"OCCUPANCY_DATE","shelter_location_pair","capacity_actual_sum","capacity_funding_sum","occupied_sum","unoccupied_sum","unavailable_sum","occupancy_rate"
2021-01-01,"40 - 1114",92,125,88,4,33,0.956521739130435
2021-01-01,"53 - 1103",40,44,38,2,4,0.95
2021-01-01,"2 - 1066",24,73,24,0,49,1
2021-01-01,"82 - 1163",140,0,54,86,-140,0.385714285714286
2021-01-02,"40 - 1114",92,125,88,4,33,0.956521739130435
2021-01-02,"53 - 1103",39,44,37,2,5,0.948717948717949
2021-01-02,"2 - 1066",23,73,23,0,50,1
2021-01-02,"82 - 1163",140,0,51,89,-140,0.364285714285714
2021-01-03,"40 - 1114",93,125,89,4,32,0.956989247311828
2021-01-03,"53 - 1103",39,44,37,2,5,0.948717948717949
2021-01-03,"2 - 1066",22,73,22,0,51,1
2021-01-03,"82 - 1163",140,0,52,88,-140,0.371428571428571
2021-01-04,"40 - 1114",92,125,89,3,33,0.967391304347826
2021-01-04,"53 - 1103",38,44,36,2,6,0.947368421052632
2021-01-04,"2 - 1066",22,73,22,0,51,1
2021-01-04,"82 - 1163",140,0,49,91,-140,0.35
2021-01-05,"40 - 1114",94,125,87,7,31,0.925531914893617
2021-01-05,"53 - 1103",36,44,36,0,8,1
2021-01-05,"2 - 1066",22,73,22,0,51,1
2021-01-05,"82 - 1163",141,0,53,88,-141,0.375886524822695
2021-01-06,"40 - 1114",92,125,88,4,33,0.956521739130435
2021-01-06,"53 - 1103",36,44,36,0,8,1
2021-01-06,"2 - 1066",23,73,23,0,50,1
2021-01-06,"82 - 1163",141,0,71,70,-141,0.50354609929078
2021-01-07,"40 - 1114",92,125,87,5,33,0.945652173913043
2021-01-07,"53 - 1103",36,44,36,0,8,1
2021-01-07,"2 - 1066",23,73,23,0,50,1
2021-01-07,"82 - 1163",142,0,75,67,-142,0.528169014084507
2021-01-08,"40 - 1114",91,125,85,6,34,0.934065934065934
2021-01-08,"53 - 1103",36,44,36,0,8,1
2021-01-08,"2 - 1066",23,73,23,0,50,1
2021-01-08,"82 - 1163",142,0,85,57,-142,0.598591549295775
2021-01-09,"40 - 1114",91,125,85,6,34,0.934065934065934
2021-01-09,"53 - 1103",38,44,36,2,6,0.947368421052632
2021-01-09,"2 - 1066",23,73,23,0,50,1
2021-01-09,"82 - 1163",143,0,87,56,-143,0.608391608391608
2021-01-10,"40 - 1114",91,125,85,6,34,0.934065934065934
2021-01-10,"53 - 1103",36,44,36,0,8,1
2021-01-10,"2 - 1066",23,73,23,0,50,1
2021-01-10,"82 - 1163",143,0,85,58,-143,0.594405594405594
2021-01-11,"40 - 1114",88,125,83,5,37,0.943181818181818
2021-01-11,"53 - 1103",36,44,36,0,8,1
2021-01-11,"2 - 1066",23,73,23,0,50,1
2021-01-11,"82 - 1163",143,0,87,56,-143,0.608391608391608
2021-01-12,"40 - 1114",88,125,83,5,37,0.943181818181818
2021-01-12,"53 - 1103",39,44,39,0,5,1
2021-01-12,"2 - 1066",24,73,24,0,49,1
2021-01-12,"82 - 1163",144,0,90,54,-144,0.625
2021-01-13,"40 - 1114",88,125,84,4,37,0.954545454545455
2021-01-13,"53 - 1103",40,44,40,0,4,1
2021-01-13,"2 - 1066",24,73,24,0,49,1
2021-01-13,"82 - 1163",147,0,95,52,-147,0.646258503401361
2021-01-14,"40 - 1114",84,125,84,0,41,1
2021-01-14,"53 - 1103",40,44,40,0,4,1
2021-01-14,"2 - 1066",24,73,24,0,49,1
2021-01-14,"82 - 1163",147,0,92,55,-147,0.625850340136054
2021-01-15,"40 - 1114",84,125,83,1,41,0.988095238095238
2021-01-15,"53 - 1103",43,44,43,0,1,1
2021-01-15,"2 - 1066",23,73,23,0,50,1
2021-01-15,"82 - 1163",147,0,101,46,-147,0.687074829931973
2021-01-16,"40 - 1114",84,125,82,2,41,0.976190476190476
2021-01-16,"53 - 1103",44,44,44,0,0,1
2021-01-16,"2 - 1066",24,73,24,0,49,1
2021-01-16,"82 - 1163",147,0,80,67,-147,0.54421768707483
2021-01-17,"40 - 1114",88,125,83,5,37,0.943181818181818
2021-01-17,"53 - 1103",44,44,44,0,0,1
2021-01-17,"2 - 1066",24,73,24,0,49,1
2021-01-17,"82 - 1163",147,0,77,70,-147,0.523809523809524
2021-01-18,"40 - 1114",88,125,82,6,37,0.931818181818182
2021-01-18,"53 - 1103",43,44,43,0,1,1
2021-01-18,"2 - 1066",25,73,25,0,48,1
2021-01-18,"82 - 1163",147,0,78,69,-147,0.530612244897959
2021-01-19,"40 - 1114",84,125,80,4,41,0.952380952380952
2021-01-19,"53 - 1103",42,44,42,0,2,1
2021-01-19,"2 - 1066",25,73,25,0,48,1
2021-01-19,"82 - 1163",148,0,100,48,-148,0.675675675675676
2021-01-20,"40 - 1114",81,125,81,0,44,1
2021-01-20,"53 - 1103",42,44,42,0,2,1
2021-01-20,"2 - 1066",22,73,22,0,51,1
2021-01-20,"82 - 1163",148,0,102,46,-148,0.689189189189189
2021-01-21,"40 - 1114",80,125,80,0,45,1
2021-01-21,"53 - 1103",44,64,44,0,20,1
2021-01-21,"2 - 1066",21,73,21,0,52,1
2021-01-21,"82 - 1163",148,0,95,53,-148,0.641891891891892
2021-01-22,"40 - 1114",79,125,79,0,46,1
2021-01-22,"53 - 1103",44,61,42,2,17,0.954545454545455
2021-01-22,"2 - 1066",21,73,21,0,52,1
2021-01-22,"82 - 1163",149,0,97,52,-149,0.651006711409396
2021-01-23,"40 - 1114",79,125,78,1,46,0.987341772151899
2021-01-23,"53 - 1103",44,61,42,2,17,0.954545454545455
2021-01-23,"2 - 1066",21,73,21,0,52,1
2021-01-23,"82 - 1163",149,0,88,61,-149,0.590604026845638
2021-01-24,"40 - 1114",79,125,78,1,46,0.987341772151899
2021-01-24,"53 - 1103",44,61,42,2,17,0.954545454545455
2021-01-24,"2 - 1066",21,73,21,0,52,1
2021-01-24,"82 - 1163",149,0,91,58,-149,0.610738255033557
2021-01-25,"40 - 1114",81,125,80,1,44,0.987654320987654
2021-01-25,"53 - 1103",45,61,44,1,16,0.977777777777778
2021-01-25,"2 - 1066",21,73,21,0,52,1
2021-01-25,"82 - 1163",149,0,82,67,-149,0.550335570469799
2021-01-26,"40 - 1114",80,125,79,1,45,0.9875
2021-01-26,"53 - 1103",44,61,41,3,17,0.931818181818182
2021-01-26,"2 - 1066",21,73,21,0,52,1
2021-01-26,"82 - 1163",149,0,81,68,-149,0.543624161073825
2021-01-27,"40 - 1114",80,125,79,1,45,0.9875
2021-01-27,"53 - 1103",38,61,37,1,23,0.973684210526316
2021-01-27,"2 - 1066",21,73,21,0,52,1
2021-01-27,"82 - 1163",149,0,83,66,-149,0.557046979865772
2021-01-28,"40 - 1114",79,125,79,0,46,1
2021-01-28,"53 - 1103",40,61,35,5,21,0.875
2021-01-28,"2 - 1066",22,73,22,0,51,1
2021-01-28,"82 - 1163",149,0,92,57,-149,0.61744966442953
2021-01-29,"40 - 1114",79,125,78,1,46,0.987341772151899
2021-01-29,"53 - 1103",38,34,36,2,-4,0.947368421052632
2021-01-29,"2 - 1066",22,73,22,0,51,1
2021-01-29,"82 - 1163",149,0,78,71,-149,0.523489932885906
2021-01-30,"40 - 1114",78,125,78,0,47,1
2021-01-30,"53 - 1103",37,34,37,0,-3,1
2021-01-30,"2 - 1066",22,73,22,0,51,1
2021-01-30,"82 - 1163",149,0,77,72,-149,0.516778523489933
2021-01-31,"40 - 1114",78,125,77,1,47,0.987179487179487
2021-01-31,"53 - 1103",39,34,39,0,-5,1
2021-01-31,"2 - 1066",22,73,22,0,51,1
2021-01-31,"82 - 1163",149,0,71,78,-149,0.476510067114094
2021-02-01,"40 - 1114",76,125,75,1,49,0.986842105263158
2021-02-01,"53 - 1103",41,78,41,0,37,1
2021-02-01,"2 - 1066",22,73,22,0,51,1
2021-02-01,"82 - 1163",149,0,68,81,-149,0.456375838926175
2021-02-02,"40 - 1114",76,125,74,2,49,0.973684210526316
2021-02-02,"53 - 1103",43,78,43,0,35,1
2021-02-02,"2 - 1066",25,73,25,0,48,1
2021-02-02,"82 - 1163",149,0,77,72,-149,0.516778523489933
2021-02-03,"40 - 1114",74,125,74,0,51,1
2021-02-03,"53 - 1103",44,78,42,2,34,0.954545454545455
2021-02-03,"2 - 1066",25,73,25,0,48,1
2021-02-03,"82 - 1163",149,0,77,72,-149,0.516778523489933
2021-02-04,"40 - 1114",74,125,74,0,51,1
2021-02-04,"53 - 1103",42,67,42,0,25,1
2021-02-04,"2 - 1066",25,73,25,0,48,1
2021-02-04,"82 - 1163",149,0,82,67,-149,0.550335570469799
2021-02-05,"40 - 1114",81,125,77,4,44,0.950617283950617
2021-02-05,"53 - 1103",46,67,43,3,21,0.934782608695652
2021-02-05,"2 - 1066",24,73,24,0,49,1
2021-02-05,"82 - 1163",149,0,86,63,-149,0.577181208053691
2021-02-06,"40 - 1114",81,125,76,5,44,0.938271604938272
2021-02-06,"53 - 1103",49,67,48,1,18,0.979591836734694
2021-02-06,"2 - 1066",24,73,24,0,49,1
2021-02-06,"82 - 1163",149,0,83,66,-149,0.557046979865772
2021-02-07,"40 - 1114",81,125,77,4,44,0.950617283950617
2021-02-07,"53 - 1103",51,67,50,1,16,0.980392156862745
2021-02-07,"2 - 1066",23,73,23,0,50,1
2021-02-07,"82 - 1163",149,0,78,71,-149,0.523489932885906
2021-02-08,"40 - 1114",86,125,84,2,39,0.976744186046512
2021-02-08,"53 - 1103",53,67,52,1,14,0.981132075471698
2021-02-08,"2 - 1066",24,73,24,0,49,1
2021-02-08,"82 - 1163",149,0,77,72,-149,0.516778523489933
2021-02-09,"40 - 1114",93,125,88,5,32,0.946236559139785
2021-02-09,"53 - 1103",56,67,55,1,11,0.982142857142857
2021-02-09,"2 - 1066",24,73,24,0,49,1
2021-02-09,"82 - 1163",149,0,88,61,-149,0.590604026845638
2021-02-10,"40 - 1114",96,125,94,2,29,0.979166666666667
2021-02-10,"53 - 1103",58,67,57,1,9,0.982758620689655
2021-02-10,"2 - 1066",24,73,24,0,49,1
2021-02-10,"82 - 1163",149,0,86,63,-149,0.577181208053691
2021-02-11,"40 - 1114",101,125,101,0,24,1
2021-02-11,"53 - 1103",56,67,55,1,11,0.982142857142857
2021-02-11,"2 - 1066",24,73,24,0,49,1
2021-02-11,"82 - 1163",149,0,92,57,-149,0.61744966442953
2021-02-12,"40 - 1114",101,125,99,2,24,0.98019801980198
2021-02-12,"53 - 1103",60,71,59,1,11,0.983333333333333
2021-02-12,"2 - 1066",24,73,24,0,49,1
2021-02-12,"82 - 1163",149,0,81,68,-149,0.543624161073825
2021-02-13,"40 - 1114",102,125,97,5,23,0.950980392156863
2021-02-13,"53 - 1103",60,71,59,1,11,0.983333333333333
2021-02-13,"2 - 1066",24,73,24,0,49,1
2021-02-13,"82 - 1163",149,0,72,77,-149,0.483221476510067
2021-02-14,"40 - 1114",102,125,97,5,23,0.950980392156863
2021-02-14,"53 - 1103",57,71,56,1,14,0.982456140350877
2021-02-14,"2 - 1066",24,73,24,0,49,1
2021-02-14,"82 - 1163",149,0,73,76,-149,0.48993288590604
2021-02-15,"40 - 1114",102,125,97,5,23,0.950980392156863
2021-02-15,"53 - 1103",60,71,59,1,11,0.983333333333333
2021-02-15,"2 - 1066",24,73,24,0,49,1
2021-02-15,"82 - 1163",149,0,71,78,-149,0.476510067114094
2021-02-16,"40 - 1114",99,125,98,1,26,0.98989898989899
2021-02-16,"53 - 1103",60,71,59,1,11,0.983333333333333
2021-02-16,"2 - 1066",25,73,25,0,48,1
2021-02-16,"82 - 1163",149,0,74,75,-149,0.496644295302013
2021-02-17,"40 - 1114",100,125,98,2,25,0.98
2021-02-17,"53 - 1103",59,71,59,0,12,1
2021-02-17,"2 - 1066",26,73,26,0,47,1
2021-02-17,"82 - 1163",149,0,83,66,-149,0.557046979865772
2021-02-18,"40 - 1114",97,125,97,0,28,1
2021-02-18,"53 - 1103",60,71,60,0,11,1
2021-02-18,"2 - 1066",26,73,26,0,47,1
2021-02-18,"82 - 1163",149,0,95,54,-149,0.63758389261745
2021-02-19,"40 - 1114",97,125,96,1,28,0.989690721649485
2021-02-19,"53 - 1103",60,71,60,0,11,1
2021-02-19,"2 - 1066",27,73,27,0,46,1
2021-02-19,"82 - 1163",149,0,117,32,-149,0.785234899328859
2021-02-20,"40 - 1114",98,125,97,1,27,0.989795918367347
2021-02-20,"53 - 1103",60,71,60,0,11,1
2021-02-20,"2 - 1066",27,73,27,0,46,1
2021-02-20,"82 - 1163",149,0,113,36,-149,0.758389261744966
2021-02-21,"40 - 1114",98,125,98,0,27,1
2021-02-21,"53 - 1103",58,71,58,0,13,1
2021-02-21,"2 - 1066",27,73,27,0,46,1
2021-02-21,"82 - 1163",150,0,110,40,-150,0.733333333333333
2021-02-22,"40 - 1114",100,125,98,2,25,0.98
2021-02-22,"53 - 1103",58,71,58,0,13,1
2021-02-22,"2 - 1066",27,73,27,0,46,1
2021-02-22,"82 - 1163",150,0,103,47,-150,0.686666666666667
2021-02-23,"40 - 1114",98,125,97,1,27,0.989795918367347
2021-02-23,"53 - 1103",58,71,58,0,13,1
2021-02-23,"2 - 1066",27,73,27,0,46,1
2021-02-23,"82 - 1163",150,0,105,45,-150,0.7
2021-02-24,"40 - 1114",96,125,96,0,29,1
2021-02-24,"53 - 1103",60,71,60,0,11,1
2021-02-24,"2 - 1066",27,73,27,0,46,1
2021-02-24,"82 - 1163",150,0,116,34,-150,0.773333333333333
2021-02-25,"40 - 1114",96,125,96,0,29,1
2021-02-25,"53 - 1103",59,71,59,0,12,1
2021-02-25,"2 - 1066",28,73,28,0,45,1
2021-02-25,"82 - 1163",150,0,118,32,-150,0.786666666666667
2021-02-26,"40 - 1114",96,125,96,0,29,1
2021-02-26,"53 - 1103",56,71,56,0,15,1
2021-02-26,"2 - 1066",28,73,28,0,45,1
2021-02-26,"82 - 1163",151,0,114,37,-151,0.754966887417219
2021-02-27,"40 - 1114",97,125,96,1,28,0.989690721649485
2021-02-27,"53 - 1103",55,71,55,0,16,1
2021-02-27,"2 - 1066",27,73,27,0,46,1
2021-02-27,"82 - 1163",151,0,116,35,-151,0.768211920529801
2021-02-28,"40 - 1114",97,125,96,1,28,0.989690721649485
2021-02-28,"53 - 1103",55,71,55,0,16,1
2021-02-28,"2 - 1066",27,73,27,0,46,1
2021-02-28,"82 - 1163",151,0,106,45,-151,0.701986754966887
2021-03-01,"40 - 1114",96,125,96,0,29,1
2021-03-01,"53 - 1103",53,71,53,0,18,1
2021-03-01,"2 - 1066",27,73,27,0,46,1
2021-03-01,"82 - 1163",151,0,71,80,-151,0.470198675496689
2021-03-02,"40 - 1114",96,125,93,3,29,0.96875
2021-03-02,"53 - 1103",54,71,54,0,17,1
2021-03-02,"2 - 1066",26,73,26,0,47,1
2021-03-02,"82 - 1163",151,0,78,73,-151,0.516556291390728
2021-03-03,"40 - 1114",91,125,90,1,34,0.989010989010989
2021-03-03,"53 - 1103",53,70,53,0,17,1
2021-03-03,"2 - 1066",25,73,25,0,48,1
2021-03-03,"82 - 1163",151,0,80,71,-151,0.529801324503311
2021-03-04,"40 - 1114",91,125,91,0,34,1
2021-03-04,"53 - 1103",51,70,51,0,19,1
2021-03-04,"2 - 1066",24,73,24,0,49,1
2021-03-04,"82 - 1163",151,0,80,71,-151,0.529801324503311
2021-03-05,"40 - 1114",92,125,89,3,33,0.967391304347826
2021-03-05,"53 - 1103",51,70,51,0,19,1
2021-03-05,"2 - 1066",24,73,24,0,49,1
2021-03-05,"82 - 1163",151,0,78,73,-151,0.516556291390728
2021-03-06,"40 - 1114",88,125,88,0,37,1
2021-03-06,"53 - 1103",49,70,49,0,21,1
2021-03-06,"2 - 1066",24,73,24,0,49,1
2021-03-06,"82 - 1163",151,0,75,76,-151,0.496688741721854
2021-03-07,"40 - 1114",87,125,87,0,38,1
2021-03-07,"53 - 1103",48,70,47,1,22,0.979166666666667
2021-03-07,"2 - 1066",24,73,24,0,49,1
2021-03-07,"82 - 1163",151,0,70,81,-151,0.463576158940397
2021-03-08,"40 - 1114",86,125,86,0,39,1
2021-03-08,"53 - 1103",44,70,44,0,26,1
2021-03-08,"2 - 1066",24,73,24,0,49,1
2021-03-08,"82 - 1163",151,0,76,75,-151,0.503311258278146
2021-03-09,"40 - 1114",86,125,86,0,39,1
2021-03-09,"53 - 1103",44,70,44,0,26,1
2021-03-09,"2 - 1066",24,73,24,0,49,1
2021-03-09,"82 - 1163",151,0,75,76,-151,0.496688741721854
2021-03-10,"40 - 1114",86,125,86,0,39,1
2021-03-10,"53 - 1103",43,70,43,0,27,1
2021-03-10,"2 - 1066",25,73,25,0,48,1
2021-03-10,"82 - 1163",151,0,76,75,-151,0.503311258278146
2021-03-11,"40 - 1114",87,125,86,1,38,0.988505747126437
2021-03-11,"53 - 1103",43,70,43,0,27,1
2021-03-11,"2 - 1066",24,73,24,0,49,1
2021-03-11,"82 - 1163",151,0,79,72,-151,0.52317880794702
2021-03-12,"40 - 1114",87,125,87,0,38,1
2021-03-12,"53 - 1103",43,70,43,0,27,1
2021-03-12,"2 - 1066",22,73,22,0,51,1
2021-03-12,"82 - 1163",151,0,82,69,-151,0.543046357615894
2021-03-13,"40 - 1114",89,125,89,0,36,1
2021-03-13,"53 - 1103",41,70,41,0,29,1
2021-03-13,"2 - 1066",21,73,21,0,52,1
2021-03-13,"82 - 1163",151,0,89,62,-151,0.589403973509934
2021-03-14,"40 - 1114",89,125,89,0,36,1
2021-03-14,"53 - 1103",42,70,42,0,28,1
2021-03-14,"2 - 1066",20,73,20,0,53,1
2021-03-14,"82 - 1163",151,0,104,47,-151,0.688741721854305
2021-03-15,"40 - 1114",89,125,89,0,36,1
2021-03-15,"53 - 1103",42,70,42,0,28,1
2021-03-15,"2 - 1066",21,73,21,0,52,1
2021-03-15,"82 - 1163",151,0,104,47,-151,0.688741721854305
2021-03-16,"40 - 1114",87,125,87,0,38,1
2021-03-16,"53 - 1103",42,70,42,0,28,1
2021-03-16,"2 - 1066",21,73,21,0,52,1
2021-03-16,"82 - 1163",151,0,102,49,-151,0.675496688741722
2021-03-17,"40 - 1114",87,125,87,0,38,1
2021-03-17,"53 - 1103",44,70,44,0,26,1
2021-03-17,"2 - 1066",21,73,21,0,52,1
2021-03-17,"82 - 1163",151,0,115,36,-151,0.76158940397351
2021-03-18,"40 - 1114",88,125,88,0,37,1
2021-03-18,"53 - 1103",49,70,49,0,21,1
2021-03-18,"2 - 1066",22,73,22,0,51,1
2021-03-18,"82 - 1163",151,0,121,30,-151,0.801324503311258
2021-03-19,"40 - 1114",88,125,88,0,37,1
2021-03-19,"53 - 1103",53,70,53,0,17,1
2021-03-19,"2 - 1066",22,73,22,0,51,1
2021-03-19,"82 - 1163",152,0,122,30,-152,0.802631578947368
2021-03-20,"40 - 1114",88,125,88,0,37,1
2021-03-20,"53 - 1103",53,70,53,0,17,1
2021-03-20,"2 - 1066",22,73,22,0,51,1
2021-03-20,"82 - 1163",153,0,124,29,-153,0.810457516339869
2021-03-21,"40 - 1114",88,125,87,1,37,0.988636363636364
2021-03-21,"53 - 1103",51,70,51,0,19,1
2021-03-21,"2 - 1066",22,73,22,0,51,1
2021-03-21,"82 - 1163",153,0,119,34,-153,0.777777777777778
2021-03-22,"40 - 1114",87,125,87,0,38,1
2021-03-22,"53 - 1103",50,70,50,0,20,1
2021-03-22,"2 - 1066",22,73,22,0,51,1
2021-03-22,"82 - 1163",153,0,127,26,-153,0.830065359477124
2021-03-23,"40 - 1114",87,125,87,0,38,1
2021-03-23,"53 - 1103",49,70,49,0,21,1
2021-03-23,"2 - 1066",22,73,22,0,51,1
2021-03-23,"82 - 1163",153,0,118,35,-153,0.77124183006536
2021-03-24,"40 - 1114",87,125,87,0,38,1
2021-03-24,"53 - 1103",52,70,52,0,18,1
2021-03-24,"2 - 1066",23,73,23,0,50,1
2021-03-24,"82 - 1163",153,0,118,35,-153,0.77124183006536
2021-03-25,"40 - 1114",87,125,87,0,38,1
2021-03-25,"53 - 1103",55,70,55,0,15,1
2021-03-25,"2 - 1066",22,73,22,0,51,1
2021-03-25,"82 - 1163",153,0,118,35,-153,0.77124183006536
2021-03-26,"40 - 1114",88,125,88,0,37,1
2021-03-26,"53 - 1103",59,70,57,2,11,0.966101694915254
2021-03-26,"2 - 1066",21,73,21,0,52,1
2021-03-26,"82 - 1163",153,0,122,31,-153,0.797385620915033
2021-03-27,"40 - 1114",88,125,88,0,37,1
2021-03-27,"53 - 1103",58,70,58,0,12,1
2021-03-27,"2 - 1066",21,73,21,0,52,1
2021-03-27,"82 - 1163",153,0,118,35,-153,0.77124183006536
2021-03-28,"40 - 1114",88,125,88,0,37,1
2021-03-28,"53 - 1103",59,70,59,0,11,1
2021-03-28,"2 - 1066",21,73,21,0,52,1
2021-03-28,"82 - 1163",153,0,119,34,-153,0.777777777777778
2021-03-29,"40 - 1114",88,125,88,0,37,1
2021-03-29,"53 - 1103",58,70,58,0,12,1
2021-03-29,"2 - 1066",21,73,21,0,52,1
2021-03-29,"82 - 1163",153,0,105,48,-153,0.686274509803922
2021-03-30,"40 - 1114",88,125,88,0,37,1
2021-03-30,"53 - 1103",59,70,59,0,11,1
2021-03-30,"2 - 1066",20,73,20,0,53,1
2021-03-30,"82 - 1163",153,0,96,57,-153,0.627450980392157
2021-03-31,"40 - 1114",88,125,88,0,37,1
2021-03-31,"53 - 1103",61,70,61,0,9,1
2021-03-31,"2 - 1066",21,73,21,0,52,1
2021-03-31,"82 - 1163",153,0,105,48,-153,0.686274509803922
2021-04-01,"40 - 1114",87,125,87,0,38,1
2021-04-01,"53 - 1103",61,90,61,0,29,1
2021-04-01,"2 - 1066",21,73,21,0,52,1
2021-04-01,"82 - 1163",153,0,103,50,-153,0.673202614379085
2021-04-02,"40 - 1114",87,125,85,2,38,0.977011494252874
2021-04-02,"53 - 1103",65,90,65,0,25,1
2021-04-02,"2 - 1066",21,73,21,0,52,1
2021-04-02,"82 - 1163",153,0,102,51,-153,0.666666666666667
2021-04-03,"40 - 1114",87,125,85,2,38,0.977011494252874
2021-04-03,"53 - 1103",70,90,70,0,20,1
2021-04-03,"2 - 1066",21,73,21,0,52,1
2021-04-03,"82 - 1163",153,0,95,58,-153,0.620915032679739
2021-04-04,"40 - 1114",87,125,84,3,38,0.96551724137931
2021-04-04,"53 - 1103",73,90,73,0,17,1
2021-04-04,"2 - 1066",22,73,22,0,51,1
2021-04-04,"82 - 1163",153,0,96,57,-153,0.627450980392157
2021-04-05,"40 - 1114",83,125,83,0,42,1
2021-04-05,"53 - 1103",78,90,78,0,12,1
2021-04-05,"2 - 1066",22,73,22,0,51,1
2021-04-05,"82 - 1163",153,0,87,66,-153,0.568627450980392
2021-04-06,"40 - 1114",83,125,83,0,42,1
2021-04-06,"53 - 1103",84,91,84,0,7,1
2021-04-06,"2 - 1066",25,73,24,1,48,0.96
2021-04-06,"82 - 1163",153,0,89,64,-153,0.581699346405229
2021-04-07,"40 - 1114",82,125,82,0,43,1
2021-04-07,"53 - 1103",87,91,87,0,4,1
2021-04-07,"2 - 1066",24,73,24,0,49,1
2021-04-07,"82 - 1163",153,0,88,65,-153,0.57516339869281
2021-04-08,"40 - 1114",81,125,81,0,44,1
2021-04-08,"53 - 1103",89,91,88,1,2,0.98876404494382
2021-04-08,"2 - 1066",26,73,26,0,47,1
2021-04-08,"82 - 1163",147,0,101,46,-147,0.687074829931973
2021-04-09,"40 - 1114",81,125,81,0,44,1
2021-04-09,"53 - 1103",88,91,88,0,3,1
2021-04-09,"2 - 1066",26,73,26,0,47,1
2021-04-09,"82 - 1163",147,0,107,40,-147,0.727891156462585
2021-04-10,"40 - 1114",81,125,81,0,44,1
2021-04-10,"53 - 1103",87,91,87,0,4,1
2021-04-10,"2 - 1066",26,73,26,0,47,1
2021-04-10,"82 - 1163",147,0,108,39,-147,0.73469387755102
2021-04-11,"40 - 1114",81,125,81,0,44,1
2021-04-11,"53 - 1103",85,91,85,0,6,1
2021-04-11,"2 - 1066",26,73,26,0,47,1
2021-04-11,"82 - 1163",147,0,98,49,-147,0.666666666666667
2021-04-12,"40 - 1114",81,125,81,0,44,1
2021-04-12,"53 - 1103",84,91,84,0,7,1
2021-04-12,"2 - 1066",26,73,26,0,47,1
2021-04-12,"82 - 1163",148,0,104,44,-148,0.702702702702703
2021-04-13,"40 - 1114",79,125,79,0,46,1
2021-04-13,"53 - 1103",84,91,84,0,7,1
2021-04-13,"2 - 1066",26,73,26,0,47,1
2021-04-13,"82 - 1163",148,0,103,45,-148,0.695945945945946
2021-04-14,"40 - 1114",79,125,79,0,46,1
2021-04-14,"53 - 1103",84,91,83,1,7,0.988095238095238
2021-04-14,"2 - 1066",27,73,27,0,46,1
2021-04-14,"82 - 1163",148,0,92,56,-148,0.621621621621622
2021-04-15,"40 - 1114",79,125,79,0,46,1
2021-04-15,"53 - 1103",85,91,85,0,6,1
2021-04-15,"2 - 1066",28,73,28,0,45,1
2021-04-15,"82 - 1163",149,0,99,50,-149,0.664429530201342
2021-04-16,"40 - 1114",89,125,78,11,36,0.876404494382023
2021-04-16,"53 - 1103",89,91,89,0,2,1
2021-04-16,"2 - 1066",27,73,27,0,46,1
2021-04-16,"82 - 1163",149,0,106,43,-149,0.711409395973154
2021-04-17,"40 - 1114",88,125,77,11,37,0.875
2021-04-17,"53 - 1103",89,91,89,0,2,1
2021-04-17,"2 - 1066",27,73,27,0,46,1
2021-04-17,"82 - 1163",149,0,105,44,-149,0.704697986577181
2021-04-18,"40 - 1114",88,125,77,11,37,0.875
2021-04-18,"53 - 1103",85,91,85,0,6,1
2021-04-18,"2 - 1066",27,73,27,0,46,1
2021-04-18,"82 - 1163",149,0,91,58,-149,0.610738255033557
2021-04-19,"40 - 1114",80,125,76,4,45,0.95
2021-04-19,"53 - 1103",84,91,84,0,7,1
2021-04-19,"2 - 1066",27,73,27,0,46,1
2021-04-19,"82 - 1163",149,0,88,61,-149,0.590604026845638
2021-04-20,"40 - 1114",79,125,76,3,46,0.962025316455696
2021-04-20,"53 - 1103",83,91,83,0,8,1
2021-04-20,"2 - 1066",28,73,28,0,45,1
2021-04-20,"82 - 1163",149,0,88,61,-149,0.590604026845638
2021-04-21,"40 - 1114",80,125,78,2,45,0.975
2021-04-21,"53 - 1103",84,91,83,1,7,0.988095238095238
2021-04-21,"2 - 1066",28,73,27,1,45,0.964285714285714
2021-04-21,"82 - 1163",149,0,97,52,-149,0.651006711409396
2021-04-22,"40 - 1114",81,125,77,4,44,0.950617283950617
2021-04-22,"53 - 1103",84,91,84,0,7,1
2021-04-22,"2 - 1066",26,73,26,0,47,1
2021-04-22,"82 - 1163",149,0,106,43,-149,0.711409395973154
2021-04-23,"40 - 1114",86,125,78,8,39,0.906976744186046
2021-04-23,"53 - 1103",84,91,84,0,7,1
2021-04-23,"2 - 1066",26,73,26,0,47,1
2021-04-23,"82 - 1163",149,0,97,52,-149,0.651006711409396
2021-04-24,"40 - 1114",86,125,78,8,39,0.906976744186046
2021-04-24,"53 - 1103",81,91,81,0,10,1
2021-04-24,"2 - 1066",26,73,26,0,47,1
2021-04-24,"82 - 1163",149,0,98,51,-149,0.657718120805369
2021-04-25,"40 - 1114",87,125,79,8,38,0.908045977011494
2021-04-25,"53 - 1103",81,91,81,0,10,1
2021-04-25,"2 - 1066",26,73,26,0,47,1
2021-04-25,"82 - 1163",149,0,99,50,-149,0.664429530201342
2021-04-26,"40 - 1114",87,125,79,8,38,0.908045977011494
2021-04-26,"53 - 1103",78,91,78,0,13,1
2021-04-26,"2 - 1066",26,73,26,0,47,1
2021-04-26,"82 - 1163",149,0,88,61,-149,0.590604026845638
2021-04-27,"40 - 1114",87,125,80,7,38,0.919540229885057
2021-04-27,"53 - 1103",78,91,78,0,13,1
2021-04-27,"2 - 1066",24,73,24,0,49,1
2021-04-27,"82 - 1163",152,0,82,70,-152,0.539473684210526
2021-04-28,"40 - 1114",87,125,80,7,38,0.919540229885057
2021-04-28,"53 - 1103",78,91,78,0,13,1
2021-04-28,"2 - 1066",24,73,24,0,49,1
2021-04-28,"82 - 1163",152,0,81,71,-152,0.532894736842105
2021-04-29,"40 - 1114",86,125,81,5,39,0.941860465116279
2021-04-29,"53 - 1103",78,91,78,0,13,1
2021-04-29,"2 - 1066",24,73,24,0,49,1
2021-04-29,"82 - 1163",152,0,81,71,-152,0.532894736842105
2021-04-30,"40 - 1114",88,125,80,8,37,0.909090909090909
2021-04-30,"53 - 1103",77,91,77,0,14,1
2021-04-30,"2 - 1066",24,73,24,0,49,1
2021-04-30,"82 - 1163",153,0,68,85,-153,0.444444444444444
2021-05-01,"40 - 1114",88,125,80,8,37,0.909090909090909
2021-05-01,"53 - 1103",75,91,75,0,16,1
2021-05-01,"2 - 1066",23,73,23,0,50,1
2021-05-01,"82 - 1163",153,0,62,91,-153,0.405228758169935
2021-05-02,"40 - 1114",88,125,80,8,37,0.909090909090909
2021-05-02,"53 - 1103",75,91,75,0,16,1
2021-05-02,"2 - 1066",25,73,24,1,48,0.96
2021-05-02,"82 - 1163",154,0,57,97,-154,0.37012987012987
2021-05-03,"40 - 1114",89,125,83,6,36,0.932584269662921
2021-05-03,"53 - 1103",74,91,74,0,17,1
2021-05-03,"2 - 1066",23,73,23,0,50,1
2021-05-03,"82 - 1163",154,0,60,94,-154,0.38961038961039
2021-05-04,"40 - 1114",90,125,83,7,35,0.922222222222222
2021-05-04,"53 - 1103",75,91,75,0,16,1
2021-05-04,"2 - 1066",23,73,23,0,50,1
2021-05-04,"82 - 1163",154,0,54,100,-154,0.350649350649351
2021-05-05,"40 - 1114",88,237,83,5,149,0.943181818181818
2021-05-05,"53 - 1103",74,NA,74,0,NA,1
2021-05-05,"2 - 1066",24,NA,24,0,NA,1
2021-05-05,"82 - 1163",154,NA,48,106,NA,0.311688311688312
2021-05-06,"40 - 1114",91,237,83,8,146,0.912087912087912
2021-05-06,"53 - 1103",72,NA,72,0,NA,1
2021-05-06,"2 - 1066",23,NA,23,0,NA,1
2021-05-06,"82 - 1163",154,NA,47,107,NA,0.305194805194805
2021-05-07,"40 - 1114",93,237,84,9,144,0.903225806451613
2021-05-07,"53 - 1103",73,91,73,0,18,1
2021-05-07,"2 - 1066",23,73,23,0,50,1
2021-05-07,"82 - 1163",154,NA,44,110,NA,0.285714285714286
2021-05-08,"40 - 1114",93,237,85,8,144,0.913978494623656
2021-05-08,"53 - 1103",73,91,73,0,18,1
2021-05-08,"2 - 1066",23,73,23,0,50,1
2021-05-08,"82 - 1163",154,NA,43,111,NA,0.279220779220779
2021-05-09,"40 - 1114",93,237,85,8,144,0.913978494623656
2021-05-09,"53 - 1103",73,91,73,0,18,1
2021-05-09,"2 - 1066",23,73,23,0,50,1
2021-05-09,"82 - 1163",154,NA,43,111,NA,0.279220779220779
2021-05-10,"40 - 1114",92,237,83,9,145,0.902173913043478
2021-05-10,"53 - 1103",73,91,73,0,18,1
2021-05-10,"2 - 1066",23,73,23,0,50,1
2021-05-10,"82 - 1163",154,NA,42,112,NA,0.272727272727273
2021-05-11,"40 - 1114",92,237,84,8,145,0.91304347826087
2021-05-11,"53 - 1103",73,91,73,0,18,1
2021-05-11,"2 - 1066",23,73,23,0,50,1
2021-05-11,"82 - 1163",154,NA,51,103,NA,0.331168831168831
2021-05-12,"40 - 1114",93,237,86,7,144,0.924731182795699
2021-05-12,"53 - 1103",70,91,70,0,21,1
2021-05-12,"2 - 1066",24,73,23,1,49,0.958333333333333
2021-05-12,"82 - 1163",154,NA,49,105,NA,0.318181818181818
2021-05-13,"40 - 1114",95,237,88,7,142,0.926315789473684
2021-05-13,"53 - 1103",67,91,67,0,24,1
2021-05-13,"2 - 1066",23,73,23,0,50,1
2021-05-13,"82 - 1163",154,NA,53,101,NA,0.344155844155844
2021-05-14,"40 - 1114",102,237,85,17,135,0.833333333333333
2021-05-14,"53 - 1103",67,91,67,0,24,1
2021-05-14,"2 - 1066",24,73,24,0,49,1
2021-05-14,"82 - 1163",154,NA,55,99,NA,0.357142857142857
2021-05-15,"40 - 1114",102,237,86,16,135,0.843137254901961
2021-05-15,"53 - 1103",67,91,67,0,24,1
2021-05-15,"2 - 1066",24,73,24,0,49,1
2021-05-15,"82 - 1163",154,NA,55,99,NA,0.357142857142857
2021-05-16,"40 - 1114",102,237,86,16,135,0.843137254901961
2021-05-16,"53 - 1103",67,91,67,0,24,1
2021-05-16,"2 - 1066",23,73,23,0,50,1
2021-05-16,"82 - 1163",154,NA,48,106,NA,0.311688311688312
2021-05-17,"40 - 1114",94,237,88,6,143,0.936170212765957
2021-05-17,"53 - 1103",64,91,64,0,27,1
2021-05-17,"2 - 1066",24,73,24,0,49,1
2021-05-17,"82 - 1163",154,NA,43,111,NA,0.279220779220779
2021-05-18,"40 - 1114",95,237,89,6,142,0.936842105263158
2021-05-18,"53 - 1103",64,91,64,0,27,1
2021-05-18,"2 - 1066",24,73,24,0,49,1
2021-05-18,"82 - 1163",154,NA,53,101,NA,0.344155844155844
2021-05-19,"40 - 1114",96,237,91,5,141,0.947916666666667
2021-05-19,"53 - 1103",64,91,63,1,27,0.984375
2021-05-19,"2 - 1066",24,73,24,0,49,1
2021-05-19,"82 - 1163",154,NA,57,97,NA,0.37012987012987
2021-05-20,"40 - 1114",96,237,91,5,141,0.947916666666667
2021-05-20,"53 - 1103",66,91,63,3,25,0.954545454545455
2021-05-20,"2 - 1066",24,73,24,0,49,1
2021-05-20,"82 - 1163",154,NA,65,89,NA,0.422077922077922
2021-05-21,"40 - 1114",107,237,92,15,130,0.85981308411215
2021-05-21,"53 - 1103",88,91,62,26,3,0.704545454545455
2021-05-21,"2 - 1066",24,73,24,0,49,1
2021-05-21,"82 - 1163",154,NA,57,97,NA,0.37012987012987
2021-05-22,"40 - 1114",107,237,93,14,130,0.869158878504673
2021-05-22,"53 - 1103",88,91,61,27,3,0.693181818181818
2021-05-22,"2 - 1066",24,73,24,0,49,1
2021-05-22,"82 - 1163",154,NA,55,99,NA,0.357142857142857
2021-05-23,"40 - 1114",107,237,92,15,130,0.85981308411215
2021-05-23,"53 - 1103",88,91,61,27,3,0.693181818181818
2021-05-23,"2 - 1066",24,73,24,0,49,1
2021-05-23,"82 - 1163",154,NA,55,99,NA,0.357142857142857
2021-05-24,"40 - 1114",107,237,94,13,130,0.878504672897196
2021-05-24,"53 - 1103",88,91,61,27,3,0.693181818181818
2021-05-24,"2 - 1066",24,73,24,0,49,1
2021-05-24,"82 - 1163",154,NA,53,101,NA,0.344155844155844
2021-05-25,"40 - 1114",106,237,94,12,131,0.886792452830189
2021-05-25,"53 - 1103",87,91,61,26,4,0.701149425287356
2021-05-25,"2 - 1066",24,73,24,0,49,1
2021-05-25,"82 - 1163",154,NA,50,104,NA,0.324675324675325
2021-05-26,"40 - 1114",107,237,96,11,130,0.897196261682243
2021-05-26,"53 - 1103",86,91,61,25,5,0.709302325581395
2021-05-26,"2 - 1066",23,73,23,0,50,1
2021-05-26,"82 - 1163",154,NA,50,104,NA,0.324675324675325
2021-05-27,"40 - 1114",107,237,97,10,130,0.906542056074766
2021-05-27,"53 - 1103",86,91,62,24,5,0.72093023255814
2021-05-27,"2 - 1066",22,73,22,0,51,1
2021-05-27,"82 - 1163",154,NA,53,101,NA,0.344155844155844
2021-05-28,"40 - 1114",109,237,98,11,128,0.89908256880734
2021-05-28,"53 - 1103",85,91,65,20,6,0.764705882352941
2021-05-28,"2 - 1066",22,73,22,0,51,1
2021-05-28,"82 - 1163",154,NA,49,105,NA,0.318181818181818
2021-05-29,"40 - 1114",110,237,100,10,127,0.909090909090909
2021-05-29,"53 - 1103",85,91,65,20,6,0.764705882352941
2021-05-29,"2 - 1066",22,73,22,0,51,1
2021-05-29,"82 - 1163",154,NA,40,114,NA,0.25974025974026
2021-05-30,"40 - 1114",110,237,101,9,127,0.918181818181818
2021-05-30,"53 - 1103",85,91,65,20,6,0.764705882352941
2021-05-30,"2 - 1066",21,73,21,0,52,1
2021-05-30,"82 - 1163",154,NA,36,118,NA,0.233766233766234
2021-05-31,"40 - 1114",111,237,102,9,126,0.918918918918919
2021-05-31,"53 - 1103",89,91,65,24,2,0.730337078651685
2021-05-31,"2 - 1066",21,73,21,0,52,1
2021-05-31,"82 - 1163",154,NA,36,118,NA,0.233766233766234
2021-06-01,"40 - 1114",117,237,103,14,120,0.88034188034188
2021-06-01,"53 - 1103",88,91,66,22,3,0.75
2021-06-01,"2 - 1066",20,73,20,0,53,1
2021-06-01,"82 - 1163",154,NA,29,125,NA,0.188311688311688
2021-06-02,"40 - 1114",118,237,106,12,119,0.898305084745763
2021-06-02,"53 - 1103",88,91,69,19,3,0.784090909090909
2021-06-02,"2 - 1066",20,73,20,0,53,1
2021-06-02,"82 - 1163",154,NA,25,129,NA,0.162337662337662
2021-06-03,"40 - 1114",113,237,107,6,124,0.946902654867257
2021-06-03,"53 - 1103",86,91,67,19,5,0.77906976744186
2021-06-03,"2 - 1066",18,73,18,0,55,1
2021-06-03,"82 - 1163",154,NA,27,127,NA,0.175324675324675
2021-06-04,"40 - 1114",116,237,109,7,121,0.939655172413793
2021-06-04,"53 - 1103",85,91,65,20,6,0.764705882352941
2021-06-04,"2 - 1066",17,73,17,0,56,1
2021-06-04,"82 - 1163",154,NA,26,128,NA,0.168831168831169
2021-06-05,"40 - 1114",116,237,110,6,121,0.948275862068966
2021-06-05,"53 - 1103",85,91,65,20,6,0.764705882352941
2021-06-05,"2 - 1066",17,73,17,0,56,1
2021-06-05,"82 - 1163",154,NA,24,130,NA,0.155844155844156
2021-06-06,"40 - 1114",116,237,110,6,121,0.948275862068966
2021-06-06,"53 - 1103",85,91,65,20,6,0.764705882352941
2021-06-06,"2 - 1066",17,73,17,0,56,1
2021-06-06,"82 - 1163",154,NA,22,132,NA,0.142857142857143
2021-06-07,"40 - 1114",119,237,112,7,118,0.941176470588235
2021-06-07,"53 - 1103",83,91,63,20,8,0.759036144578313
2021-06-07,"2 - 1066",17,73,17,0,56,1
2021-06-07,"82 - 1163",154,NA,19,135,NA,0.123376623376623
2021-06-08,"40 - 1114",126,237,111,15,111,0.880952380952381
2021-06-08,"53 - 1103",83,91,62,21,8,0.746987951807229
2021-06-08,"2 - 1066",18,73,18,0,55,1
2021-06-08,"82 - 1163",154,NA,18,136,NA,0.116883116883117
2021-06-09,"40 - 1114",124,237,111,13,113,0.895161290322581
2021-06-09,"53 - 1103",83,91,63,20,8,0.759036144578313
2021-06-09,"2 - 1066",18,73,18,0,55,1
2021-06-09,"82 - 1163",154,NA,17,137,NA,0.11038961038961
2021-06-10,"40 - 1114",122,237,111,11,115,0.90983606557377
2021-06-10,"53 - 1103",88,91,64,24,3,0.727272727272727
2021-06-10,"2 - 1066",18,73,18,0,55,1
2021-06-10,"82 - 1163",154,NA,13,141,NA,0.0844155844155844
2021-06-11,"40 - 1114",122,237,111,11,115,0.90983606557377
2021-06-11,"53 - 1103",88,91,63,25,3,0.715909090909091
2021-06-11,"2 - 1066",18,73,18,0,55,1
2021-06-11,"82 - 1163",154,NA,12,142,NA,0.0779220779220779
2021-06-12,"40 - 1114",122,237,112,10,115,0.918032786885246
2021-06-12,"53 - 1103",86,91,61,25,5,0.709302325581395
2021-06-12,"2 - 1066",18,73,18,0,55,1
2021-06-12,"82 - 1163",154,NA,11,143,NA,0.0714285714285714
2021-06-13,"40 - 1114",122,237,112,10,115,0.918032786885246
2021-06-13,"53 - 1103",84,91,61,23,7,0.726190476190476
2021-06-13,"2 - 1066",18,73,18,0,55,1
2021-06-13,"82 - 1163",154,NA,9,145,NA,0.0584415584415584
2021-06-14,"40 - 1114",121,237,110,11,116,0.909090909090909
2021-06-14,"53 - 1103",86,91,61,25,5,0.709302325581395
2021-06-14,"2 - 1066",19,73,19,0,54,1
2021-06-14,"82 - 1163",154,NA,8,146,NA,0.051948051948052
2021-06-15,"40 - 1114",119,237,108,11,118,0.907563025210084
2021-06-15,"53 - 1103",81,91,60,21,10,0.740740740740741
2021-06-15,"2 - 1066",19,73,19,0,54,1
2021-06-15,"82 - 1163",154,NA,8,146,NA,0.051948051948052
2021-06-16,"40 - 1114",126,302,118,8,176,0.936507936507937
2021-06-16,"53 - 1103",89,91,59,30,2,0.662921348314607
2021-06-16,"2 - 1066",19,73,19,0,54,1
2021-06-16,"82 - 1163",114,NA,5,109,NA,0.043859649122807
2021-06-17,"40 - 1114",127,302,119,8,175,0.937007874015748
2021-06-17,"53 - 1103",89,91,59,30,2,0.662921348314607
2021-06-17,"2 - 1066",20,73,20,0,53,1
2021-06-17,"82 - 1163",114,NA,4,110,NA,0.0350877192982456
2021-06-18,"40 - 1114",138,302,124,14,164,0.898550724637681
2021-06-18,"53 - 1103",89,91,60,29,2,0.674157303370786
2021-06-18,"2 - 1066",21,73,21,0,52,1
2021-06-18,"82 - 1163",115,NA,5,110,NA,0.0434782608695652
2021-06-19,"40 - 1114",138,302,128,10,164,0.927536231884058
2021-06-19,"53 - 1103",89,91,61,28,2,0.685393258426966
2021-06-19,"2 - 1066",21,73,21,0,52,1
2021-06-19,"82 - 1163",115,NA,3,112,NA,0.0260869565217391
2021-06-20,"40 - 1114",138,302,129,9,164,0.934782608695652
2021-06-20,"53 - 1103",89,91,61,28,2,0.685393258426966
2021-06-20,"2 - 1066",20,73,20,0,53,1
2021-06-20,"82 - 1163",115,NA,3,112,NA,0.0260869565217391
2021-06-21,"40 - 1114",142,302,132,10,160,0.929577464788732
2021-06-21,"53 - 1103",89,91,62,27,2,0.696629213483146
2021-06-21,"2 - 1066",20,73,20,0,53,1
2021-06-21,"82 - 1163",115,NA,3,112,NA,0.0260869565217391
2021-06-22,"40 - 1114",145,302,133,12,157,0.917241379310345
2021-06-22,"53 - 1103",88,91,61,27,3,0.693181818181818
2021-06-22,"2 - 1066",20,73,20,0,53,1
2021-06-22,"82 - 1163",115,NA,4,111,NA,0.0347826086956522
2021-06-23,"40 - 1114",144,302,132,12,158,0.916666666666667
2021-06-23,"53 - 1103",89,91,64,25,2,0.719101123595506
2021-06-23,"2 - 1066",20,73,19,1,53,0.95
2021-06-23,"82 - 1163",115,NA,4,111,NA,0.0347826086956522
2021-06-24,"40 - 1114",144,302,133,11,158,0.923611111111111
2021-06-24,"53 - 1103",88,91,64,24,3,0.727272727272727
2021-06-24,"2 - 1066",19,73,19,0,54,1
2021-06-24,"82 - 1163",115,NA,5,110,NA,0.0434782608695652
2021-06-25,"40 - 1114",151,302,135,16,151,0.894039735099338
2021-06-25,"53 - 1103",88,91,63,25,3,0.715909090909091
2021-06-25,"2 - 1066",19,73,19,0,54,1
2021-06-25,"82 - 1163",116,NA,6,110,NA,0.0517241379310345
2021-06-26,"40 - 1114",151,302,135,16,151,0.894039735099338
2021-06-26,"53 - 1103",88,91,63,25,3,0.715909090909091
2021-06-26,"2 - 1066",20,73,20,0,53,1
2021-06-26,"82 - 1163",117,NA,6,111,NA,0.0512820512820513
2021-06-27,"40 - 1114",151,302,135,16,151,0.894039735099338
2021-06-27,"53 - 1103",88,91,62,26,3,0.704545454545455
2021-06-27,"2 - 1066",20,73,20,0,53,1
2021-06-27,"82 - 1163",117,NA,6,111,NA,0.0512820512820513
2021-06-28,"40 - 1114",147,302,138,9,155,0.938775510204082
2021-06-28,"53 - 1103",86,91,62,24,5,0.72093023255814
2021-06-28,"2 - 1066",20,73,20,0,53,1
2021-06-28,"82 - 1163",118,NA,8,110,NA,0.0677966101694915
2021-06-29,"40 - 1114",147,302,140,7,155,0.952380952380952
2021-06-29,"53 - 1103",86,91,64,22,5,0.744186046511628
2021-06-29,"2 - 1066",23,73,23,0,50,1
2021-06-29,"82 - 1163",118,NA,8,110,NA,0.0677966101694915
2021-06-30,"40 - 1114",170,302,143,27,132,0.841176470588235
2021-06-30,"53 - 1103",88,91,63,25,3,0.715909090909091
2021-06-30,"2 - 1066",22,73,22,0,51,1
2021-06-30,"82 - 1163",118,NA,8,110,NA,0.0677966101694915
2021-07-01,"40 - 1114",170,302,147,23,132,0.864705882352941
2021-07-01,"53 - 1103",84,91,62,22,7,0.738095238095238
2021-07-01,"2 - 1066",20,73,20,0,53,1
2021-07-01,"82 - 1163",118,NA,8,110,NA,0.0677966101694915
2021-07-02,"40 - 1114",172,302,148,24,130,0.86046511627907
2021-07-02,"53 - 1103",85,91,63,22,6,0.741176470588235
2021-07-02,"2 - 1066",19,73,19,0,54,1
2021-07-02,"82 - 1163",118,NA,10,108,NA,0.0847457627118644
2021-07-03,"40 - 1114",172,302,151,21,130,0.877906976744186
2021-07-03,"53 - 1103",85,91,64,21,6,0.752941176470588
2021-07-03,"2 - 1066",20,73,20,0,53,1
2021-07-03,"82 - 1163",118,NA,9,109,NA,0.076271186440678
2021-07-04,"40 - 1114",172,302,150,22,130,0.872093023255814
2021-07-04,"53 - 1103",81,91,64,17,10,0.790123456790123
2021-07-04,"2 - 1066",19,73,19,0,54,1
2021-07-04,"82 - 1163",118,NA,9,109,NA,0.076271186440678
2021-07-05,"40 - 1114",172,302,152,20,130,0.883720930232558
2021-07-05,"53 - 1103",77,91,65,12,14,0.844155844155844
2021-07-05,"2 - 1066",19,73,19,0,54,1
2021-07-05,"82 - 1163",118,NA,8,110,NA,0.0677966101694915
2021-07-06,"40 - 1114",174,302,154,20,128,0.885057471264368
2021-07-06,"53 - 1103",78,91,66,12,13,0.846153846153846
2021-07-06,"2 - 1066",19,73,19,0,54,1
2021-07-06,"82 - 1163",118,NA,11,107,NA,0.0932203389830508
2021-07-07,"40 - 1114",174,302,154,20,128,0.885057471264368
2021-07-07,"53 - 1103",80,91,64,16,11,0.8
2021-07-07,"2 - 1066",20,73,19,1,53,0.95
2021-07-07,"82 - 1163",66,NA,8,58,NA,0.121212121212121
2021-07-08,"40 - 1114",172,302,155,17,130,0.901162790697674
2021-07-08,"53 - 1103",61,91,61,0,30,1
2021-07-08,"2 - 1066",19,73,19,0,54,1
2021-07-08,"82 - 1163",66,NA,6,60,NA,0.0909090909090909
2021-07-09,"40 - 1114",179,230,157,22,51,0.877094972067039
2021-07-09,"53 - 1103",60,91,59,1,31,0.983333333333333
2021-07-09,"2 - 1066",19,73,19,0,54,1
2021-07-09,"82 - 1163",63,60,6,57,-3,0.0952380952380952
2021-07-10,"40 - 1114",181,232,158,23,51,0.87292817679558
2021-07-10,"53 - 1103",60,91,59,1,31,0.983333333333333
2021-07-10,"2 - 1066",20,73,20,0,53,1
2021-07-10,"82 - 1163",63,60,3,60,-3,0.0476190476190476
2021-07-11,"40 - 1114",179,230,160,19,51,0.893854748603352
2021-07-11,"53 - 1103",59,91,59,0,32,1
2021-07-11,"2 - 1066",20,73,20,0,53,1
2021-07-11,"82 - 1163",29,30,1,28,1,0.0344827586206897
2021-07-12,"40 - 1114",179,230,161,18,51,0.899441340782123
2021-07-12,"53 - 1103",59,91,58,1,32,0.983050847457627
2021-07-12,"2 - 1066",21,73,21,0,52,1
2021-07-12,"82 - 1163",29,30,1,28,1,0.0344827586206897
2021-07-13,"40 - 1114",183,232,157,26,49,0.85792349726776
2021-07-13,"53 - 1103",58,91,58,0,33,1
2021-07-13,"2 - 1066",19,73,19,0,54,1
2021-07-13,"82 - 1163",29,30,1,28,1,0.0344827586206897
2021-07-14,"40 - 1114",185,231,157,28,46,0.848648648648649
2021-07-14,"53 - 1103",57,91,57,0,34,1
2021-07-14,"2 - 1066",20,73,20,0,53,1
2021-07-14,"82 - 1163",63,60,3,60,-3,0.0476190476190476
2021-07-15,"40 - 1114",175,231,159,16,56,0.908571428571429
2021-07-15,"53 - 1103",56,91,56,0,35,1
2021-07-15,"2 - 1066",19,63,19,0,44,1
2021-07-15,"82 - 1163",63,60,4,59,-3,0.0634920634920635
2021-07-16,"40 - 1114",176,231,161,15,55,0.914772727272727
2021-07-16,"53 - 1103",55,91,55,0,36,1
2021-07-16,"2 - 1066",19,63,19,0,44,1
2021-07-16,"82 - 1163",63,60,4,59,-3,0.0634920634920635
2021-07-17,"40 - 1114",176,231,161,15,55,0.914772727272727
2021-07-17,"53 - 1103",55,91,55,0,36,1
2021-07-17,"2 - 1066",19,63,19,0,44,1
2021-07-17,"82 - 1163",34,30,2,32,-4,0.0588235294117647
2021-07-18,"40 - 1114",176,231,160,16,55,0.909090909090909
2021-07-18,"53 - 1103",55,91,55,0,36,1
2021-07-18,"2 - 1066",18,63,18,0,45,1
2021-07-18,"82 - 1163",34,30,1,33,-4,0.0294117647058824
2021-07-19,"40 - 1114",175,231,160,15,56,0.914285714285714
2021-07-19,"53 - 1103",53,91,53,0,38,1
2021-07-19,"2 - 1066",19,63,19,0,44,1
2021-07-19,"82 - 1163",62,60,2,60,-2,0.032258064516129
2021-07-20,"40 - 1114",175,231,161,14,56,0.92
2021-07-20,"53 - 1103",50,91,50,0,41,1
2021-07-20,"2 - 1066",20,63,20,0,43,1
2021-07-20,"82 - 1163",62,60,4,58,-2,0.0645161290322581
2021-07-21,"40 - 1114",180,231,163,17,51,0.905555555555556
2021-07-21,"53 - 1103",49,91,49,0,42,1
2021-07-21,"2 - 1066",21,63,21,0,42,1
2021-07-21,"82 - 1163",62,60,2,60,-2,0.032258064516129
2021-07-22,"40 - 1114",183,231,165,18,48,0.901639344262295
2021-07-22,"53 - 1103",48,91,48,0,43,1
2021-07-22,"2 - 1066",21,63,21,0,42,1
2021-07-22,"82 - 1163",28,30,2,26,2,0.0714285714285714
2021-07-23,"40 - 1114",181,231,166,15,50,0.917127071823204
2021-07-23,"53 - 1103",46,77,46,0,31,1
2021-07-23,"2 - 1066",21,63,21,0,42,1
2021-07-23,"82 - 1163",28,30,2,26,2,0.0714285714285714
2021-07-24,"40 - 1114",181,231,165,16,50,0.911602209944751
2021-07-24,"53 - 1103",45,77,45,0,32,1
2021-07-24,"2 - 1066",21,63,21,0,42,1
2021-07-24,"82 - 1163",62,60,3,59,-2,0.0483870967741935
2021-07-25,"40 - 1114",181,231,165,16,50,0.911602209944751
2021-07-25,"53 - 1103",45,77,45,0,32,1
2021-07-25,"2 - 1066",21,63,21,0,42,1
2021-07-25,"82 - 1163",62,60,4,58,-2,0.0645161290322581
2021-07-26,"40 - 1114",177,231,165,12,54,0.932203389830508
2021-07-26,"53 - 1103",44,77,43,1,33,0.977272727272727
2021-07-26,"2 - 1066",20,63,20,0,43,1
2021-07-26,"82 - 1163",62,60,5,57,-2,0.0806451612903226
2021-07-27,"40 - 1114",176,231,163,13,55,0.926136363636364
2021-07-27,"53 - 1103",43,77,43,0,34,1
2021-07-27,"2 - 1066",20,63,20,0,43,1
2021-07-27,"82 - 1163",62,60,4,58,-2,0.0645161290322581
2021-07-28,"40 - 1114",172,231,160,12,59,0.930232558139535
2021-07-28,"53 - 1103",39,91,39,0,52,1
2021-07-28,"2 - 1066",20,63,20,0,43,1
2021-07-28,"82 - 1163",62,60,2,60,-2,0.032258064516129
2021-07-29,"40 - 1114",172,231,159,13,59,0.924418604651163
2021-07-29,"53 - 1103",37,91,37,0,54,1
2021-07-29,"2 - 1066",20,63,20,0,43,1
2021-07-29,"82 - 1163",62,60,2,60,-2,0.032258064516129
2021-07-30,"40 - 1114",175,231,161,14,56,0.92
2021-07-30,"53 - 1103",36,91,34,2,55,0.944444444444444
2021-07-30,"2 - 1066",20,63,20,0,43,1
2021-07-30,"82 - 1163",62,60,2,60,-2,0.032258064516129
2021-07-31,"40 - 1114",176,231,161,15,55,0.914772727272727
2021-07-31,"53 - 1103",32,91,32,0,59,1
2021-07-31,"2 - 1066",19,63,19,0,44,1
2021-07-31,"82 - 1163",62,60,2,60,-2,0.032258064516129
2021-08-01,"40 - 1114",176,231,163,13,55,0.926136363636364
2021-08-01,"53 - 1103",32,91,32,0,59,1
2021-08-01,"2 - 1066",19,63,19,0,44,1
2021-08-01,"82 - 1163",62,60,3,59,-2,0.0483870967741935
2021-08-02,"40 - 1114",176,231,163,13,55,0.926136363636364
2021-08-02,"53 - 1103",32,91,32,0,59,1
2021-08-02,"2 - 1066",19,63,19,0,44,1
2021-08-02,"82 - 1163",62,60,2,60,-2,0.032258064516129
2021-08-03,"40 - 1114",179,231,165,14,52,0.921787709497207
2021-08-03,"53 - 1103",31,91,31,0,60,1
2021-08-03,"2 - 1066",18,63,18,0,45,1
2021-08-03,"82 - 1163",62,60,4,58,-2,0.0645161290322581
2021-08-04,"40 - 1114",180,231,166,14,51,0.922222222222222
2021-08-04,"53 - 1103",33,91,33,0,58,1
2021-08-04,"2 - 1066",18,63,18,0,45,1
2021-08-04,"82 - 1163",62,60,4,58,-2,0.0645161290322581
2021-08-05,"40 - 1114",167,231,164,3,64,0.982035928143713
2021-08-05,"53 - 1103",33,91,33,0,58,1
2021-08-05,"2 - 1066",18,63,18,0,45,1
2021-08-05,"82 - 1163",62,60,7,55,-2,0.112903225806452
2021-08-06,"40 - 1114",171,231,165,6,60,0.964912280701754
2021-08-06,"53 - 1103",33,91,33,0,58,1
2021-08-06,"2 - 1066",18,63,18,0,45,1
2021-08-06,"82 - 1163",62,60,10,52,-2,0.161290322580645
2021-08-07,"40 - 1114",171,231,165,6,60,0.964912280701754
2021-08-07,"53 - 1103",33,91,33,0,58,1
2021-08-07,"2 - 1066",19,63,19,0,44,1
2021-08-07,"82 - 1163",62,60,7,55,-2,0.112903225806452
2021-08-08,"40 - 1114",171,231,163,8,60,0.953216374269006
2021-08-08,"53 - 1103",33,91,33,0,58,1
2021-08-08,"2 - 1066",18,63,18,0,45,1
2021-08-08,"82 - 1163",62,60,6,56,-2,0.0967741935483871
2021-08-09,"40 - 1114",168,231,162,6,63,0.964285714285714
2021-08-09,"53 - 1103",33,91,33,0,58,1
2021-08-09,"2 - 1066",17,63,17,0,46,1
2021-08-09,"82 - 1163",62,60,5,57,-2,0.0806451612903226
2021-08-10,"40 - 1114",167,231,161,6,64,0.964071856287425
2021-08-10,"53 - 1103",33,91,33,0,58,1
2021-08-10,"2 - 1066",17,63,17,0,46,1
2021-08-10,"82 - 1163",62,60,4,58,-2,0.0645161290322581
2021-08-11,"40 - 1114",167,231,159,8,64,0.952095808383233
2021-08-11,"53 - 1103",33,91,33,0,58,1
2021-08-11,"2 - 1066",18,63,18,0,45,1
2021-08-11,"82 - 1163",62,60,4,58,-2,0.0645161290322581
2021-08-12,"40 - 1114",167,231,162,5,64,0.970059880239521
2021-08-12,"53 - 1103",33,91,33,0,58,1
2021-08-12,"2 - 1066",18,63,18,0,45,1
2021-08-12,"82 - 1163",62,60,5,57,-2,0.0806451612903226
2021-08-13,"40 - 1114",168,231,162,6,63,0.964285714285714
2021-08-13,"53 - 1103",33,91,33,0,58,1
2021-08-13,"2 - 1066",19,63,19,0,44,1
2021-08-13,"82 - 1163",62,60,4,58,-2,0.0645161290322581
2021-08-14,"40 - 1114",168,231,162,6,63,0.964285714285714
2021-08-14,"53 - 1103",33,91,33,0,58,1
2021-08-14,"2 - 1066",21,63,21,0,42,1
2021-08-14,"82 - 1163",62,60,4,58,-2,0.0645161290322581
2021-08-15,"40 - 1114",168,231,162,6,63,0.964285714285714
2021-08-15,"53 - 1103",33,91,33,0,58,1
2021-08-15,"2 - 1066",22,63,22,0,41,1
2021-08-15,"82 - 1163",34,30,3,31,-4,0.0882352941176471
2021-08-16,"40 - 1114",170,231,164,6,61,0.964705882352941
2021-08-16,"53 - 1103",33,91,33,0,58,1
2021-08-16,"2 - 1066",23,63,23,0,40,1
2021-08-16,"82 - 1163",34,30,5,29,-4,0.147058823529412
2021-08-17,"40 - 1114",170,231,164,6,61,0.964705882352941
2021-08-17,"53 - 1103",33,91,32,1,58,0.96969696969697
2021-08-17,"2 - 1066",23,63,23,0,40,1
2021-08-17,"82 - 1163",34,30,5,29,-4,0.147058823529412
2021-08-18,"40 - 1114",166,231,161,5,65,0.969879518072289
2021-08-18,"53 - 1103",32,91,32,0,59,1
2021-08-18,"2 - 1066",24,63,24,0,39,1
2021-08-18,"82 - 1163",34,30,8,26,-4,0.235294117647059
2021-08-19,"40 - 1114",165,231,161,4,66,0.975757575757576
2021-08-19,"53 - 1103",33,91,33,0,58,1
2021-08-19,"2 - 1066",24,63,23,1,39,0.958333333333333
2021-08-19,"82 - 1163",63,60,13,50,-3,0.206349206349206
2021-08-20,"40 - 1114",165,231,162,3,66,0.981818181818182
2021-08-20,"53 - 1103",33,91,33,0,58,1
2021-08-20,"2 - 1066",22,63,22,0,41,1
2021-08-20,"82 - 1163",63,60,8,55,-3,0.126984126984127
2021-08-21,"40 - 1114",165,231,163,2,66,0.987878787878788
2021-08-21,"53 - 1103",33,91,32,1,58,0.96969696969697
2021-08-21,"2 - 1066",20,63,20,0,43,1
2021-08-21,"82 - 1163",63,60,8,55,-3,0.126984126984127
2021-08-22,"40 - 1114",165,231,163,2,66,0.987878787878788
2021-08-22,"53 - 1103",31,91,31,0,60,1
2021-08-22,"2 - 1066",19,63,19,0,44,1
2021-08-22,"82 - 1163",63,60,9,54,-3,0.142857142857143
2021-08-23,"40 - 1114",165,231,163,2,66,0.987878787878788
2021-08-23,"53 - 1103",31,91,31,0,60,1
2021-08-23,"2 - 1066",19,63,19,0,44,1
2021-08-23,"82 - 1163",63,60,10,53,-3,0.158730158730159
2021-08-24,"40 - 1114",163,231,160,3,68,0.98159509202454
2021-08-24,"53 - 1103",31,91,31,0,60,1
2021-08-24,"2 - 1066",17,63,17,0,46,1
2021-08-24,"82 - 1163",63,60,9,54,-3,0.142857142857143
2021-08-25,"40 - 1114",162,231,160,2,69,0.987654320987654
2021-08-25,"53 - 1103",30,91,30,0,61,1
2021-08-25,"2 - 1066",17,63,17,0,46,1
2021-08-25,"82 - 1163",63,60,10,53,-3,0.158730158730159
2021-08-26,"40 - 1114",163,231,160,3,68,0.98159509202454
2021-08-26,"53 - 1103",31,91,30,1,60,0.967741935483871
2021-08-26,"2 - 1066",19,63,19,0,44,1
2021-08-26,"82 - 1163",63,60,8,55,-3,0.126984126984127
2021-08-27,"40 - 1114",163,231,160,3,68,0.98159509202454
2021-08-27,"53 - 1103",31,91,30,1,60,0.967741935483871
2021-08-27,"2 - 1066",17,63,17,0,46,1
2021-08-27,"82 - 1163",63,60,10,53,-3,0.158730158730159
2021-08-28,"40 - 1114",163,231,160,3,68,0.98159509202454
2021-08-28,"53 - 1103",30,91,30,0,61,1
2021-08-28,"2 - 1066",17,63,17,0,46,1
2021-08-28,"82 - 1163",63,60,9,54,-3,0.142857142857143
2021-08-29,"40 - 1114",163,231,160,3,68,0.98159509202454
2021-08-29,"53 - 1103",30,91,30,0,61,1
2021-08-29,"2 - 1066",17,63,17,0,46,1
2021-08-29,"82 - 1163",63,60,9,54,-3,0.142857142857143
2021-08-30,"40 - 1114",163,231,159,4,68,0.975460122699387
2021-08-30,"53 - 1103",31,91,30,1,60,0.967741935483871
2021-08-30,"2 - 1066",18,63,18,0,45,1
2021-08-30,"82 - 1163",63,60,7,56,-3,0.111111111111111
2021-08-31,"40 - 1114",164,231,159,5,67,0.969512195121951
2021-08-31,"53 - 1103",30,91,30,0,61,1
2021-08-31,"2 - 1066",20,63,20,0,43,1
2021-08-31,"82 - 1163",63,60,11,52,-3,0.174603174603175
2021-09-01,"40 - 1114",163,231,161,2,68,0.987730061349693
2021-09-01,"53 - 1103",29,91,29,0,62,1
2021-09-01,"2 - 1066",20,63,20,0,43,1
2021-09-01,"82 - 1163",63,60,11,52,-3,0.174603174603175
2021-09-02,"40 - 1114",163,231,161,2,68,0.987730061349693
2021-09-02,"53 - 1103",28,91,28,0,63,1
2021-09-02,"2 - 1066",23,63,23,0,40,1
2021-09-02,"82 - 1163",63,60,10,53,-3,0.158730158730159
2021-09-03,"40 - 1114",161,231,159,2,70,0.987577639751553
2021-09-03,"53 - 1103",28,91,28,0,63,1
2021-09-03,"2 - 1066",23,63,23,0,40,1
2021-09-03,"82 - 1163",63,60,10,53,-3,0.158730158730159
2021-09-04,"40 - 1114",161,231,159,2,70,0.987577639751553
2021-09-04,"53 - 1103",28,91,28,0,63,1
2021-09-04,"2 - 1066",23,63,23,0,40,1
2021-09-04,"82 - 1163",63,60,10,53,-3,0.158730158730159
2021-09-05,"40 - 1114",161,231,158,3,70,0.981366459627329
2021-09-05,"53 - 1103",28,91,28,0,63,1
2021-09-05,"2 - 1066",23,63,23,0,40,1
2021-09-05,"82 - 1163",63,60,10,53,-3,0.158730158730159
2021-09-06,"40 - 1114",161,231,158,3,70,0.981366459627329
2021-09-06,"53 - 1103",28,91,28,0,63,1
2021-09-06,"2 - 1066",24,63,24,0,39,1
2021-09-06,"82 - 1163",63,60,10,53,-3,0.158730158730159
2021-09-07,"40 - 1114",161,231,158,3,70,0.981366459627329
2021-09-07,"53 - 1103",28,91,28,0,63,1
2021-09-07,"2 - 1066",25,63,25,0,38,1
2021-09-07,"82 - 1163",63,60,9,54,-3,0.142857142857143
2021-09-08,"40 - 1114",158,231,157,1,73,0.993670886075949
2021-09-08,"53 - 1103",28,91,28,0,63,1
2021-09-08,"2 - 1066",26,63,26,0,37,1
2021-09-08,"82 - 1163",63,60,10,53,-3,0.158730158730159
2021-09-09,"40 - 1114",158,231,157,1,73,0.993670886075949
2021-09-09,"53 - 1103",28,91,28,0,63,1
2021-09-09,"2 - 1066",27,63,27,0,36,1
2021-09-09,"82 - 1163",63,60,10,53,-3,0.158730158730159
2021-09-10,"40 - 1114",161,231,159,2,70,0.987577639751553
2021-09-10,"53 - 1103",27,77,27,0,50,1
2021-09-10,"2 - 1066",26,63,26,0,37,1
2021-09-10,"82 - 1163",63,60,12,51,-3,0.19047619047619
2021-09-11,"40 - 1114",161,231,156,5,70,0.968944099378882
2021-09-11,"53 - 1103",27,77,27,0,50,1
2021-09-11,"2 - 1066",26,63,26,0,37,1
2021-09-11,"82 - 1163",63,60,7,56,-3,0.111111111111111
2021-09-12,"40 - 1114",161,231,154,7,70,0.956521739130435
2021-09-12,"53 - 1103",27,77,27,0,50,1
2021-09-12,"2 - 1066",26,63,25,1,37,0.961538461538462
2021-09-12,"82 - 1163",63,60,6,57,-3,0.0952380952380952
2021-09-13,"40 - 1114",163,231,156,7,68,0.957055214723926
2021-09-13,"53 - 1103",31,77,27,4,46,0.870967741935484
2021-09-13,"2 - 1066",25,63,25,0,38,1
2021-09-13,"82 - 1163",63,60,12,51,-3,0.19047619047619
2021-09-14,"40 - 1114",163,231,156,7,68,0.957055214723926
2021-09-14,"53 - 1103",31,77,27,4,46,0.870967741935484
2021-09-14,"2 - 1066",26,63,26,0,37,1
2021-09-14,"82 - 1163",63,60,12,51,-3,0.19047619047619
2021-09-15,"40 - 1114",163,231,156,7,68,0.957055214723926
2021-09-15,"53 - 1103",32,77,27,5,45,0.84375
2021-09-15,"2 - 1066",26,63,26,0,37,1
2021-09-15,"82 - 1163",63,60,17,46,-3,0.26984126984127
2021-09-16,"40 - 1114",163,231,156,7,68,0.957055214723926
2021-09-16,"53 - 1103",27,77,27,0,50,1
2021-09-16,"2 - 1066",26,63,26,0,37,1
2021-09-16,"82 - 1163",63,60,19,44,-3,0.301587301587302
2021-09-17,"40 - 1114",162,231,156,6,69,0.962962962962963
2021-09-17,"53 - 1103",27,77,27,0,50,1
2021-09-17,"2 - 1066",26,63,26,0,37,1
2021-09-17,"82 - 1163",63,60,20,43,-3,0.317460317460317
2021-09-18,"40 - 1114",162,231,155,7,69,0.95679012345679
2021-09-18,"53 - 1103",27,77,27,0,50,1
2021-09-18,"2 - 1066",26,63,26,0,37,1
2021-09-18,"82 - 1163",63,60,20,43,-3,0.317460317460317
2021-09-19,"40 - 1114",162,231,155,7,69,0.95679012345679
2021-09-19,"53 - 1103",27,77,27,0,50,1
2021-09-19,"2 - 1066",26,63,26,0,37,1
2021-09-19,"82 - 1163",63,60,18,45,-3,0.285714285714286
2021-09-20,"40 - 1114",160,229,155,5,69,0.96875
2021-09-20,"53 - 1103",33,77,28,5,44,0.848484848484849
2021-09-20,"2 - 1066",24,63,24,0,39,1
2021-09-20,"82 - 1163",63,60,19,44,-3,0.301587301587302
2021-09-21,"40 - 1114",160,229,155,5,69,0.96875
2021-09-21,"53 - 1103",33,77,28,5,44,0.848484848484849
2021-09-21,"2 - 1066",25,63,25,0,38,1
2021-09-21,"82 - 1163",63,60,18,45,-3,0.285714285714286
2021-09-22,"40 - 1114",160,229,156,4,69,0.975
2021-09-22,"53 - 1103",33,77,28,5,44,0.848484848484849
2021-09-22,"2 - 1066",27,63,27,0,36,1
2021-09-22,"82 - 1163",63,60,20,43,-3,0.317460317460317
2021-09-23,"40 - 1114",159,229,156,3,70,0.981132075471698
2021-09-23,"53 - 1103",33,77,28,5,44,0.848484848484849
2021-09-23,"2 - 1066",27,63,27,0,36,1
2021-09-23,"82 - 1163",63,60,19,44,-3,0.301587301587302
2021-09-24,"40 - 1114",159,229,155,4,70,0.974842767295597
2021-09-24,"53 - 1103",33,77,30,3,44,0.909090909090909
2021-09-24,"2 - 1066",27,63,27,0,36,1
2021-09-24,"82 - 1163",63,60,17,46,-3,0.26984126984127
2021-09-25,"40 - 1114",159,229,155,4,70,0.974842767295597
2021-09-25,"53 - 1103",31,77,31,0,46,1
2021-09-25,"2 - 1066",27,63,27,0,36,1
2021-09-25,"82 - 1163",63,60,15,48,-3,0.238095238095238
2021-09-26,"40 - 1114",159,229,154,5,70,0.968553459119497
2021-09-26,"53 - 1103",31,77,30,1,46,0.967741935483871
2021-09-26,"2 - 1066",27,63,27,0,36,1
2021-09-26,"82 - 1163",63,60,13,50,-3,0.206349206349206
2021-09-27,"40 - 1114",160,229,158,2,69,0.9875
2021-09-27,"53 - 1103",30,77,30,0,47,1
2021-09-27,"2 - 1066",27,63,27,0,36,1
2021-09-27,"82 - 1163",63,60,13,50,-3,0.206349206349206
2021-09-28,"40 - 1114",158,229,158,0,71,1
2021-09-28,"53 - 1103",30,77,29,1,47,0.966666666666667
2021-09-28,"2 - 1066",27,63,27,0,36,1
2021-09-28,"82 - 1163",63,60,10,53,-3,0.158730158730159
2021-09-29,"40 - 1114",157,229,157,0,72,1
2021-09-29,"53 - 1103",28,77,28,0,49,1
2021-09-29,"2 - 1066",27,63,27,0,36,1
2021-09-29,"82 - 1163",63,60,14,49,-3,0.222222222222222
2021-09-30,"40 - 1114",161,229,161,0,68,1
2021-09-30,"53 - 1103",28,77,27,1,49,0.964285714285714
2021-09-30,"2 - 1066",28,63,28,0,35,1
2021-09-30,"82 - 1163",63,60,16,47,-3,0.253968253968254
2021-10-01,"40 - 1114",166,230,162,4,64,0.975903614457831
2021-10-01,"53 - 1103",27,77,27,0,50,1
2021-10-01,"2 - 1066",30,63,30,0,33,1
2021-10-01,"82 - 1163",63,60,16,47,-3,0.253968253968254
2021-10-02,"40 - 1114",166,230,162,4,64,0.975903614457831
2021-10-02,"53 - 1103",30,77,27,3,47,0.9
2021-10-02,"2 - 1066",31,63,31,0,32,1
2021-10-02,"82 - 1163",63,60,15,48,-3,0.238095238095238
2021-10-03,"40 - 1114",166,230,162,4,64,0.975903614457831
2021-10-03,"53 - 1103",27,77,27,0,50,1
2021-10-03,"2 - 1066",32,63,32,0,31,1
2021-10-03,"82 - 1163",63,60,13,50,-3,0.206349206349206
2021-10-04,"40 - 1114",165,230,164,1,65,0.993939393939394
2021-10-04,"53 - 1103",47,77,29,18,30,0.617021276595745
2021-10-04,"2 - 1066",33,63,33,0,30,1
2021-10-04,"82 - 1163",63,60,16,47,-3,0.253968253968254
2021-10-05,"40 - 1114",168,230,163,5,62,0.970238095238095
2021-10-05,"53 - 1103",45,77,29,16,32,0.644444444444444
2021-10-05,"2 - 1066",34,63,34,0,29,1
2021-10-05,"82 - 1163",63,60,10,53,-3,0.158730158730159
2021-10-06,"40 - 1114",168,230,163,5,62,0.970238095238095
2021-10-06,"53 - 1103",45,77,30,15,32,0.666666666666667
2021-10-06,"2 - 1066",35,63,35,0,28,1
2021-10-06,"82 - 1163",63,60,8,55,-3,0.126984126984127
2021-10-07,"40 - 1114",175,230,166,9,55,0.948571428571429
2021-10-07,"53 - 1103",58,77,33,25,19,0.568965517241379
2021-10-07,"2 - 1066",35,63,35,0,28,1
2021-10-07,"82 - 1163",63,60,10,53,-3,0.158730158730159
2021-10-08,"40 - 1114",189,230,180,9,41,0.952380952380952
2021-10-08,"53 - 1103",59,77,38,21,18,0.64406779661017
2021-10-08,"2 - 1066",35,63,35,0,28,1
2021-10-08,"82 - 1163",63,60,9,54,-3,0.142857142857143
2021-10-09,"40 - 1114",190,230,183,7,40,0.963157894736842
2021-10-09,"53 - 1103",59,77,39,20,18,0.661016949152542
2021-10-09,"2 - 1066",34,63,34,0,29,1
2021-10-09,"82 - 1163",63,60,8,55,-3,0.126984126984127
2021-10-10,"40 - 1114",190,230,184,6,40,0.968421052631579
2021-10-10,"53 - 1103",56,77,38,18,21,0.678571428571429
2021-10-10,"2 - 1066",34,63,34,0,29,1
2021-10-10,"82 - 1163",63,60,9,54,-3,0.142857142857143
2021-10-11,"40 - 1114",190,230,185,5,40,0.973684210526316
2021-10-11,"53 - 1103",55,77,37,18,22,0.672727272727273
2021-10-11,"2 - 1066",34,63,34,0,29,1
2021-10-11,"82 - 1163",63,60,11,52,-3,0.174603174603175
2021-10-12,"40 - 1114",192,230,189,3,38,0.984375
2021-10-12,"53 - 1103",55,77,36,19,22,0.654545454545455
2021-10-12,"2 - 1066",34,63,34,0,29,1
2021-10-12,"82 - 1163",63,60,11,52,-3,0.174603174603175
2021-10-13,"40 - 1114",199,230,196,3,31,0.984924623115578
2021-10-13,"53 - 1103",73,77,37,36,4,0.506849315068493
2021-10-13,"2 - 1066",34,63,34,0,29,1
2021-10-13,"82 - 1163",63,60,10,53,-3,0.158730158730159
2021-10-14,"40 - 1114",204,232,203,1,28,0.995098039215686
2021-10-14,"53 - 1103",39,77,39,0,38,1
2021-10-14,"2 - 1066",35,63,35,0,28,1
2021-10-14,"82 - 1163",63,60,10,53,-3,0.158730158730159
2021-10-15,"40 - 1114",208,232,204,4,24,0.980769230769231
2021-10-15,"53 - 1103",37,77,36,1,40,0.972972972972973
2021-10-15,"2 - 1066",35,63,35,0,28,1
2021-10-15,"82 - 1163",63,60,8,55,-3,0.126984126984127
2021-10-16,"40 - 1114",208,232,204,4,24,0.980769230769231
2021-10-16,"53 - 1103",37,77,37,0,40,1
2021-10-16,"2 - 1066",35,63,35,0,28,1
2021-10-16,"82 - 1163",63,60,8,55,-3,0.126984126984127
2021-10-17,"40 - 1114",208,232,203,5,24,0.975961538461538
2021-10-17,"53 - 1103",37,77,37,0,40,1
2021-10-17,"2 - 1066",34,63,34,0,29,1
2021-10-17,"82 - 1163",63,60,9,54,-3,0.142857142857143
2021-10-18,"40 - 1114",210,232,208,2,22,0.99047619047619
2021-10-18,"53 - 1103",37,77,37,0,40,1
2021-10-18,"2 - 1066",34,63,34,0,29,1
2021-10-18,"82 - 1163",63,60,8,55,-3,0.126984126984127
2021-10-19,"40 - 1114",211,232,207,4,21,0.981042654028436
2021-10-19,"53 - 1103",38,77,37,1,39,0.973684210526316
2021-10-19,"2 - 1066",34,63,34,0,29,1
2021-10-19,"82 - 1163",63,60,8,55,-3,0.126984126984127
2021-10-20,"40 - 1114",210,232,206,4,22,0.980952380952381
2021-10-20,"53 - 1103",38,77,36,2,39,0.947368421052632
2021-10-20,"2 - 1066",34,63,34,0,29,1
2021-10-20,"82 - 1163",63,60,6,57,-3,0.0952380952380952
2021-10-21,"40 - 1114",207,233,204,3,26,0.985507246376812
2021-10-21,"53 - 1103",38,77,35,3,39,0.921052631578947
2021-10-21,"2 - 1066",34,63,34,0,29,1
2021-10-21,"82 - 1163",63,60,4,59,-3,0.0634920634920635
2021-10-22,"40 - 1114",209,233,205,4,24,0.980861244019139
2021-10-22,"53 - 1103",39,77,35,4,38,0.897435897435897
2021-10-22,"2 - 1066",35,63,35,0,28,1
2021-10-22,"82 - 1163",63,60,6,57,-3,0.0952380952380952
2021-10-23,"40 - 1114",209,233,207,2,24,0.990430622009569
2021-10-23,"53 - 1103",39,77,35,4,38,0.897435897435897
2021-10-23,"2 - 1066",35,63,35,0,28,1
2021-10-23,"82 - 1163",33,30,2,31,-3,0.0606060606060606
2021-10-24,"40 - 1114",209,233,208,1,24,0.995215311004785
2021-10-24,"53 - 1103",39,77,35,4,38,0.897435897435897
2021-10-24,"2 - 1066",35,63,35,0,28,1
2021-10-24,"82 - 1163",33,30,2,31,-3,0.0606060606060606
2021-10-25,"40 - 1114",212,233,209,3,21,0.985849056603774
2021-10-25,"53 - 1103",39,77,37,2,38,0.948717948717949
2021-10-25,"2 - 1066",35,63,35,0,28,1
2021-10-25,"82 - 1163",33,30,4,29,-3,0.121212121212121
2021-10-26,"40 - 1114",214,233,212,2,19,0.990654205607477
2021-10-26,"53 - 1103",38,77,38,0,39,1
2021-10-26,"2 - 1066",33,63,33,0,30,1
2021-10-26,"82 - 1163",33,30,4,29,-3,0.121212121212121
2021-10-27,"40 - 1114",218,233,213,5,15,0.977064220183486
2021-10-27,"53 - 1103",59,77,45,14,18,0.76271186440678
2021-10-27,"2 - 1066",33,63,33,0,30,1
2021-10-27,"82 - 1163",33,30,2,31,-3,0.0606060606060606
2021-10-28,"40 - 1114",221,233,213,8,12,0.963800904977376
2021-10-28,"53 - 1103",56,77,55,1,21,0.982142857142857
2021-10-28,"2 - 1066",33,63,33,0,30,1
2021-10-28,"82 - 1163",33,30,2,31,-3,0.0606060606060606
2021-10-29,"40 - 1114",217,233,214,3,16,0.986175115207373
2021-10-29,"53 - 1103",57,77,57,0,20,1
2021-10-29,"2 - 1066",33,63,33,0,30,1
2021-10-29,"82 - 1163",33,30,3,30,-3,0.0909090909090909
2021-10-30,"40 - 1114",217,233,216,1,16,0.995391705069124
2021-10-30,"53 - 1103",56,77,56,0,21,1
2021-10-30,"2 - 1066",34,63,34,0,29,1
2021-10-30,"82 - 1163",33,30,3,30,-3,0.0909090909090909
2021-10-31,"40 - 1114",219,233,217,2,14,0.990867579908676
2021-10-31,"53 - 1103",57,77,55,2,20,0.964912280701754
2021-10-31,"2 - 1066",34,63,34,0,29,1
2021-10-31,"82 - 1163",33,30,2,31,-3,0.0606060606060606
2021-11-01,"40 - 1114",220,233,218,2,13,0.990909090909091
2021-11-01,"53 - 1103",56,77,56,0,21,1
2021-11-01,"2 - 1066",31,63,31,0,32,1
2021-11-01,"82 - 1163",33,30,3,30,-3,0.0909090909090909
2021-11-02,"40 - 1114",220,233,220,0,13,1
2021-11-02,"53 - 1103",57,77,57,0,20,1
2021-11-02,"2 - 1066",34,73,34,0,39,1
2021-11-02,"82 - 1163",33,30,2,31,-3,0.0606060606060606
2021-11-03,"40 - 1114",218,233,218,0,15,1
2021-11-03,"53 - 1103",57,77,57,0,20,1
2021-11-03,"2 - 1066",34,73,34,0,39,1
2021-11-03,"82 - 1163",33,30,3,30,-3,0.0909090909090909
2021-11-04,"40 - 1114",224,233,223,1,9,0.995535714285714
2021-11-04,"53 - 1103",58,77,57,1,19,0.982758620689655
2021-11-04,"2 - 1066",35,73,35,0,38,1
2021-11-04,"82 - 1163",33,30,6,27,-3,0.181818181818182
2021-11-05,"40 - 1114",225,233,222,3,8,0.986666666666667
2021-11-05,"53 - 1103",54,77,54,0,23,1
2021-11-05,"2 - 1066",34,73,34,0,39,1
2021-11-05,"82 - 1163",33,30,4,29,-3,0.121212121212121
2021-11-06,"40 - 1114",225,233,225,0,8,1
2021-11-06,"53 - 1103",54,77,54,0,23,1
2021-11-06,"2 - 1066",34,73,34,0,39,1
2021-11-06,"82 - 1163",33,30,3,30,-3,0.0909090909090909
2021-11-07,"40 - 1114",225,233,225,0,8,1
2021-11-07,"53 - 1103",55,77,53,2,22,0.963636363636364
2021-11-07,"2 - 1066",34,73,34,0,39,1
2021-11-07,"82 - 1163",63,60,4,59,-3,0.0634920634920635
2021-11-08,"40 - 1114",226,233,226,0,7,1
2021-11-08,"53 - 1103",55,77,53,2,22,0.963636363636364
2021-11-08,"2 - 1066",34,73,34,0,39,1
2021-11-08,"82 - 1163",33,30,2,31,-3,0.0606060606060606
2021-11-09,"40 - 1114",226,233,226,0,7,1
2021-11-09,"53 - 1103",56,77,53,3,21,0.946428571428571
2021-11-09,"2 - 1066",34,73,34,0,39,1
2021-11-09,"82 - 1163",33,30,7,26,-3,0.212121212121212
2021-11-10,"40 - 1114",224,233,224,0,9,1
2021-11-10,"53 - 1103",58,77,54,4,19,0.931034482758621
2021-11-10,"2 - 1066",34,73,34,0,39,1
2021-11-10,"82 - 1163",33,30,4,29,-3,0.121212121212121
2021-11-11,"40 - 1114",223,233,223,0,10,1
2021-11-11,"53 - 1103",58,77,54,4,19,0.931034482758621
2021-11-11,"2 - 1066",34,73,34,0,39,1
2021-11-11,"82 - 1163",33,30,5,28,-3,0.151515151515152
2021-11-12,"40 - 1114",224,232,224,0,8,1
2021-11-12,"53 - 1103",58,77,54,4,19,0.931034482758621
2021-11-12,"2 - 1066",34,73,34,0,39,1
2021-11-12,"82 - 1163",33,30,5,28,-3,0.151515151515152
2021-11-13,"40 - 1114",224,232,224,0,8,1
2021-11-13,"53 - 1103",59,77,54,5,18,0.915254237288136
2021-11-13,"2 - 1066",34,73,34,0,39,1
2021-11-13,"82 - 1163",33,30,1,32,-3,0.0303030303030303
2021-11-14,"40 - 1114",226,232,225,1,6,0.995575221238938
2021-11-14,"53 - 1103",57,77,54,3,20,0.947368421052632
2021-11-14,"2 - 1066",34,73,34,0,39,1
2021-11-14,"82 - 1163",63,60,2,61,-3,0.0317460317460317
2021-11-15,"40 - 1114",226,232,224,2,6,0.991150442477876
2021-11-15,"53 - 1103",77,77,56,21,0,0.727272727272727
2021-11-15,"2 - 1066",35,73,35,0,38,1
2021-11-15,"82 - 1163",63,60,3,60,-3,0.0476190476190476
2021-11-16,"40 - 1114",224,232,224,0,8,1
2021-11-16,"53 - 1103",89,91,69,20,2,0.775280898876405
2021-11-16,"2 - 1066",34,73,34,0,39,1
2021-11-16,"82 - 1163",63,60,6,57,-3,0.0952380952380952
2021-11-17,"40 - 1114",224,232,224,0,8,1
2021-11-17,"53 - 1103",89,91,76,13,2,0.853932584269663
2021-11-17,"2 - 1066",35,73,35,0,38,1
2021-11-17,"82 - 1163",63,60,14,49,-3,0.222222222222222
2021-11-18,"40 - 1114",223,232,223,0,9,1
2021-11-18,"53 - 1103",86,91,75,11,5,0.872093023255814
2021-11-18,"2 - 1066",36,73,36,0,37,1
2021-11-18,"82 - 1163",63,60,14,49,-3,0.222222222222222
2021-11-19,"40 - 1114",225,232,225,0,7,1
2021-11-19,"53 - 1103",88,91,81,7,3,0.920454545454545
2021-11-19,"2 - 1066",41,73,36,5,32,0.878048780487805
2021-11-19,"82 - 1163",63,60,12,51,-3,0.19047619047619
2021-11-20,"40 - 1114",227,232,226,1,5,0.995594713656388
2021-11-20,"53 - 1103",88,91,81,7,3,0.920454545454545
2021-11-20,"2 - 1066",42,73,37,5,31,0.880952380952381
2021-11-20,"82 - 1163",63,60,11,52,-3,0.174603174603175
2021-11-21,"40 - 1114",227,232,226,1,5,0.995594713656388
2021-11-21,"53 - 1103",88,91,80,8,3,0.909090909090909
2021-11-21,"2 - 1066",41,73,36,5,32,0.878048780487805
2021-11-21,"82 - 1163",63,60,9,54,-3,0.142857142857143
2021-11-22,"40 - 1114",227,232,227,0,5,1
2021-11-22,"53 - 1103",87,91,81,6,4,0.931034482758621
2021-11-22,"2 - 1066",41,73,36,5,32,0.878048780487805
2021-11-22,"82 - 1163",63,60,12,51,-3,0.19047619047619
2021-11-23,"40 - 1114",227,232,227,0,5,1
2021-11-23,"53 - 1103",90,91,85,5,1,0.944444444444444
2021-11-23,"2 - 1066",41,73,36,5,32,0.878048780487805
2021-11-23,"82 - 1163",64,60,12,52,-4,0.1875
2021-11-24,"40 - 1114",227,232,227,0,5,1
2021-11-24,"53 - 1103",89,91,86,3,2,0.966292134831461
2021-11-24,"2 - 1066",41,73,36,5,32,0.878048780487805
2021-11-24,"82 - 1163",64,60,15,49,-4,0.234375
2021-11-25,"40 - 1114",227,232,227,0,5,1
2021-11-25,"53 - 1103",88,91,87,1,3,0.988636363636364
2021-11-25,"2 - 1066",42,73,38,4,31,0.904761904761905
2021-11-25,"82 - 1163",64,60,15,49,-4,0.234375
2021-11-26,"40 - 1114",227,232,227,0,5,1
2021-11-26,"53 - 1103",88,91,86,2,3,0.977272727272727
2021-11-26,"2 - 1066",43,73,38,5,30,0.883720930232558
2021-11-26,"82 - 1163",64,60,15,49,-4,0.234375
2021-11-27,"40 - 1114",227,232,227,0,5,1
2021-11-27,"53 - 1103",85,91,84,1,6,0.988235294117647
2021-11-27,"2 - 1066",44,73,39,5,29,0.886363636363636
2021-11-27,"82 - 1163",65,60,16,49,-5,0.246153846153846
2021-11-28,"40 - 1114",227,232,227,0,5,1
2021-11-28,"53 - 1103",85,91,84,1,6,0.988235294117647
2021-11-28,"2 - 1066",44,73,39,5,29,0.886363636363636
2021-11-28,"82 - 1163",65,60,14,51,-5,0.215384615384615
2021-11-29,"40 - 1114",227,232,227,0,5,1
2021-11-29,"53 - 1103",84,91,81,3,7,0.964285714285714
2021-11-29,"2 - 1066",44,73,39,5,29,0.886363636363636
2021-11-29,"82 - 1163",65,60,15,50,-5,0.230769230769231
2021-11-30,"40 - 1114",228,232,228,0,4,1
2021-11-30,"53 - 1103",84,91,83,1,7,0.988095238095238
2021-11-30,"2 - 1066",44,73,39,5,29,0.886363636363636
2021-11-30,"82 - 1163",65,60,10,55,-5,0.153846153846154
2021-12-01,"40 - 1114",229,232,228,1,3,0.995633187772926
2021-12-01,"53 - 1103",86,91,82,4,5,0.953488372093023
2021-12-01,"2 - 1066",45,73,39,6,28,0.866666666666667
2021-12-01,"82 - 1163",65,60,14,51,-5,0.215384615384615
2021-12-02,"40 - 1114",226,232,226,0,6,1
2021-12-02,"53 - 1103",81,91,81,0,10,1
2021-12-02,"2 - 1066",45,73,38,7,28,0.844444444444444
2021-12-02,"82 - 1163",65,60,14,51,-5,0.215384615384615
2021-12-03,"40 - 1114",225,233,225,0,8,1
2021-12-03,"53 - 1103",80,91,79,1,11,0.9875
2021-12-03,"2 - 1066",44,73,38,6,29,0.863636363636364
2021-12-03,"82 - 1163",65,60,12,53,-5,0.184615384615385
2021-12-04,"40 - 1114",225,233,224,1,8,0.995555555555556
2021-12-04,"53 - 1103",82,91,80,2,9,0.975609756097561
2021-12-04,"2 - 1066",44,73,38,6,29,0.863636363636364
2021-12-04,"82 - 1163",65,60,13,52,-5,0.2
2021-12-05,"40 - 1114",225,233,223,2,8,0.991111111111111
2021-12-05,"53 - 1103",83,91,82,1,8,0.987951807228916
2021-12-05,"2 - 1066",45,73,39,6,28,0.866666666666667
2021-12-05,"82 - 1163",65,60,13,52,-5,0.2
2021-12-06,"40 - 1114",223,233,223,0,10,1
2021-12-06,"53 - 1103",82,91,81,1,9,0.98780487804878
2021-12-06,"2 - 1066",45,73,39,6,28,0.866666666666667
2021-12-06,"82 - 1163",65,60,14,51,-5,0.215384615384615
2021-12-07,"40 - 1114",222,233,222,0,11,1
2021-12-07,"53 - 1103",85,91,83,2,6,0.976470588235294
2021-12-07,"2 - 1066",45,73,41,4,28,0.911111111111111
2021-12-07,"82 - 1163",65,60,16,49,-5,0.246153846153846
2021-12-08,"40 - 1114",224,233,223,1,9,0.995535714285714
2021-12-08,"53 - 1103",86,91,85,1,5,0.988372093023256
2021-12-08,"2 - 1066",45,73,43,2,28,0.955555555555556
2021-12-08,"82 - 1163",65,60,14,51,-5,0.215384615384615
2021-12-09,"40 - 1114",228,233,226,2,5,0.991228070175439
2021-12-09,"53 - 1103",85,91,85,0,6,1
2021-12-09,"2 - 1066",45,73,43,2,28,0.955555555555556
2021-12-09,"82 - 1163",65,60,17,48,-5,0.261538461538462
2021-12-10,"40 - 1114",226,233,226,0,7,1
2021-12-10,"53 - 1103",84,91,84,0,7,1
2021-12-10,"2 - 1066",45,73,43,2,28,0.955555555555556
2021-12-10,"82 - 1163",65,60,21,44,-5,0.323076923076923
2021-12-11,"40 - 1114",226,233,225,1,7,0.995575221238938
2021-12-11,"53 - 1103",84,91,84,0,7,1
2021-12-11,"2 - 1066",45,73,43,2,28,0.955555555555556
2021-12-11,"82 - 1163",65,60,18,47,-5,0.276923076923077
2021-12-12,"40 - 1114",226,233,225,1,7,0.995575221238938
2021-12-12,"53 - 1103",84,91,84,0,7,1
2021-12-12,"2 - 1066",45,73,44,1,28,0.977777777777778
2021-12-12,"82 - 1163",65,60,12,53,-5,0.184615384615385
2021-12-13,"40 - 1114",225,233,225,0,8,1
2021-12-13,"53 - 1103",84,91,84,0,7,1
2021-12-13,"2 - 1066",45,73,44,1,28,0.977777777777778
2021-12-13,"82 - 1163",65,60,15,50,-5,0.230769230769231
2021-12-14,"40 - 1114",226,233,226,0,7,1
2021-12-14,"53 - 1103",88,91,88,0,3,1
2021-12-14,"2 - 1066",45,73,44,1,28,0.977777777777778
2021-12-14,"82 - 1163",65,60,16,49,-5,0.246153846153846
2021-12-15,"40 - 1114",225,233,225,0,8,1
2021-12-15,"53 - 1103",88,91,87,1,3,0.988636363636364
2021-12-15,"2 - 1066",45,73,43,2,28,0.955555555555556
2021-12-15,"82 - 1163",65,60,12,53,-5,0.184615384615385
2021-12-16,"40 - 1114",224,233,224,0,9,1
2021-12-16,"53 - 1103",89,91,87,2,2,0.97752808988764
2021-12-16,"2 - 1066",44,73,42,2,29,0.954545454545455
2021-12-16,"82 - 1163",65,60,13,52,-5,0.2
2021-12-17,"40 - 1114",225,233,225,0,8,1
2021-12-17,"53 - 1103",87,91,87,0,4,1
2021-12-17,"2 - 1066",45,73,43,2,28,0.955555555555556
2021-12-17,"82 - 1163",65,60,22,43,-5,0.338461538461538
2021-12-18,"40 - 1114",225,233,223,2,8,0.991111111111111
2021-12-18,"53 - 1103",87,91,87,0,4,1
2021-12-18,"2 - 1066",45,73,44,1,28,0.977777777777778
2021-12-18,"82 - 1163",65,60,17,48,-5,0.261538461538462
2021-12-19,"40 - 1114",225,233,225,0,8,1
2021-12-19,"53 - 1103",87,91,87,0,4,1
2021-12-19,"2 - 1066",45,73,44,1,28,0.977777777777778
2021-12-19,"82 - 1163",65,60,14,51,-5,0.215384615384615
2021-12-20,"40 - 1114",226,233,226,0,7,1
2021-12-20,"53 - 1103",87,91,85,2,4,0.977011494252874
2021-12-20,"2 - 1066",45,73,45,0,28,1
2021-12-20,"82 - 1163",65,60,19,46,-5,0.292307692307692
2021-12-21,"40 - 1114",226,233,226,0,7,1
2021-12-21,"53 - 1103",86,91,85,1,5,0.988372093023256
2021-12-21,"2 - 1066",44,73,44,0,29,1
2021-12-21,"82 - 1163",65,60,27,38,-5,0.415384615384615
2021-12-22,"40 - 1114",225,233,225,0,8,1
2021-12-22,"53 - 1103",85,91,84,1,6,0.988235294117647
2021-12-22,"2 - 1066",44,73,44,0,29,1
2021-12-22,"82 - 1163",67,60,37,30,-7,0.552238805970149
2021-12-23,"40 - 1114",227,233,224,3,6,0.986784140969163
2021-12-23,"53 - 1103",86,91,86,0,5,1
2021-12-23,"2 - 1066",44,73,44,0,29,1
2021-12-23,"82 - 1163",70,60,44,26,-10,0.628571428571429
2021-12-24,"40 - 1114",226,233,226,0,7,1
2021-12-24,"53 - 1103",86,91,86,0,5,1
2021-12-24,"2 - 1066",44,73,44,0,29,1
2021-12-24,"82 - 1163",70,60,37,33,-10,0.528571428571429
2021-12-25,"40 - 1114",227,233,227,0,6,1
2021-12-25,"53 - 1103",87,91,87,0,4,1
2021-12-25,"2 - 1066",45,73,45,0,28,1
2021-12-25,"82 - 1163",70,60,40,30,-10,0.571428571428571
2021-12-26,"40 - 1114",227,233,227,0,6,1
2021-12-26,"53 - 1103",85,91,85,0,6,1
2021-12-26,"2 - 1066",45,73,45,0,28,1
2021-12-26,"82 - 1163",70,60,41,29,-10,0.585714285714286
2021-12-27,"40 - 1114",227,233,227,0,6,1
2021-12-27,"53 - 1103",85,91,85,0,6,1
2021-12-27,"2 - 1066",45,73,45,0,28,1
2021-12-27,"82 - 1163",70,60,48,22,-10,0.685714285714286
2021-12-28,"40 - 1114",228,233,228,0,5,1
2021-12-28,"53 - 1103",87,91,87,0,4,1
2021-12-28,"2 - 1066",45,73,45,0,28,1
2021-12-28,"82 - 1163",70,60,49,21,-10,0.7
2021-12-29,"40 - 1114",228,233,228,0,5,1
2021-12-29,"53 - 1103",88,91,87,1,3,0.988636363636364
2021-12-29,"2 - 1066",45,73,45,0,28,1
2021-12-29,"82 - 1163",74,60,55,19,-14,0.743243243243243
2021-12-30,"40 - 1114",228,233,227,1,5,0.995614035087719
2021-12-30,"53 - 1103",89,91,88,1,2,0.98876404494382
2021-12-30,"2 - 1066",45,73,45,0,28,1
2021-12-30,"82 - 1163",76,60,62,14,-16,0.81578947368421
2021-12-31,"40 - 1114",228,233,227,1,5,0.995614035087719
2021-12-31,"53 - 1103",89,91,88,1,2,0.98876404494382
2021-12-31,"2 - 1066",46,73,45,1,27,0.978260869565217
2021-12-31,"82 - 1163",78,60,59,19,-18,0.756410256410256
2022-01-01,"40 - 1114",226,233,226,0,7,1
2022-01-01,"53 - 1103",89,91,88,1,2,0.98876404494382
2022-01-01,"2 - 1066",46,73,46,0,27,1
2022-01-01,"82 - 1163",150,142,115,35,-8,0.766666666666667
2022-01-02,"40 - 1114",226,233,226,0,7,1
2022-01-02,"53 - 1103",88,91,87,1,3,0.988636363636364
2022-01-02,"2 - 1066",45,73,45,0,28,1
2022-01-02,"82 - 1163",150,142,112,38,-8,0.746666666666667
2022-01-03,"40 - 1114",226,233,224,2,7,0.991150442477876
2022-01-03,"53 - 1103",88,91,86,2,3,0.977272727272727
2022-01-03,"2 - 1066",45,73,45,0,28,1
2022-01-03,"82 - 1163",151,142,118,33,-9,0.781456953642384
2022-01-04,"40 - 1114",224,233,223,1,9,0.995535714285714
2022-01-04,"53 - 1103",87,91,87,0,4,1
2022-01-04,"2 - 1066",44,73,44,0,29,1
2022-01-04,"82 - 1163",152,142,117,35,-10,0.769736842105263
2022-01-05,"40 - 1114",215,233,215,0,18,1
2022-01-05,"53 - 1103",88,91,88,0,3,1
2022-01-05,"2 - 1066",45,73,45,0,28,1
2022-01-05,"82 - 1163",152,142,119,33,-10,0.782894736842105
2022-01-06,"40 - 1114",215,233,214,1,18,0.995348837209302
2022-01-06,"53 - 1103",88,91,88,0,3,1
2022-01-06,"2 - 1066",45,73,45,0,28,1
2022-01-06,"82 - 1163",153,142,118,35,-11,0.77124183006536
2022-01-07,"40 - 1114",213,233,213,0,20,1
2022-01-07,"53 - 1103",88,91,88,0,3,1
2022-01-07,"2 - 1066",45,73,45,0,28,1
2022-01-07,"82 - 1163",132,142,113,19,10,0.856060606060606
2022-01-08,"40 - 1114",213,233,212,1,20,0.995305164319249
2022-01-08,"53 - 1103",88,91,88,0,3,1
2022-01-08,"2 - 1066",45,73,45,0,28,1
2022-01-08,"82 - 1163",134,142,110,24,8,0.82089552238806
2022-01-09,"40 - 1114",213,233,212,1,20,0.995305164319249
2022-01-09,"53 - 1103",88,91,88,0,3,1
2022-01-09,"2 - 1066",45,73,45,0,28,1
2022-01-09,"82 - 1163",147,142,107,40,-5,0.727891156462585
2022-01-10,"40 - 1114",212,233,212,0,21,1
2022-01-10,"53 - 1103",88,91,88,0,3,1
2022-01-10,"2 - 1066",45,73,45,0,28,1
2022-01-10,"82 - 1163",139,112,104,35,-27,0.748201438848921
2022-01-11,"40 - 1114",215,233,215,0,18,1
2022-01-11,"53 - 1103",89,91,89,0,2,1
2022-01-11,"2 - 1066",45,73,45,0,28,1
2022-01-11,"82 - 1163",139,112,102,37,-27,0.733812949640288
2022-01-12,"40 - 1114",218,233,217,1,15,0.995412844036697
2022-01-12,"53 - 1103",89,91,89,0,2,1
2022-01-12,"2 - 1066",45,50,45,0,5,1
2022-01-12,"82 - 1163",139,112,104,35,-27,0.748201438848921
2022-01-13,"40 - 1114",221,233,221,0,12,1
2022-01-13,"53 - 1103",89,91,89,0,2,1
2022-01-13,"2 - 1066",45,50,45,0,5,1
2022-01-13,"82 - 1163",136,112,109,27,-24,0.801470588235294
2022-01-14,"40 - 1114",221,233,221,0,12,1
2022-01-14,"53 - 1103",89,91,89,0,2,1
2022-01-14,"2 - 1066",45,50,45,0,5,1
2022-01-14,"82 - 1163",143,142,110,33,-1,0.769230769230769
2022-01-15,"40 - 1114",221,233,220,1,12,0.995475113122172
2022-01-15,"53 - 1103",89,91,89,0,2,1
2022-01-15,"2 - 1066",45,50,45,0,5,1
2022-01-15,"82 - 1163",138,112,107,31,-26,0.77536231884058
2022-01-16,"40 - 1114",220,233,220,0,13,1
2022-01-16,"53 - 1103",184,186,153,31,2,0.831521739130435
2022-01-16,"2 - 1066",45,50,45,0,5,1
2022-01-16,"82 - 1163",138,112,109,29,-26,0.789855072463768
2022-01-17,"40 - 1114",219,233,219,0,14,1
2022-01-17,"53 - 1103",162,186,162,0,24,1
2022-01-17,"2 - 1066",45,58,45,0,13,1
2022-01-17,"82 - 1163",140,112,111,29,-28,0.792857142857143
2022-01-18,"40 - 1114",219,233,219,0,14,1
2022-01-18,"53 - 1103",169,186,162,7,17,0.958579881656805
2022-01-18,"2 - 1066",45,58,45,0,13,1
2022-01-18,"82 - 1163",140,112,107,33,-28,0.764285714285714
2022-01-19,"40 - 1114",220,233,220,0,13,1
2022-01-19,"53 - 1103",169,186,166,3,17,0.982248520710059
2022-01-19,"2 - 1066",45,58,45,0,13,1
2022-01-19,"82 - 1163",141,112,104,37,-29,0.73758865248227
2022-01-20,"40 - 1114",223,233,223,0,10,1
2022-01-20,"53 - 1103",168,186,166,2,18,0.988095238095238
2022-01-20,"2 - 1066",45,45,45,0,0,1
2022-01-20,"82 - 1163",141,112,95,46,-29,0.673758865248227
2022-01-21,"40 - 1114",225,233,225,0,8,1
2022-01-21,"53 - 1103",171,186,166,5,15,0.970760233918129
2022-01-21,"2 - 1066",45,58,45,0,13,1
2022-01-21,"82 - 1163",149,142,86,63,-7,0.577181208053691
2022-01-22,"40 - 1114",225,233,225,0,8,1
2022-01-22,"53 - 1103",171,186,165,6,15,0.964912280701754
2022-01-22,"2 - 1066",45,58,45,0,13,1
2022-01-22,"82 - 1163",141,112,81,60,-29,0.574468085106383
2022-01-23,"40 - 1114",226,233,225,1,7,0.995575221238938
2022-01-23,"53 - 1103",173,186,164,9,13,0.947976878612717
2022-01-23,"2 - 1066",45,58,45,0,13,1
2022-01-23,"82 - 1163",141,112,76,65,-29,0.539007092198582
2022-01-24,"40 - 1114",225,233,225,0,8,1
2022-01-24,"53 - 1103",175,186,167,8,11,0.954285714285714
2022-01-24,"2 - 1066",45,58,45,0,13,1
2022-01-24,"82 - 1163",141,112,69,72,-29,0.48936170212766
2022-01-25,"40 - 1114",226,233,226,0,7,1
2022-01-25,"53 - 1103",175,186,170,5,11,0.971428571428571
2022-01-25,"2 - 1066",45,58,45,0,13,1
2022-01-25,"82 - 1163",56,112,56,0,56,1
2022-01-26,"40 - 1114",229,233,229,0,4,1
2022-01-26,"53 - 1103",171,186,167,4,15,0.976608187134503
2022-01-26,"2 - 1066",44,58,44,0,14,1
2022-01-26,"82 - 1163",57,112,52,5,55,0.912280701754386
2022-01-27,"40 - 1114",227,233,227,0,6,1
2022-01-27,"53 - 1103",175,186,169,6,11,0.965714285714286
2022-01-27,"2 - 1066",44,58,44,0,14,1
2022-01-27,"82 - 1163",51,30,33,18,-21,0.647058823529412
2022-01-28,"40 - 1114",225,233,225,0,8,1
2022-01-28,"53 - 1103",179,186,171,8,7,0.955307262569832
2022-01-28,"2 - 1066",46,58,46,0,12,1
2022-01-28,"82 - 1163",54,30,26,28,-24,0.481481481481481
2022-01-29,"40 - 1114",225,233,225,0,8,1
2022-01-29,"53 - 1103",181,186,178,3,5,0.983425414364641
2022-01-29,"2 - 1066",46,58,46,0,12,1
2022-01-29,"82 - 1163",55,30,29,26,-25,0.527272727272727
2022-01-30,"40 - 1114",223,233,223,0,10,1
2022-01-30,"53 - 1103",181,186,180,1,5,0.994475138121547
2022-01-30,"2 - 1066",46,58,46,0,12,1
2022-01-30,"82 - 1163",54,30,28,26,-24,0.518518518518518
2022-01-31,"40 - 1114",223,233,223,0,10,1
2022-01-31,"53 - 1103",178,186,178,0,8,1
2022-01-31,"2 - 1066",46,58,46,0,12,1
2022-01-31,"82 - 1163",68,30,27,41,-38,0.397058823529412
2022-02-01,"40 - 1114",222,233,222,0,11,1
2022-02-01,"53 - 1103",179,186,179,0,7,1
2022-02-01,"2 - 1066",44,58,44,0,14,1
2022-02-01,"82 - 1163",68,30,28,40,-38,0.411764705882353
2022-02-02,"40 - 1114",222,233,222,0,11,1
2022-02-02,"53 - 1103",181,186,178,3,5,0.983425414364641
2022-02-02,"2 - 1066",42,58,42,0,16,1
2022-02-02,"82 - 1163",68,30,27,41,-38,0.397058823529412
2022-02-03,"40 - 1114",224,233,224,0,9,1
2022-02-03,"53 - 1103",181,186,181,0,5,1
2022-02-03,"2 - 1066",42,58,42,0,16,1
2022-02-03,"82 - 1163",79,60,28,51,-19,0.354430379746835
2022-02-04,"40 - 1114",225,233,224,1,8,0.995555555555556
2022-02-04,"53 - 1103",181,186,181,0,5,1
2022-02-04,"2 - 1066",42,58,42,0,16,1
2022-02-04,"82 - 1163",79,60,29,50,-19,0.367088607594937
2022-02-05,"40 - 1114",225,233,225,0,8,1
2022-02-05,"53 - 1103",177,186,175,2,9,0.988700564971751
2022-02-05,"2 - 1066",43,58,43,0,15,1
2022-02-05,"82 - 1163",79,60,29,50,-19,0.367088607594937
2022-02-06,"40 - 1114",224,233,224,0,9,1
2022-02-06,"53 - 1103",177,186,177,0,9,1
2022-02-06,"2 - 1066",42,58,42,0,16,1
2022-02-06,"82 - 1163",79,60,27,52,-19,0.341772151898734
2022-02-07,"40 - 1114",224,233,224,0,9,1
2022-02-07,"53 - 1103",181,186,177,4,5,0.977900552486188
2022-02-07,"2 - 1066",41,58,41,0,17,1
2022-02-07,"82 - 1163",68,30,21,47,-38,0.308823529411765
2022-02-08,"40 - 1114",224,233,224,0,9,1
2022-02-08,"53 - 1103",182,186,174,8,4,0.956043956043956
2022-02-08,"2 - 1066",41,58,41,0,17,1
2022-02-08,"82 - 1163",85,60,26,59,-25,0.305882352941176
2022-02-09,"40 - 1114",224,233,224,0,9,1
2022-02-09,"53 - 1103",181,186,175,6,5,0.966850828729282
2022-02-09,"2 - 1066",41,58,41,0,17,1
2022-02-09,"82 - 1163",85,60,28,57,-25,0.329411764705882
2022-02-10,"40 - 1114",222,233,222,0,11,1
2022-02-10,"53 - 1103",182,186,176,6,4,0.967032967032967
2022-02-10,"2 - 1066",41,58,41,0,17,1
2022-02-10,"82 - 1163",85,60,28,57,-25,0.329411764705882
2022-02-11,"40 - 1114",224,233,224,0,9,1
2022-02-11,"53 - 1103",181,186,177,4,5,0.977900552486188
2022-02-11,"2 - 1066",41,58,41,0,17,1
2022-02-11,"82 - 1163",85,60,26,59,-25,0.305882352941176
2022-02-12,"40 - 1114",224,233,224,0,9,1
2022-02-12,"53 - 1103",180,186,176,4,6,0.977777777777778
2022-02-12,"2 - 1066",41,58,41,0,17,1
2022-02-12,"82 - 1163",80,60,29,51,-20,0.3625
2022-02-13,"40 - 1114",224,233,224,0,9,1
2022-02-13,"53 - 1103",179,186,176,3,7,0.983240223463687
2022-02-13,"2 - 1066",41,58,41,0,17,1
2022-02-13,"82 - 1163",80,60,26,54,-20,0.325
2022-02-14,"40 - 1114",223,233,223,0,10,1
2022-02-14,"53 - 1103",179,186,176,3,7,0.983240223463687
2022-02-14,"2 - 1066",39,58,39,0,19,1
2022-02-14,"82 - 1163",80,60,23,57,-20,0.2875
2022-02-15,"40 - 1114",222,233,222,0,11,1
2022-02-15,"53 - 1103",177,186,175,2,9,0.988700564971751
2022-02-15,"2 - 1066",39,58,39,0,19,1
2022-02-15,"82 - 1163",80,60,22,58,-20,0.275
2022-02-16,"40 - 1114",219,233,219,0,14,1
2022-02-16,"53 - 1103",177,186,176,1,9,0.994350282485876
2022-02-16,"2 - 1066",39,58,39,0,19,1
2022-02-16,"82 - 1163",81,60,22,59,-21,0.271604938271605
2022-02-17,"40 - 1114",221,233,221,0,12,1
2022-02-17,"53 - 1103",176,186,176,0,10,1
2022-02-17,"2 - 1066",39,58,39,0,19,1
2022-02-17,"82 - 1163",79,60,22,57,-19,0.278481012658228
2022-02-18,"40 - 1114",223,233,221,2,10,0.991031390134529
2022-02-18,"53 - 1103",179,186,177,2,7,0.988826815642458
2022-02-18,"2 - 1066",39,58,39,0,19,1
2022-02-18,"82 - 1163",79,60,19,60,-19,0.240506329113924
2022-02-19,"40 - 1114",223,233,222,1,10,0.995515695067265
2022-02-19,"53 - 1103",178,186,176,2,8,0.98876404494382
2022-02-19,"2 - 1066",40,58,40,0,18,1
2022-02-19,"82 - 1163",79,60,19,60,-19,0.240506329113924
2022-02-20,"40 - 1114",221,233,221,0,12,1
2022-02-20,"53 - 1103",177,186,176,1,9,0.994350282485876
2022-02-20,"2 - 1066",41,58,41,0,17,1
2022-02-20,"82 - 1163",79,60,19,60,-19,0.240506329113924
2022-02-21,"40 - 1114",221,233,221,0,12,1
2022-02-21,"53 - 1103",177,186,176,1,9,0.994350282485876
2022-02-21,"2 - 1066",41,58,41,0,17,1
2022-02-21,"82 - 1163",79,60,17,62,-19,0.215189873417722
2022-02-22,"40 - 1114",221,233,221,0,12,1
2022-02-22,"53 - 1103",181,186,177,4,5,0.977900552486188
2022-02-22,"2 - 1066",41,58,41,0,17,1
2022-02-22,"82 - 1163",79,60,13,66,-19,0.164556962025316
2022-02-23,"40 - 1114",224,233,224,0,9,1
2022-02-23,"53 - 1103",179,186,176,3,7,0.983240223463687
2022-02-23,"2 - 1066",41,58,41,0,17,1
2022-02-23,"82 - 1163",78,60,13,65,-18,0.166666666666667
2022-02-24,"40 - 1114",224,233,224,0,9,1
2022-02-24,"53 - 1103",183,186,180,3,3,0.983606557377049
2022-02-24,"2 - 1066",42,58,42,0,16,1
2022-02-24,"82 - 1163",65,30,8,57,-35,0.123076923076923
2022-02-25,"40 - 1114",226,233,226,0,7,1
2022-02-25,"53 - 1103",182,186,177,5,4,0.972527472527473
2022-02-25,"2 - 1066",42,58,42,0,16,1
2022-02-25,"82 - 1163",78,60,9,69,-18,0.115384615384615
2022-02-26,"40 - 1114",226,233,226,0,7,1
2022-02-26,"53 - 1103",181,186,176,5,5,0.972375690607735
2022-02-26,"2 - 1066",41,58,41,0,17,1
2022-02-26,"82 - 1163",78,60,8,70,-18,0.102564102564103
2022-02-27,"40 - 1114",226,233,226,0,7,1
2022-02-27,"53 - 1103",181,186,174,7,5,0.961325966850829
2022-02-27,"2 - 1066",42,58,42,0,16,1
2022-02-27,"82 - 1163",78,60,8,70,-18,0.102564102564103
2022-02-28,"40 - 1114",226,233,226,0,7,1
2022-02-28,"53 - 1103",181,186,173,8,5,0.955801104972376
2022-02-28,"2 - 1066",42,58,42,0,16,1
2022-02-28,"82 - 1163",78,60,8,70,-18,0.102564102564103
2022-03-01,"40 - 1114",226,233,224,2,7,0.991150442477876
2022-03-01,"53 - 1103",180,186,176,4,6,0.977777777777778
2022-03-01,"2 - 1066",43,58,43,0,15,1
2022-03-01,"82 - 1163",65,30,8,57,-35,0.123076923076923
2022-03-02,"40 - 1114",222,233,222,0,11,1
2022-03-02,"53 - 1103",180,186,178,2,6,0.988888888888889
2022-03-02,"2 - 1066",43,58,43,0,15,1
2022-03-02,"82 - 1163",65,30,7,58,-35,0.107692307692308
2022-03-03,"40 - 1114",223,233,222,1,10,0.995515695067265
2022-03-03,"53 - 1103",182,186,177,5,4,0.972527472527473
2022-03-03,"2 - 1066",43,58,43,0,15,1
2022-03-03,"82 - 1163",65,30,7,58,-35,0.107692307692308
2022-03-04,"40 - 1114",224,233,223,1,9,0.995535714285714
2022-03-04,"53 - 1103",182,186,178,4,4,0.978021978021978
2022-03-04,"2 - 1066",42,58,42,0,16,1
2022-03-04,"82 - 1163",78,60,7,71,-18,0.0897435897435897
2022-03-05,"40 - 1114",224,233,223,1,9,0.995535714285714
2022-03-05,"53 - 1103",181,186,176,5,5,0.972375690607735
2022-03-05,"2 - 1066",43,58,43,0,15,1
2022-03-05,"82 - 1163",62,30,7,55,-32,0.112903225806452
2022-03-06,"40 - 1114",224,233,222,2,9,0.991071428571429
2022-03-06,"53 - 1103",179,186,175,4,7,0.977653631284916
2022-03-06,"2 - 1066",43,58,43,0,15,1
2022-03-06,"82 - 1163",62,30,6,56,-32,0.0967741935483871
2022-03-07,"40 - 1320",2,80,2,0,78,1
2022-03-07,"40 - 1114",218,233,217,1,15,0.995412844036697
2022-03-07,"53 - 1103",183,186,175,8,3,0.956284153005464
2022-03-07,"2 - 1066",43,58,43,0,15,1
2022-03-07,"82 - 1163",62,30,5,57,-32,0.0806451612903226
2022-03-08,"40 - 1320",6,80,6,0,74,1
2022-03-08,"40 - 1114",213,233,213,0,20,1
2022-03-08,"53 - 1103",183,186,180,3,3,0.983606557377049
2022-03-08,"2 - 1066",43,58,43,0,15,1
2022-03-08,"82 - 1163",62,30,5,57,-32,0.0806451612903226
2022-03-09,"40 - 1320",9,80,9,0,71,1
2022-03-09,"40 - 1114",212,233,211,1,21,0.995283018867924
2022-03-09,"53 - 1103",185,186,180,5,1,0.972972972972973
2022-03-09,"2 - 1066",43,58,43,0,15,1
2022-03-09,"82 - 1163",62,30,5,57,-32,0.0806451612903226
2022-03-10,"40 - 1320",12,80,12,0,68,1
2022-03-10,"40 - 1114",212,233,211,1,21,0.995283018867924
2022-03-10,"53 - 1103",182,186,178,4,4,0.978021978021978
2022-03-10,"2 - 1066",43,58,43,0,15,1
2022-03-10,"82 - 1163",62,30,5,57,-32,0.0806451612903226
2022-03-11,"40 - 1320",15,80,15,0,65,1
2022-03-11,"40 - 1114",212,233,211,1,21,0.995283018867924
2022-03-11,"53 - 1103",185,186,180,5,1,0.972972972972973
2022-03-11,"2 - 1066",44,58,44,0,14,1
2022-03-11,"82 - 1163",62,30,7,55,-32,0.112903225806452
2022-03-12,"40 - 1320",15,80,14,1,65,0.933333333333333
2022-03-12,"40 - 1114",212,233,212,0,21,1
2022-03-12,"53 - 1103",184,186,177,7,2,0.96195652173913
2022-03-12,"2 - 1066",43,58,43,0,15,1
2022-03-12,"82 - 1163",62,30,9,53,-32,0.145161290322581
2022-03-13,"40 - 1320",16,80,16,0,64,1
2022-03-13,"40 - 1114",212,233,212,0,21,1
2022-03-13,"53 - 1103",180,186,177,3,6,0.983333333333333
2022-03-13,"2 - 1066",43,58,43,0,15,1
2022-03-13,"82 - 1163",62,30,9,53,-32,0.145161290322581
2022-03-14,"40 - 1320",21,105,21,0,84,1
2022-03-14,"40 - 1114",214,233,212,2,19,0.990654205607477
2022-03-14,"53 - 1103",182,186,179,3,4,0.983516483516483
2022-03-14,"2 - 1066",43,58,43,0,15,1
2022-03-14,"82 - 1163",74,60,10,64,-14,0.135135135135135
2022-03-15,"40 - 1320",24,105,24,0,81,1
2022-03-15,"40 - 1114",213,233,212,1,20,0.995305164319249
2022-03-15,"53 - 1103",185,186,175,10,1,0.945945945945946
2022-03-15,"2 - 1066",42,58,42,0,16,1
2022-03-15,"82 - 1163",74,60,10,64,-14,0.135135135135135
2022-03-16,"40 - 1320",29,105,28,1,76,0.96551724137931
2022-03-16,"40 - 1114",214,233,214,0,19,1
2022-03-16,"53 - 1103",185,186,174,11,1,0.940540540540541
2022-03-16,"2 - 1066",43,58,43,0,15,1
2022-03-16,"82 - 1163",74,60,13,61,-14,0.175675675675676
2022-03-17,"40 - 1320",33,105,33,0,72,1
2022-03-17,"40 - 1114",213,233,213,0,20,1
2022-03-17,"53 - 1103",183,186,176,7,3,0.961748633879781
2022-03-17,"2 - 1066",43,58,43,0,15,1
2022-03-17,"82 - 1163",74,60,15,59,-14,0.202702702702703
2022-03-18,"40 - 1320",38,105,37,1,67,0.973684210526316
2022-03-18,"40 - 1114",213,233,213,0,20,1
2022-03-18,"53 - 1103",183,186,176,7,3,0.961748633879781
2022-03-18,"2 - 1066",45,58,45,0,13,1
2022-03-18,"82 - 1163",74,60,16,58,-14,0.216216216216216
2022-03-19,"40 - 1320",38,105,38,0,67,1
2022-03-19,"40 - 1114",213,233,212,1,20,0.995305164319249
2022-03-19,"53 - 1103",184,186,178,6,2,0.967391304347826
2022-03-19,"2 - 1066",44,58,44,0,14,1
2022-03-19,"82 - 1163",74,60,16,58,-14,0.216216216216216
2022-03-20,"40 - 1320",40,105,38,2,65,0.95
2022-03-20,"40 - 1114",215,233,214,1,18,0.995348837209302
2022-03-20,"53 - 1103",182,186,176,6,4,0.967032967032967
2022-03-20,"2 - 1066",44,58,44,0,14,1
2022-03-20,"82 - 1163",74,60,16,58,-14,0.216216216216216
2022-03-21,"40 - 1320",47,105,47,0,58,1
2022-03-21,"40 - 1114",214,233,214,0,19,1
2022-03-21,"53 - 1103",176,186,175,1,10,0.994318181818182
2022-03-21,"2 - 1066",44,58,44,0,14,1
2022-03-21,"82 - 1163",74,60,15,59,-14,0.202702702702703
2022-03-22,"40 - 1320",49,105,49,0,56,1
2022-03-22,"40 - 1114",215,233,215,0,18,1
2022-03-22,"53 - 1103",177,186,177,0,9,1
2022-03-22,"2 - 1066",44,58,44,0,14,1
2022-03-22,"82 - 1163",74,60,14,60,-14,0.189189189189189
2022-03-23,"40 - 1320",53,105,53,0,52,1
2022-03-23,"40 - 1114",216,233,216,0,17,1
2022-03-23,"53 - 1103",185,186,181,4,1,0.978378378378378
2022-03-23,"2 - 1066",44,58,44,0,14,1
2022-03-23,"82 - 1163",74,60,7,67,-14,0.0945945945945946
2022-03-24,"40 - 1320",54,105,54,0,51,1
2022-03-24,"40 - 1114",218,233,218,0,15,1
2022-03-24,"53 - 1103",185,186,180,5,1,0.972972972972973
2022-03-24,"2 - 1066",45,58,45,0,13,1
2022-03-24,"82 - 1163",74,60,7,67,-14,0.0945945945945946
2022-03-25,"40 - 1320",56,105,56,0,49,1
2022-03-25,"40 - 1114",217,233,217,0,16,1
2022-03-25,"53 - 1103",183,186,180,3,3,0.983606557377049
2022-03-25,"2 - 1066",45,58,45,0,13,1
2022-03-25,"82 - 1163",74,60,7,67,-14,0.0945945945945946
2022-03-26,"40 - 1320",57,105,57,0,48,1
2022-03-26,"40 - 1114",217,233,216,1,16,0.995391705069124
2022-03-26,"53 - 1103",184,186,180,4,2,0.978260869565217
2022-03-26,"2 - 1066",45,58,45,0,13,1
2022-03-26,"82 - 1163",74,60,5,69,-14,0.0675675675675676
2022-03-27,"40 - 1320",57,105,57,0,48,1
2022-03-27,"40 - 1114",218,233,218,0,15,1
2022-03-27,"53 - 1103",183,186,180,3,3,0.983606557377049
2022-03-27,"2 - 1066",45,58,45,0,13,1
2022-03-27,"82 - 1163",74,60,2,72,-14,0.027027027027027
2022-03-28,"40 - 1320",60,105,60,0,45,1
2022-03-28,"40 - 1114",218,233,218,0,15,1
2022-03-28,"53 - 1103",179,186,179,0,7,1
2022-03-28,"2 - 1066",45,58,45,0,13,1
2022-03-28,"82 - 1163",74,60,5,69,-14,0.0675675675675676
2022-03-29,"40 - 1320",67,105,66,1,38,0.985074626865672
2022-03-29,"40 - 1114",217,233,217,0,16,1
2022-03-29,"53 - 1103",183,186,182,1,3,0.994535519125683
2022-03-29,"2 - 1066",45,58,45,0,13,1
2022-03-29,"82 - 1163",62,30,4,58,-32,0.0645161290322581
2022-03-30,"40 - 1320",69,105,69,0,36,1
2022-03-30,"40 - 1114",217,233,217,0,16,1
2022-03-30,"53 - 1103",183,186,181,2,3,0.989071038251366
2022-03-30,"2 - 1066",45,58,45,0,13,1
2022-03-30,"82 - 1163",62,30,4,58,-32,0.0645161290322581
2022-03-31,"40 - 1320",74,105,74,0,31,1
2022-03-31,"40 - 1114",217,233,217,0,16,1
2022-03-31,"53 - 1103",183,186,180,3,3,0.983606557377049
2022-03-31,"2 - 1066",45,58,45,0,13,1
2022-03-31,"82 - 1163",62,30,4,58,-32,0.0645161290322581
2022-04-01,"40 - 1320",78,105,78,0,27,1
2022-04-01,"40 - 1114",216,233,216,0,17,1
2022-04-01,"53 - 1103",182,186,180,2,4,0.989010989010989
2022-04-01,"2 - 1066",41,58,41,0,17,1
2022-04-01,"82 - 1163",76,30,5,71,-46,0.0657894736842105
2022-04-02,"40 - 1320",80,105,80,0,25,1
2022-04-02,"40 - 1114",216,233,216,0,17,1
2022-04-02,"53 - 1103",182,186,179,3,4,0.983516483516483
2022-04-02,"2 - 1066",42,58,42,0,16,1
2022-04-02,"82 - 1163",78,30,14,64,-48,0.17948717948718
2022-04-03,"40 - 1320",82,105,82,0,23,1
2022-04-03,"40 - 1114",216,233,216,0,17,1
2022-04-03,"53 - 1103",182,186,178,4,4,0.978021978021978
2022-04-03,"2 - 1066",42,58,42,0,16,1
2022-04-03,"82 - 1163",79,30,16,63,-49,0.20253164556962
2022-04-04,"40 - 1320",87,105,87,0,18,1
2022-04-04,"40 - 1114",222,231,215,7,9,0.968468468468468
2022-04-04,"53 - 1103",183,186,181,2,3,0.989071038251366
2022-04-04,"2 - 1066",42,58,42,0,16,1
2022-04-04,"82 - 1163",125,148,17,108,23,0.136
2022-04-05,"40 - 1320",88,105,88,0,17,1
2022-04-05,"40 - 1114",220,231,219,1,11,0.995454545454545
2022-04-05,"53 - 1103",184,186,180,4,2,0.978260869565217
2022-04-05,"2 - 1066",43,58,43,0,15,1
2022-04-05,"82 - 1163",129,148,21,108,19,0.162790697674419
2022-04-06,"40 - 1320",90,105,90,0,15,1
2022-04-06,"40 - 1114",219,232,219,0,13,1
2022-04-06,"53 - 1103",184,186,178,6,2,0.967391304347826
2022-04-06,"2 - 1066",42,58,42,0,16,1
2022-04-06,"82 - 1163",129,148,32,97,19,0.248062015503876
2022-04-07,"40 - 1320",95,105,91,4,10,0.957894736842105
2022-04-07,"40 - 1114",219,232,219,0,13,1
2022-04-07,"53 - 1103",184,186,179,5,2,0.972826086956522
2022-04-07,"2 - 1066",42,58,42,0,16,1
2022-04-07,"82 - 1163",129,148,43,86,19,0.333333333333333
2022-04-08,"40 - 1320",95,105,91,4,10,0.957894736842105
2022-04-08,"40 - 1114",218,232,218,0,14,1
2022-04-08,"53 - 1103",182,186,178,4,4,0.978021978021978
2022-04-08,"2 - 1066",41,58,41,0,17,1
2022-04-08,"82 - 1163",130,148,51,79,18,0.392307692307692
2022-04-09,"40 - 1320",99,105,94,5,6,0.94949494949495
2022-04-09,"40 - 1114",220,232,218,2,12,0.990909090909091
2022-04-09,"53 - 1103",184,186,179,5,2,0.972826086956522
2022-04-09,"2 - 1066",41,58,41,0,17,1
2022-04-09,"82 - 1163",130,148,49,81,18,0.376923076923077
2022-04-10,"40 - 1320",100,105,96,4,5,0.96
2022-04-10,"40 - 1114",219,232,216,3,13,0.986301369863014
2022-04-10,"53 - 1103",184,186,177,7,2,0.96195652173913
2022-04-10,"2 - 1066",41,58,41,0,17,1
2022-04-10,"82 - 1163",132,178,52,80,46,0.393939393939394
2022-04-11,"40 - 1320",105,105,101,4,0,0.961904761904762
2022-04-11,"40 - 1114",217,232,215,2,15,0.990783410138249
2022-04-11,"53 - 1103",181,186,173,8,5,0.955801104972376
2022-04-11,"2 - 1066",41,58,41,0,17,1
2022-04-11,"82 - 1163",138,178,54,84,40,0.391304347826087
2022-04-12,"40 - 1320",104,105,104,0,1,1
2022-04-12,"40 - 1114",217,232,216,1,15,0.995391705069124
2022-04-12,"53 - 1103",184,186,175,9,2,0.951086956521739
2022-04-12,"2 - 1066",40,58,40,0,18,1
2022-04-12,"82 - 1163",139,178,58,81,39,0.41726618705036
2022-04-13,"40 - 1320",104,105,104,0,1,1
2022-04-13,"40 - 1114",219,232,219,0,13,1
2022-04-13,"53 - 1103",184,186,178,6,2,0.967391304347826
2022-04-13,"2 - 1066",41,58,41,0,17,1
2022-04-13,"82 - 1163",150,178,61,89,28,0.406666666666667
2022-04-14,"40 - 1320",104,105,103,1,1,0.990384615384615
2022-04-14,"40 - 1114",218,232,218,0,14,1
2022-04-14,"53 - 1103",183,186,179,4,3,0.978142076502732
2022-04-14,"2 - 1066",42,58,42,0,16,1
2022-04-14,"82 - 1163",151,178,64,87,27,0.423841059602649
2022-04-15,"40 - 1320",104,105,103,1,1,0.990384615384615
2022-04-15,"40 - 1114",218,232,218,0,14,1
2022-04-15,"53 - 1103",181,186,177,4,5,0.977900552486188
2022-04-15,"2 - 1066",43,58,43,0,15,1
2022-04-15,"82 - 1163",151,178,63,88,27,0.417218543046358
2022-04-16,"40 - 1320",105,105,105,0,0,1
2022-04-16,"40 - 1114",220,232,218,2,12,0.990909090909091
2022-04-16,"53 - 1103",182,186,174,8,4,0.956043956043956
2022-04-16,"2 - 1066",43,58,43,0,15,1
2022-04-16,"82 - 1163",151,178,64,87,27,0.423841059602649
2022-04-17,"40 - 1320",105,105,105,0,0,1
2022-04-17,"40 - 1114",220,232,218,2,12,0.990909090909091
2022-04-17,"53 - 1103",185,186,178,7,1,0.962162162162162
2022-04-17,"2 - 1066",42,58,42,0,16,1
2022-04-17,"82 - 1163",151,178,62,89,27,0.410596026490066
2022-04-18,"40 - 1320",105,105,105,0,0,1
2022-04-18,"40 - 1114",219,232,217,2,13,0.990867579908676
2022-04-18,"53 - 1103",186,186,179,7,0,0.96236559139785
2022-04-18,"2 - 1066",42,58,42,0,16,1
2022-04-18,"82 - 1163",151,178,60,91,27,0.397350993377483
2022-04-19,"40 - 1320",105,105,105,0,0,1
2022-04-19,"40 - 1114",218,232,218,0,14,1
2022-04-19,"53 - 1103",186,186,176,10,0,0.946236559139785
2022-04-19,"2 - 1066",42,58,42,0,16,1
2022-04-19,"82 - 1163",151,178,63,88,27,0.417218543046358
2022-04-20,"40 - 1320",105,105,105,0,0,1
2022-04-20,"40 - 1114",218,232,218,0,14,1
2022-04-20,"53 - 1103",186,186,177,9,0,0.951612903225806
2022-04-20,"2 - 1066",41,58,41,0,17,1
2022-04-20,"82 - 1163",149,148,65,84,-1,0.436241610738255
2022-04-21,"40 - 1320",105,105,105,0,0,1
2022-04-21,"40 - 1114",218,232,218,0,14,1
2022-04-21,"53 - 1103",184,186,175,9,2,0.951086956521739
2022-04-21,"2 - 1066",43,58,43,0,15,1
2022-04-21,"82 - 1163",86,148,76,10,62,0.883720930232558
2022-04-22,"40 - 1320",105,105,105,0,0,1
2022-04-22,"40 - 1114",219,232,219,0,13,1
2022-04-22,"53 - 1103",184,186,178,6,2,0.967391304347826
2022-04-22,"2 - 1066",41,58,41,0,17,1
2022-04-22,"82 - 1163",108,148,86,22,40,0.796296296296296
2022-04-23,"40 - 1320",105,105,105,0,0,1
2022-04-23,"40 - 1114",219,232,219,0,13,1
2022-04-23,"53 - 1103",186,186,179,7,0,0.96236559139785
2022-04-23,"2 - 1066",41,58,41,0,17,1
2022-04-23,"82 - 1163",109,178,90,19,69,0.825688073394495
2022-04-24,"40 - 1320",105,105,105,0,0,1
2022-04-24,"40 - 1114",219,232,219,0,13,1
2022-04-24,"53 - 1103",186,186,179,7,0,0.96236559139785
2022-04-24,"2 - 1066",41,58,41,0,17,1
2022-04-24,"82 - 1163",110,178,87,23,68,0.790909090909091
2022-04-25,"40 - 1320",105,105,105,0,0,1
2022-04-25,"40 - 1114",217,232,217,0,15,1
2022-04-25,"53 - 1103",185,186,182,3,1,0.983783783783784
2022-04-25,"2 - 1066",41,58,41,0,17,1
2022-04-25,"82 - 1163",109,148,87,22,39,0.798165137614679
2022-04-26,"40 - 1320",105,105,105,0,0,1
2022-04-26,"40 - 1114",217,232,217,0,15,1
2022-04-26,"53 - 1103",186,186,182,4,0,0.978494623655914
2022-04-26,"2 - 1066",40,58,40,0,18,1
2022-04-26,"82 - 1163",125,148,87,38,23,0.696
2022-04-27,"40 - 1320",105,105,105,0,0,1
2022-04-27,"40 - 1114",216,232,216,0,16,1
2022-04-27,"53 - 1103",184,186,183,1,2,0.994565217391304
2022-04-27,"2 - 1066",41,58,41,0,17,1
2022-04-27,"82 - 1163",126,148,99,27,22,0.785714285714286
2022-04-28,"40 - 1320",105,105,105,0,0,1
2022-04-28,"40 - 1114",217,232,217,0,15,1
2022-04-28,"53 - 1103",184,186,182,2,2,0.989130434782609
2022-04-28,"2 - 1066",41,58,41,0,17,1
2022-04-28,"82 - 1163",119,148,100,19,29,0.840336134453782
2022-04-29,"40 - 1320",105,105,104,1,0,0.99047619047619
2022-04-29,"40 - 1114",214,231,214,0,17,1
2022-04-29,"53 - 1103",184,186,181,3,2,0.983695652173913
2022-04-29,"2 - 1066",41,58,41,0,17,1
2022-04-29,"82 - 1163",119,148,102,17,29,0.857142857142857
2022-04-30,"40 - 1320",105,105,104,1,0,0.99047619047619
2022-04-30,"40 - 1114",214,231,213,1,17,0.995327102803738
2022-04-30,"53 - 1103",181,186,181,0,5,1
2022-04-30,"2 - 1066",39,58,39,0,19,1
2022-04-30,"82 - 1163",119,148,100,19,29,0.840336134453782
2022-05-01,"40 - 1320",105,105,104,1,0,0.99047619047619
2022-05-01,"40 - 1114",212,231,211,1,19,0.995283018867924
2022-05-01,"53 - 1103",181,186,181,0,5,1
2022-05-01,"2 - 1066",37,58,37,0,21,1
2022-05-01,"82 - 1163",117,148,85,32,31,0.726495726495726
2022-05-02,"40 - 1320",105,105,105,0,0,1
2022-05-02,"40 - 1114",210,231,210,0,21,1
2022-05-02,"53 - 1103",182,186,180,2,4,0.989010989010989
2022-05-02,"2 - 1066",36,58,36,0,22,1
2022-05-02,"82 - 1163",117,178,82,35,61,0.700854700854701
2022-05-03,"40 - 1320",105,105,105,0,0,1
2022-05-03,"40 - 1114",211,231,211,0,20,1
2022-05-03,"53 - 1103",182,186,182,0,4,1
2022-05-03,"2 - 1066",38,58,37,1,20,0.973684210526316
2022-05-03,"82 - 1163",118,178,84,34,60,0.711864406779661
2022-05-04,"40 - 1320",105,105,105,0,0,1
2022-05-04,"40 - 1114",211,231,211,0,20,1
2022-05-04,"53 - 1103",184,186,184,0,2,1
2022-05-04,"2 - 1066",39,58,38,1,19,0.974358974358974
2022-05-04,"82 - 1163",118,178,83,35,60,0.703389830508475
2022-05-05,"40 - 1320",104,105,104,0,1,1
2022-05-05,"40 - 1114",211,231,211,0,20,1
2022-05-05,"53 - 1103",184,186,182,2,2,0.989130434782609
2022-05-05,"2 - 1066",40,58,39,1,18,0.975
2022-05-05,"82 - 1163",115,178,82,33,63,0.71304347826087
2022-05-06,"40 - 1320",104,105,104,0,1,1
2022-05-06,"40 - 1114",213,231,212,1,18,0.995305164319249
2022-05-06,"53 - 1103",183,186,182,1,3,0.994535519125683
2022-05-06,"2 - 1066",37,58,37,0,21,1
2022-05-06,"82 - 1163",115,178,81,34,63,0.704347826086957
2022-05-07,"40 - 1320",104,105,104,0,1,1
2022-05-07,"40 - 1114",215,231,213,2,16,0.990697674418605
2022-05-07,"53 - 1103",185,186,183,2,1,0.989189189189189
2022-05-07,"2 - 1066",37,58,37,0,21,1
2022-05-07,"82 - 1163",114,178,80,34,64,0.701754385964912
2022-05-08,"40 - 1320",104,105,104,0,1,1
2022-05-08,"40 - 1114",216,231,214,2,15,0.990740740740741
2022-05-08,"53 - 1103",185,186,183,2,1,0.989189189189189
2022-05-08,"2 - 1066",39,58,39,0,19,1
2022-05-08,"82 - 1163",114,178,80,34,64,0.701754385964912
2022-05-09,"40 - 1320",104,105,104,0,1,1
2022-05-09,"40 - 1114",216,231,215,1,15,0.99537037037037
2022-05-09,"53 - 1103",186,186,186,0,0,1
2022-05-09,"2 - 1066",39,58,39,0,19,1
2022-05-09,"82 - 1163",117,178,84,33,61,0.717948717948718
2022-05-10,"40 - 1320",105,105,105,0,0,1
2022-05-10,"40 - 1114",216,231,216,0,15,1
2022-05-10,"53 - 1103",185,186,185,0,1,1
2022-05-10,"2 - 1066",37,58,37,0,21,1
2022-05-10,"82 - 1163",119,178,85,34,59,0.714285714285714
2022-05-11,"40 - 1320",105,105,105,0,0,1
2022-05-11,"40 - 1114",211,231,211,0,20,1
2022-05-11,"53 - 1103",186,186,186,0,0,1
2022-05-11,"2 - 1066",38,58,38,0,20,1
2022-05-11,"82 - 1163",121,178,88,33,57,0.727272727272727
2022-05-12,"40 - 1320",105,105,105,0,0,1
2022-05-12,"40 - 1114",211,231,211,0,20,1
2022-05-12,"53 - 1103",185,186,184,1,1,0.994594594594595
2022-05-12,"2 - 1066",40,58,40,0,18,1
2022-05-12,"82 - 1163",125,178,90,35,53,0.72
2022-05-13,"40 - 1320",105,105,105,0,0,1
2022-05-13,"40 - 1114",213,231,213,0,18,1
2022-05-13,"53 - 1103",185,186,185,0,1,1
2022-05-13,"2 - 1066",39,58,39,0,19,1
2022-05-13,"82 - 1163",125,178,86,39,53,0.688
2022-05-14,"40 - 1320",105,105,105,0,0,1
2022-05-14,"40 - 1114",215,231,215,0,16,1
2022-05-14,"53 - 1103",185,186,184,1,1,0.994594594594595
2022-05-14,"2 - 1066",38,58,38,0,20,1
2022-05-14,"82 - 1163",125,178,90,35,53,0.72
2022-05-15,"40 - 1320",105,105,105,0,0,1
2022-05-15,"40 - 1114",216,231,216,0,15,1
2022-05-15,"53 - 1103",184,186,182,2,2,0.989130434782609
2022-05-15,"2 - 1066",38,58,38,0,20,1
2022-05-15,"82 - 1163",122,148,84,38,26,0.688524590163934
2022-05-16,"40 - 1320",105,105,105,0,0,1
2022-05-16,"40 - 1114",215,231,215,0,16,1
2022-05-16,"53 - 1103",179,186,179,0,7,1
2022-05-16,"2 - 1066",38,58,38,0,20,1
2022-05-16,"82 - 1163",121,148,85,36,27,0.702479338842975
2022-05-17,"40 - 1320",105,105,105,0,0,1
2022-05-17,"40 - 1114",216,231,216,0,15,1
2022-05-17,"53 - 1103",179,186,177,2,7,0.988826815642458
2022-05-17,"2 - 1066",39,58,39,0,19,1
2022-05-17,"82 - 1163",127,148,91,36,21,0.716535433070866
2022-05-18,"40 - 1320",105,105,105,0,0,1
2022-05-18,"40 - 1114",219,231,218,1,12,0.995433789954338
2022-05-18,"53 - 1103",176,186,176,0,10,1
2022-05-18,"2 - 1066",40,58,39,1,18,0.975
2022-05-18,"82 - 1163",129,148,94,35,19,0.728682170542636
2022-05-19,"40 - 1320",105,105,105,0,0,1
2022-05-19,"40 - 1114",217,231,217,0,14,1
2022-05-19,"53 - 1103",179,186,179,0,7,1
2022-05-19,"2 - 1066",41,58,40,1,17,0.975609756097561
2022-05-19,"82 - 1163",129,148,92,37,19,0.713178294573643
2022-05-20,"40 - 1320",105,105,103,2,0,0.980952380952381
2022-05-20,"40 - 1114",217,231,217,0,14,1
2022-05-20,"53 - 1103",183,186,183,0,3,1
2022-05-20,"2 - 1066",42,58,42,0,16,1
2022-05-20,"82 - 1163",129,148,97,32,19,0.751937984496124
2022-05-21,"40 - 1320",104,105,104,0,1,1
2022-05-21,"40 - 1114",219,231,218,1,12,0.995433789954338
2022-05-21,"53 - 1103",185,186,184,1,1,0.994594594594595
2022-05-21,"2 - 1066",42,58,42,0,16,1
2022-05-21,"82 - 1163",129,148,96,33,19,0.744186046511628
2022-05-22,"40 - 1320",104,105,104,0,1,1
2022-05-22,"40 - 1114",219,231,219,0,12,1
2022-05-22,"53 - 1103",185,186,184,1,1,0.994594594594595
2022-05-22,"2 - 1066",42,58,42,0,16,1
2022-05-22,"82 - 1163",129,148,96,33,19,0.744186046511628
2022-05-23,"40 - 1320",104,105,103,1,1,0.990384615384615
2022-05-23,"40 - 1114",219,231,219,0,12,1
2022-05-23,"53 - 1103",186,186,183,3,0,0.983870967741935
2022-05-23,"2 - 1066",44,58,43,1,14,0.977272727272727
2022-05-23,"82 - 1163",129,148,95,34,19,0.736434108527132
2022-05-24,"40 - 1320",105,105,105,0,0,1
2022-05-24,"40 - 1114",220,231,219,1,11,0.995454545454545
2022-05-24,"53 - 1103",185,186,182,3,1,0.983783783783784
2022-05-24,"2 - 1066",44,58,44,0,14,1
2022-05-24,"82 - 1163",129,148,94,35,19,0.728682170542636
2022-05-25,"40 - 1320",105,105,105,0,0,1
2022-05-25,"40 - 1114",220,231,220,0,11,1
2022-05-25,"53 - 1103",178,186,176,2,8,0.98876404494382
2022-05-25,"2 - 1066",44,58,44,0,14,1
2022-05-25,"82 - 1163",129,148,93,36,19,0.72093023255814
2022-05-26,"40 - 1320",105,105,105,0,0,1
2022-05-26,"40 - 1114",219,231,219,0,12,1
2022-05-26,"53 - 1103",183,186,180,3,3,0.983606557377049
2022-05-26,"2 - 1066",44,58,44,0,14,1
2022-05-26,"82 - 1163",129,148,94,35,19,0.728682170542636
2022-05-27,"40 - 1320",105,105,105,0,0,1
2022-05-27,"40 - 1114",215,231,215,0,16,1
2022-05-27,"53 - 1103",182,186,181,1,4,0.994505494505495
2022-05-27,"2 - 1066",43,58,43,0,15,1
2022-05-27,"82 - 1163",127,148,93,34,21,0.732283464566929
2022-05-28,"40 - 1320",105,105,105,0,0,1
2022-05-28,"40 - 1114",216,231,215,1,15,0.99537037037037
2022-05-28,"53 - 1103",186,186,182,4,0,0.978494623655914
2022-05-28,"2 - 1066",44,58,44,0,14,1
2022-05-28,"82 - 1163",127,148,92,35,21,0.724409448818898
2022-05-29,"40 - 1320",105,105,105,0,0,1
2022-05-29,"40 - 1114",216,231,215,1,15,0.99537037037037
2022-05-29,"53 - 1103",184,186,182,2,2,0.989130434782609
2022-05-29,"2 - 1066",44,58,44,0,14,1
2022-05-29,"82 - 1163",127,148,92,35,21,0.724409448818898
2022-05-30,"40 - 1320",105,105,105,0,0,1
2022-05-30,"40 - 1114",215,231,215,0,16,1
2022-05-30,"53 - 1103",184,186,183,1,2,0.994565217391304
2022-05-30,"2 - 1066",44,58,44,0,14,1
2022-05-30,"82 - 1163",127,148,91,36,21,0.716535433070866
2022-05-31,"40 - 1320",105,105,105,0,0,1
2022-05-31,"40 - 1114",215,231,213,2,16,0.990697674418605
2022-05-31,"53 - 1103",183,186,182,1,3,0.994535519125683
2022-05-31,"2 - 1066",45,58,45,0,13,1
2022-05-31,"82 - 1163",127,148,87,40,21,0.68503937007874
2022-06-01,"40 - 1320",105,105,105,0,0,1
2022-06-01,"40 - 1114",211,231,211,0,20,1
2022-06-01,"53 - 1103",181,186,180,1,5,0.994475138121547
2022-06-01,"2 - 1066",45,58,45,0,13,1
2022-06-01,"82 - 1163",126,148,89,37,22,0.706349206349206
2022-06-02,"40 - 1320",105,105,104,1,0,0.99047619047619
2022-06-02,"40 - 1114",211,231,211,0,20,1
2022-06-02,"53 - 1103",182,186,181,1,4,0.994505494505495
2022-06-02,"2 - 1066",43,58,43,0,15,1
2022-06-02,"82 - 1163",125,148,88,37,23,0.704
2022-06-03,"40 - 1320",104,105,104,0,1,1
2022-06-03,"40 - 1114",209,231,209,0,22,1
2022-06-03,"53 - 1103",185,186,184,1,1,0.994594594594595
2022-06-03,"2 - 1066",44,58,44,0,14,1
2022-06-03,"82 - 1163",127,148,86,41,21,0.677165354330709
2022-06-04,"40 - 1320",104,105,103,1,1,0.990384615384615
2022-06-04,"40 - 1114",209,231,209,0,22,1
2022-06-04,"53 - 1103",184,186,184,0,2,1
2022-06-04,"2 - 1066",44,58,44,0,14,1
2022-06-04,"82 - 1163",124,148,84,40,24,0.67741935483871
2022-06-05,"40 - 1320",105,105,105,0,0,1
2022-06-05,"40 - 1114",209,231,209,0,22,1
2022-06-05,"53 - 1103",183,186,181,2,3,0.989071038251366
2022-06-05,"2 - 1066",45,58,44,1,13,0.977777777777778
2022-06-05,"82 - 1163",124,148,84,40,24,0.67741935483871
2022-06-06,"40 - 1320",105,105,105,0,0,1
2022-06-06,"40 - 1114",210,231,208,2,21,0.99047619047619
2022-06-06,"53 - 1103",183,186,183,0,3,1
2022-06-06,"2 - 1066",45,58,45,0,13,1
2022-06-06,"82 - 1163",123,148,82,41,25,0.666666666666667
2022-06-07,"40 - 1320",105,105,105,0,0,1
2022-06-07,"40 - 1114",214,231,212,2,17,0.990654205607477
2022-06-07,"53 - 1103",183,186,181,2,3,0.989071038251366
2022-06-07,"2 - 1066",45,58,45,0,13,1
2022-06-07,"82 - 1163",126,148,85,41,22,0.674603174603175
2022-06-08,"40 - 1320",105,105,105,0,0,1
2022-06-08,"40 - 1114",214,231,214,0,17,1
2022-06-08,"53 - 1103",179,186,179,0,7,1
2022-06-08,"2 - 1066",45,58,45,0,13,1
2022-06-08,"82 - 1163",126,148,83,43,22,0.658730158730159
2022-06-09,"40 - 1320",105,105,105,0,0,1
2022-06-09,"40 - 1114",216,231,215,1,15,0.99537037037037
2022-06-09,"53 - 1103",179,186,179,0,7,1
2022-06-09,"2 - 1066",45,58,45,0,13,1
2022-06-09,"82 - 1163",125,148,84,41,23,0.672
2022-06-10,"40 - 1320",105,105,105,0,0,1
2022-06-10,"40 - 1114",220,231,219,1,11,0.995454545454545
2022-06-10,"53 - 1103",174,186,174,0,12,1
2022-06-10,"2 - 1066",45,58,45,0,13,1
2022-06-10,"82 - 1163",134,148,93,41,14,0.694029850746269
2022-06-11,"40 - 1320",105,105,105,0,0,1
2022-06-11,"40 - 1114",219,231,218,1,12,0.995433789954338
2022-06-11,"53 - 1103",176,186,174,2,10,0.988636363636364
2022-06-11,"2 - 1066",45,58,45,0,13,1
2022-06-11,"82 - 1163",142,148,98,44,6,0.690140845070423
2022-06-12,"40 - 1320",105,105,105,0,0,1
2022-06-12,"40 - 1114",219,231,219,0,12,1
2022-06-12,"53 - 1103",180,186,178,2,6,0.988888888888889
2022-06-12,"2 - 1066",45,58,45,0,13,1
2022-06-12,"82 - 1163",140,148,97,43,8,0.692857142857143
2022-06-13,"40 - 1320",105,105,105,0,0,1
2022-06-13,"40 - 1114",219,231,219,0,12,1
2022-06-13,"53 - 1103",178,186,177,1,8,0.99438202247191
2022-06-13,"2 - 1066",45,58,45,0,13,1
2022-06-13,"82 - 1163",147,148,107,40,1,0.727891156462585
2022-06-14,"40 - 1320",105,105,105,0,0,1
2022-06-14,"40 - 1114",217,231,216,1,14,0.995391705069124
2022-06-14,"53 - 1103",180,186,180,0,6,1
2022-06-14,"2 - 1066",45,58,45,0,13,1
2022-06-14,"82 - 1163",149,148,111,38,-1,0.74496644295302
2022-06-15,"40 - 1320",105,105,105,0,0,1
2022-06-15,"40 - 1114",218,231,218,0,13,1
2022-06-15,"53 - 1103",180,186,177,3,6,0.983333333333333
2022-06-15,"2 - 1066",45,58,45,0,13,1
2022-06-15,"82 - 1163",141,148,113,28,7,0.801418439716312
2022-06-16,"40 - 1320",105,105,105,0,0,1
2022-06-16,"40 - 1114",221,231,220,1,10,0.995475113122172
2022-06-16,"53 - 1103",181,186,180,1,5,0.994475138121547
2022-06-16,"2 - 1066",46,58,46,0,12,1
2022-06-16,"82 - 1163",138,148,112,26,10,0.811594202898551
2022-06-17,"40 - 1320",105,105,105,0,0,1
2022-06-17,"40 - 1114",223,231,223,0,8,1
2022-06-17,"53 - 1103",180,186,180,0,6,1
2022-06-17,"2 - 1066",46,58,46,0,12,1
2022-06-17,"82 - 1163",137,148,109,28,11,0.795620437956204
2022-06-18,"40 - 1320",105,105,105,0,0,1
2022-06-18,"40 - 1114",225,231,225,0,6,1
2022-06-18,"53 - 1103",179,186,179,0,7,1
2022-06-18,"2 - 1066",46,58,46,0,12,1
2022-06-18,"82 - 1163",137,148,109,28,11,0.795620437956204
2022-06-19,"40 - 1320",105,105,105,0,0,1
2022-06-19,"40 - 1114",227,231,226,1,4,0.995594713656388
2022-06-19,"53 - 1103",178,186,178,0,8,1
2022-06-19,"2 - 1066",46,58,46,0,12,1
2022-06-19,"82 - 1163",136,148,109,27,12,0.801470588235294
2022-06-20,"40 - 1320",105,105,105,0,0,1
2022-06-20,"40 - 1114",226,231,226,0,5,1
2022-06-20,"53 - 1103",181,186,178,3,5,0.983425414364641
2022-06-20,"2 - 1066",45,58,45,0,13,1
2022-06-20,"82 - 1163",134,148,108,26,14,0.805970149253731
2022-06-21,"40 - 1320",105,105,105,0,0,1
2022-06-21,"40 - 1114",226,231,226,0,5,1
2022-06-21,"53 - 1103",178,186,178,0,8,1
2022-06-21,"2 - 1066",45,58,45,0,13,1
2022-06-21,"82 - 1163",137,148,113,24,11,0.824817518248175
2022-06-22,"40 - 1320",105,105,104,1,0,0.99047619047619
2022-06-22,"40 - 1114",227,231,227,0,4,1
2022-06-22,"53 - 1103",177,186,176,1,9,0.994350282485876
2022-06-22,"2 - 1066",45,58,45,0,13,1
2022-06-22,"82 - 1163",138,148,115,23,10,0.833333333333333
2022-06-23,"40 - 1320",105,105,105,0,0,1
2022-06-23,"40 - 1114",227,231,227,0,4,1
2022-06-23,"53 - 1103",178,186,175,3,8,0.98314606741573
2022-06-23,"2 - 1066",44,58,44,0,14,1
2022-06-23,"82 - 1163",138,148,118,20,10,0.855072463768116
2022-06-24,"40 - 1320",105,105,105,0,0,1
2022-06-24,"40 - 1114",226,231,226,0,5,1
2022-06-24,"53 - 1103",179,186,176,3,7,0.983240223463687
2022-06-24,"2 - 1066",45,58,45,0,13,1
2022-06-24,"82 - 1163",139,148,118,21,9,0.848920863309353
2022-06-25,"40 - 1320",105,105,105,0,0,1
2022-06-25,"40 - 1114",227,231,227,0,4,1
2022-06-25,"53 - 1103",177,186,175,2,9,0.988700564971751
2022-06-25,"2 - 1066",44,58,43,1,14,0.977272727272727
2022-06-25,"82 - 1163",139,148,119,20,9,0.856115107913669
2022-06-26,"40 - 1320",105,105,105,0,0,1
2022-06-26,"40 - 1114",227,231,227,0,4,1
2022-06-26,"53 - 1103",177,186,173,4,9,0.977401129943503
2022-06-26,"2 - 1066",44,58,43,1,14,0.977272727272727
2022-06-26,"82 - 1163",139,148,119,20,9,0.856115107913669
2022-06-27,"40 - 1320",105,105,105,0,0,1
2022-06-27,"40 - 1114",226,231,226,0,5,1
2022-06-27,"53 - 1103",177,186,175,2,9,0.988700564971751
2022-06-27,"2 - 1066",44,58,44,0,14,1
2022-06-27,"82 - 1163",135,148,116,19,13,0.859259259259259
2022-06-28,"40 - 1320",105,105,105,0,0,1
2022-06-28,"40 - 1114",226,231,226,0,5,1
2022-06-28,"53 - 1103",177,186,176,1,9,0.994350282485876
2022-06-28,"2 - 1066",44,58,44,0,14,1
2022-06-28,"82 - 1163",136,178,119,17,42,0.875
2022-06-29,"40 - 1320",105,105,105,0,0,1
2022-06-29,"40 - 1114",226,231,226,0,5,1
2022-06-29,"53 - 1103",179,186,179,0,7,1
2022-06-29,"2 - 1066",44,58,44,0,14,1
2022-06-29,"82 - 1163",138,178,124,14,40,0.898550724637681
2022-06-30,"40 - 1320",104,105,103,1,1,0.990384615384615
2022-06-30,"40 - 1114",226,231,226,0,5,1
2022-06-30,"53 - 1103",179,186,177,2,7,0.988826815642458
2022-06-30,"2 - 1066",44,58,44,0,14,1
2022-06-30,"82 - 1163",141,178,125,16,37,0.886524822695035
2022-07-01,"40 - 1320",104,105,102,2,1,0.980769230769231
2022-07-01,"40 - 1114",227,231,227,0,4,1
2022-07-01,"53 - 1103",178,186,177,1,8,0.99438202247191
2022-07-01,"2 - 1066",44,58,44,0,14,1
2022-07-01,"82 - 1163",138,178,120,18,40,0.869565217391304
2022-07-02,"40 - 1320",105,105,105,0,0,1
2022-07-02,"40 - 1114",227,231,227,0,4,1
2022-07-02,"53 - 1103",180,186,178,2,6,0.988888888888889
2022-07-02,"2 - 1066",44,58,44,0,14,1
2022-07-02,"82 - 1163",138,178,117,21,40,0.847826086956522
2022-07-03,"40 - 1320",105,105,105,0,0,1
2022-07-03,"40 - 1114",226,231,226,0,5,1
2022-07-03,"53 - 1103",179,186,178,1,7,0.994413407821229
2022-07-03,"2 - 1066",43,58,43,0,15,1
2022-07-03,"82 - 1163",138,178,116,22,40,0.840579710144927
2022-07-04,"40 - 1320",105,105,105,0,0,1
2022-07-04,"40 - 1114",224,231,224,0,7,1
2022-07-04,"53 - 1103",177,186,177,0,9,1
2022-07-04,"2 - 1066",44,58,44,0,14,1
2022-07-04,"82 - 1163",137,178,112,25,41,0.817518248175182
2022-07-05,"40 - 1320",105,105,105,0,0,1
2022-07-05,"40 - 1114",221,231,221,0,10,1
2022-07-05,"53 - 1103",180,186,179,1,6,0.994444444444444
2022-07-05,"2 - 1066",43,40,43,0,-3,1
2022-07-05,"82 - 1163",139,178,116,23,39,0.83453237410072
2022-07-06,"40 - 1320",105,105,105,0,0,1
2022-07-06,"40 - 1114",220,231,219,1,11,0.995454545454545
2022-07-06,"53 - 1103",180,186,180,0,6,1
2022-07-06,"2 - 1066",42,40,42,0,-2,1
2022-07-06,"82 - 1163",137,178,117,20,41,0.854014598540146
2022-07-07,"40 - 1320",105,105,105,0,0,1
2022-07-07,"40 - 1114",226,232,220,6,6,0.973451327433628
2022-07-07,"53 - 1103",179,186,178,1,7,0.994413407821229
2022-07-07,"2 - 1066",42,40,42,0,-2,1
2022-07-07,"82 - 1163",138,178,124,14,40,0.898550724637681
2022-07-08,"40 - 1320",105,105,105,0,0,1
2022-07-08,"40 - 1114",222,232,222,0,10,1
2022-07-08,"53 - 1103",179,186,179,0,7,1
2022-07-08,"2 - 1066",44,40,44,0,-4,1
2022-07-08,"82 - 1163",139,178,120,19,39,0.863309352517986
2022-07-09,"40 - 1320",105,105,105,0,0,1
2022-07-09,"40 - 1114",226,232,226,0,6,1
2022-07-09,"53 - 1103",179,186,179,0,7,1
2022-07-09,"2 - 1066",45,40,45,0,-5,1
2022-07-09,"82 - 1163",139,178,121,18,39,0.870503597122302
2022-07-10,"40 - 1320",105,105,105,0,0,1
2022-07-10,"40 - 1114",226,232,225,1,6,0.995575221238938
2022-07-10,"53 - 1103",179,186,178,1,7,0.994413407821229
2022-07-10,"2 - 1066",45,40,45,0,-5,1
2022-07-10,"82 - 1163",140,178,123,17,38,0.878571428571429
2022-07-11,"40 - 1320",105,105,105,0,0,1
2022-07-11,"40 - 1114",223,232,223,0,9,1
2022-07-11,"53 - 1103",178,186,178,0,8,1
2022-07-11,"2 - 1066",45,40,45,0,-5,1
2022-07-11,"82 - 1163",135,178,123,12,43,0.911111111111111
2022-07-12,"40 - 1320",104,105,104,0,1,1
2022-07-12,"40 - 1114",225,232,225,0,7,1
2022-07-12,"53 - 1103",179,186,178,1,7,0.994413407821229
2022-07-12,"2 - 1066",45,40,45,0,-5,1
2022-07-12,"82 - 1163",134,178,122,12,44,0.91044776119403
2022-07-13,"40 - 1320",104,105,104,0,1,1
2022-07-13,"40 - 1114",228,232,228,0,4,1
2022-07-13,"53 - 1103",180,186,179,1,6,0.994444444444444
2022-07-13,"2 - 1066",45,40,45,0,-5,1
2022-07-13,"82 - 1163",136,178,125,11,42,0.919117647058823
2022-07-14,"40 - 1320",104,105,104,0,1,1
2022-07-14,"40 - 1114",228,232,228,0,4,1
2022-07-14,"53 - 1103",181,186,179,2,5,0.988950276243094
2022-07-14,"2 - 1066",46,40,46,0,-6,1
2022-07-14,"82 - 1163",136,178,125,11,42,0.919117647058823
2022-07-15,"40 - 1320",105,105,104,1,0,0.99047619047619
2022-07-15,"40 - 1114",227,232,227,0,5,1
2022-07-15,"53 - 1103",182,186,179,3,4,0.983516483516483
2022-07-15,"2 - 1066",46,40,46,0,-6,1
2022-07-15,"82 - 1163",136,178,127,9,42,0.933823529411765
2022-07-16,"40 - 1320",105,105,105,0,0,1
2022-07-16,"40 - 1114",227,232,227,0,5,1
2022-07-16,"53 - 1103",183,186,179,4,3,0.978142076502732
2022-07-16,"2 - 1066",46,40,46,0,-6,1
2022-07-16,"82 - 1163",136,178,126,10,42,0.926470588235294
2022-07-17,"40 - 1320",105,105,105,0,0,1
2022-07-17,"40 - 1114",227,232,227,0,5,1
2022-07-17,"53 - 1103",183,186,178,5,3,0.972677595628415
2022-07-17,"2 - 1066",46,40,46,0,-6,1
2022-07-17,"82 - 1163",135,178,126,9,43,0.933333333333333
2022-07-18,"40 - 1320",105,105,105,0,0,1
2022-07-18,"40 - 1114",227,231,226,1,4,0.995594713656388
2022-07-18,"53 - 1103",179,186,179,0,7,1
2022-07-18,"2 - 1066",46,40,46,0,-6,1
2022-07-18,"82 - 1163",134,178,123,11,44,0.917910447761194
2022-07-19,"40 - 1320",105,105,105,0,0,1
2022-07-19,"40 - 1114",229,232,227,2,3,0.991266375545852
2022-07-19,"53 - 1103",179,186,178,1,7,0.994413407821229
2022-07-19,"2 - 1066",46,40,46,0,-6,1
2022-07-19,"82 - 1163",134,178,124,10,44,0.925373134328358
2022-07-20,"40 - 1320",105,105,105,0,0,1
2022-07-20,"40 - 1114",228,232,228,0,4,1
2022-07-20,"53 - 1103",182,186,182,0,4,1
2022-07-20,"2 - 1066",45,40,45,0,-5,1
2022-07-20,"82 - 1163",133,178,122,11,45,0.917293233082707
2022-07-21,"40 - 1320",105,105,105,0,0,1
2022-07-21,"40 - 1114",229,232,229,0,3,1
2022-07-21,"53 - 1103",184,186,183,1,2,0.994565217391304
2022-07-21,"2 - 1066",46,40,46,0,-6,1
2022-07-21,"82 - 1163",133,178,126,7,45,0.947368421052632
2022-07-22,"40 - 1320",105,105,105,0,0,1
2022-07-22,"40 - 1114",230,232,229,1,2,0.995652173913044
2022-07-22,"53 - 1103",183,186,183,0,3,1
2022-07-22,"2 - 1066",45,40,45,0,-5,1
2022-07-22,"82 - 1163",133,178,126,7,45,0.947368421052632
2022-07-23,"40 - 1320",105,105,104,1,0,0.99047619047619
2022-07-23,"40 - 1114",230,232,230,0,2,1
2022-07-23,"53 - 1103",183,186,182,1,3,0.994535519125683
2022-07-23,"2 - 1066",45,40,45,0,-5,1
2022-07-23,"82 - 1163",136,178,127,9,42,0.933823529411765
2022-07-24,"40 - 1320",105,105,105,0,0,1
2022-07-24,"40 - 1114",230,232,230,0,2,1
2022-07-24,"53 - 1103",182,186,179,3,4,0.983516483516483
2022-07-24,"2 - 1066",45,40,45,0,-5,1
2022-07-24,"82 - 1163",132,178,123,9,46,0.931818181818182
2022-07-25,"40 - 1320",105,105,105,0,0,1
2022-07-25,"40 - 1114",230,232,230,0,2,1
2022-07-25,"53 - 1103",183,186,183,0,3,1
2022-07-25,"2 - 1066",45,40,45,0,-5,1
2022-07-25,"82 - 1163",131,178,124,7,47,0.946564885496183
2022-07-26,"40 - 1320",105,105,105,0,0,1
2022-07-26,"40 - 1114",230,232,230,0,2,1
2022-07-26,"53 - 1103",184,186,183,1,2,0.994565217391304
2022-07-26,"2 - 1066",44,40,44,0,-4,1
2022-07-26,"82 - 1163",142,178,125,17,36,0.880281690140845
2022-07-27,"40 - 1320",105,105,105,0,0,1
2022-07-27,"40 - 1114",230,232,230,0,2,1
2022-07-27,"53 - 1103",184,186,183,1,2,0.994565217391304
2022-07-27,"2 - 1066",46,40,46,0,-6,1
2022-07-27,"82 - 1163",143,178,129,14,35,0.902097902097902
2022-07-28,"40 - 1320",105,105,105,0,0,1
2022-07-28,"40 - 1114",228,231,228,0,3,1
2022-07-28,"53 - 1103",183,186,182,1,3,0.994535519125683
2022-07-28,"2 - 1066",46,40,46,0,-6,1
2022-07-28,"82 - 1163",143,178,133,10,35,0.93006993006993
2022-07-29,"40 - 1320",105,105,104,1,0,0.99047619047619
2022-07-29,"40 - 1114",228,231,228,0,3,1
2022-07-29,"53 - 1103",185,186,185,0,1,1
2022-07-29,"2 - 1066",46,40,46,0,-6,1
2022-07-29,"82 - 1163",144,178,136,8,34,0.944444444444444
2022-07-30,"40 - 1320",105,105,105,0,0,1
2022-07-30,"40 - 1114",228,231,228,0,3,1
2022-07-30,"53 - 1103",184,186,184,0,2,1
2022-07-30,"2 - 1066",46,40,46,0,-6,1
2022-07-30,"82 - 1163",145,178,134,11,33,0.924137931034483
2022-07-31,"40 - 1320",105,105,105,0,0,1
2022-07-31,"40 - 1114",228,231,228,0,3,1
2022-07-31,"53 - 1103",184,186,184,0,2,1
2022-07-31,"2 - 1066",46,40,46,0,-6,1
2022-07-31,"82 - 1163",146,178,128,18,32,0.876712328767123
2022-08-01,"40 - 1320",105,105,104,1,0,0.99047619047619
2022-08-01,"40 - 1114",227,231,227,0,4,1
2022-08-01,"53 - 1103",183,186,183,0,3,1
2022-08-01,"2 - 1066",45,40,45,0,-5,1
2022-08-01,"82 - 1163",146,178,126,20,32,0.863013698630137
2022-08-02,"40 - 1320",105,105,105,0,0,1
2022-08-02,"40 - 1114",226,231,226,0,5,1
2022-08-02,"53 - 1103",183,186,183,0,3,1
2022-08-02,"2 - 1066",45,40,45,0,-5,1
2022-08-02,"82 - 1163",142,178,126,16,36,0.887323943661972
2022-08-03,"40 - 1320",105,105,105,0,0,1
2022-08-03,"40 - 1114",223,231,223,0,8,1
2022-08-03,"53 - 1103",183,186,183,0,3,1
2022-08-03,"2 - 1066",45,40,45,0,-5,1
2022-08-03,"82 - 1163",142,178,124,18,36,0.873239436619718
2022-08-04,"40 - 1320",103,105,102,1,2,0.990291262135922
2022-08-04,"40 - 1114",223,231,223,0,8,1
2022-08-04,"53 - 1103",185,186,185,0,1,1
2022-08-04,"2 - 1066",45,40,45,0,-5,1
2022-08-04,"82 - 1163",142,178,126,16,36,0.887323943661972
2022-08-05,"40 - 1320",104,105,103,1,1,0.990384615384615
2022-08-05,"40 - 1114",223,231,223,0,8,1
2022-08-05,"53 - 1103",181,186,181,0,5,1
2022-08-05,"2 - 1066",44,40,44,0,-4,1
2022-08-05,"82 - 1163",142,178,125,17,36,0.880281690140845
2022-08-06,"40 - 1320",104,105,103,1,1,0.990384615384615
2022-08-06,"40 - 1114",223,231,223,0,8,1
2022-08-06,"53 - 1103",183,186,180,3,3,0.983606557377049
2022-08-06,"2 - 1066",45,40,45,0,-5,1
2022-08-06,"82 - 1163",143,178,118,25,35,0.825174825174825
2022-08-07,"40 - 1320",105,105,104,1,0,0.99047619047619
2022-08-07,"40 - 1114",223,231,222,1,8,0.995515695067265
2022-08-07,"53 - 1103",182,186,181,1,4,0.994505494505495
2022-08-07,"2 - 1066",45,40,45,0,-5,1
2022-08-07,"82 - 1163",141,178,114,27,37,0.808510638297872
2022-08-08,"40 - 1320",105,105,104,1,0,0.99047619047619
2022-08-08,"40 - 1114",223,231,223,0,8,1
2022-08-08,"53 - 1103",181,186,181,0,5,1
2022-08-08,"2 - 1066",45,40,45,0,-5,1
2022-08-08,"82 - 1163",141,178,115,26,37,0.815602836879433
2022-08-09,"40 - 1320",105,105,104,1,0,0.99047619047619
2022-08-09,"40 - 1114",223,231,223,0,8,1
2022-08-09,"53 - 1103",183,186,183,0,3,1
2022-08-09,"2 - 1066",45,40,45,0,-5,1
2022-08-09,"82 - 1163",140,178,116,24,38,0.828571428571429
2022-08-10,"40 - 1320",105,105,105,0,0,1
2022-08-10,"40 - 1114",223,231,223,0,8,1
2022-08-10,"53 - 1103",183,186,183,0,3,1
2022-08-10,"2 - 1066",45,40,45,0,-5,1
2022-08-10,"82 - 1163",115,178,115,0,63,1
2022-08-11,"40 - 1320",105,105,104,1,0,0.99047619047619
2022-08-11,"40 - 1114",224,231,224,0,7,1
2022-08-11,"53 - 1103",183,186,183,0,3,1
2022-08-11,"2 - 1066",45,40,45,0,-5,1
2022-08-11,"82 - 1163",124,178,122,2,54,0.983870967741935
2022-08-12,"40 - 1320",105,105,105,0,0,1
2022-08-12,"40 - 1114",225,231,224,1,6,0.995555555555556
2022-08-12,"53 - 1103",185,186,184,1,1,0.994594594594595
2022-08-12,"2 - 1066",46,40,46,0,-6,1
2022-08-12,"82 - 1163",132,178,127,5,46,0.962121212121212
2022-08-13,"40 - 1320",104,105,104,0,1,1
2022-08-13,"40 - 1114",225,231,224,1,6,0.995555555555556
2022-08-13,"53 - 1103",182,186,182,0,4,1
2022-08-13,"2 - 1066",46,40,46,0,-6,1
2022-08-13,"82 - 1163",128,178,125,3,50,0.9765625
2022-08-14,"40 - 1320",105,105,105,0,0,1
2022-08-14,"40 - 1114",225,231,223,2,6,0.991111111111111
2022-08-14,"53 - 1103",179,186,179,0,7,1
2022-08-14,"2 - 1066",46,40,46,0,-6,1
2022-08-14,"82 - 1163",128,178,125,3,50,0.9765625
2022-08-15,"40 - 1320",105,105,105,0,0,1
2022-08-15,"40 - 1114",223,231,223,0,8,1
2022-08-15,"53 - 1103",180,186,179,1,6,0.994444444444444
2022-08-15,"2 - 1066",45,40,44,1,-5,0.977777777777778
2022-08-15,"82 - 1163",129,178,119,10,49,0.922480620155039
2022-08-16,"40 - 1320",105,105,105,0,0,1
2022-08-16,"40 - 1114",223,231,223,0,8,1
2022-08-16,"53 - 1103",185,186,185,0,1,1
2022-08-16,"2 - 1066",45,40,45,0,-5,1
2022-08-16,"82 - 1163",121,178,121,0,57,1
2022-08-17,"40 - 1320",105,105,105,0,0,1
2022-08-17,"40 - 1114",223,231,222,1,8,0.995515695067265
2022-08-17,"53 - 1103",185,186,183,2,1,0.989189189189189
2022-08-17,"2 - 1066",45,40,45,0,-5,1
2022-08-17,"82 - 1163",121,178,121,0,57,1
2022-08-18,"40 - 1320",105,105,105,0,0,1
2022-08-18,"40 - 1114",222,231,222,0,9,1
2022-08-18,"53 - 1103",182,186,182,0,4,1
2022-08-18,"2 - 1066",45,40,45,0,-5,1
2022-08-18,"82 - 1163",126,178,126,0,52,1
2022-08-19,"40 - 1320",105,105,105,0,0,1
2022-08-19,"40 - 1114",225,231,225,0,6,1
2022-08-19,"53 - 1103",182,186,181,1,4,0.994505494505495
2022-08-19,"2 - 1066",44,40,44,0,-4,1
2022-08-19,"82 - 1163",124,178,124,0,54,1
2022-08-20,"40 - 1320",105,105,104,1,0,0.99047619047619
2022-08-20,"40 - 1114",225,231,225,0,6,1
2022-08-20,"53 - 1103",183,186,182,1,3,0.994535519125683
2022-08-20,"2 - 1066",45,40,44,1,-5,0.977777777777778
2022-08-20,"82 - 1163",124,178,124,0,54,1
2022-08-21,"40 - 1320",105,105,104,1,0,0.99047619047619
2022-08-21,"40 - 1114",224,231,224,0,7,1
2022-08-21,"53 - 1103",182,186,181,1,4,0.994505494505495
2022-08-21,"2 - 1066",45,40,44,1,-5,0.977777777777778
2022-08-21,"82 - 1163",122,178,122,0,56,1
2022-08-22,"40 - 1320",105,105,105,0,0,1
2022-08-22,"40 - 1114",224,231,224,0,7,1
2022-08-22,"53 - 1103",183,186,179,4,3,0.978142076502732
2022-08-22,"2 - 1066",45,40,44,1,-5,0.977777777777778
2022-08-22,"82 - 1163",118,178,118,0,60,1
2022-08-23,"40 - 1320",105,105,105,0,0,1
2022-08-23,"40 - 1114",224,231,224,0,7,1
2022-08-23,"53 - 1103",181,186,180,1,5,0.994475138121547
2022-08-23,"2 - 1066",45,40,44,1,-5,0.977777777777778
2022-08-23,"82 - 1163",117,178,117,0,61,1
2022-08-24,"40 - 1320",105,105,105,0,0,1
2022-08-24,"40 - 1114",226,231,226,0,5,1
2022-08-24,"53 - 1103",183,186,182,1,3,0.994535519125683
2022-08-24,"2 - 1066",44,40,44,0,-4,1
2022-08-24,"82 - 1163",114,178,114,0,64,1
2022-08-25,"40 - 1320",105,105,105,0,0,1
2022-08-25,"40 - 1114",226,231,226,0,5,1
2022-08-25,"53 - 1103",185,186,184,1,1,0.994594594594595
2022-08-25,"2 - 1066",44,40,44,0,-4,1
2022-08-25,"82 - 1163",114,178,114,0,64,1
2022-08-26,"40 - 1320",105,105,105,0,0,1
2022-08-26,"40 - 1114",228,231,228,0,3,1
2022-08-26,"53 - 1103",185,186,185,0,1,1
2022-08-26,"2 - 1066",43,40,43,0,-3,1
2022-08-26,"82 - 1163",112,178,112,0,66,1
2022-08-27,"40 - 1320",105,105,105,0,0,1
2022-08-27,"40 - 1114",228,231,228,0,3,1
2022-08-27,"53 - 1103",185,186,185,0,1,1
2022-08-27,"2 - 1066",43,40,43,0,-3,1
2022-08-27,"82 - 1163",108,178,108,0,70,1
2022-08-28,"40 - 1320",105,105,105,0,0,1
2022-08-28,"40 - 1114",228,231,228,0,3,1
2022-08-28,"53 - 1103",184,186,184,0,2,1
2022-08-28,"2 - 1066",43,40,43,0,-3,1
2022-08-28,"82 - 1163",105,178,105,0,73,1
2022-08-29,"40 - 1320",105,105,105,0,0,1
2022-08-29,"40 - 1114",227,231,227,0,4,1
2022-08-29,"53 - 1103",183,186,182,1,3,0.994535519125683
2022-08-29,"2 - 1066",44,40,44,0,-4,1
2022-08-29,"82 - 1163",104,178,104,0,74,1
2022-08-30,"40 - 1320",104,105,104,0,1,1
2022-08-30,"40 - 1114",228,231,228,0,3,1
2022-08-30,"53 - 1103",183,186,182,1,3,0.994535519125683
2022-08-30,"2 - 1066",44,40,44,0,-4,1
2022-08-30,"82 - 1163",111,178,111,0,67,1
2022-08-31,"40 - 1320",105,105,104,1,0,0.99047619047619
2022-08-31,"40 - 1114",227,231,227,0,4,1
2022-08-31,"53 - 1103",183,186,183,0,3,1
2022-08-31,"2 - 1066",44,40,44,0,-4,1
2022-08-31,"82 - 1163",113,178,113,0,65,1
2022-09-01,"40 - 1320",105,105,102,3,0,0.971428571428571
2022-09-01,"40 - 1114",225,231,225,0,6,1
2022-09-01,"53 - 1103",180,186,180,0,6,1
2022-09-01,"2 - 1066",42,40,42,0,-2,1
2022-09-01,"82 - 1163",114,178,113,1,64,0.991228070175439
2022-09-02,"40 - 1320",105,105,104,1,0,0.99047619047619
2022-09-02,"40 - 1114",227,231,225,2,4,0.991189427312775
2022-09-02,"53 - 1103",181,186,181,0,5,1
2022-09-02,"2 - 1066",40,40,40,0,0,1
2022-09-02,"82 - 1163",115,178,115,0,63,1
2022-09-03,"40 - 1320",105,105,105,0,0,1
2022-09-03,"40 - 1114",227,231,227,0,4,1
2022-09-03,"53 - 1103",181,186,180,1,5,0.994475138121547
2022-09-03,"2 - 1066",40,40,40,0,0,1
2022-09-03,"82 - 1163",115,178,115,0,63,1
2022-09-04,"40 - 1320",105,105,105,0,0,1
2022-09-04,"40 - 1114",226,231,225,1,5,0.995575221238938
2022-09-04,"53 - 1103",182,186,180,2,4,0.989010989010989
2022-09-04,"2 - 1066",40,40,40,0,0,1
2022-09-04,"82 - 1163",114,178,114,0,64,1
2022-09-05,"40 - 1320",105,105,105,0,0,1
2022-09-05,"40 - 1114",226,231,226,0,5,1
2022-09-05,"53 - 1103",183,186,183,0,3,1
2022-09-05,"2 - 1066",40,40,40,0,0,1
2022-09-05,"82 - 1163",112,178,112,0,66,1
2022-09-06,"40 - 1320",105,105,105,0,0,1
2022-09-06,"40 - 1114",225,231,225,0,6,1
2022-09-06,"53 - 1103",183,186,183,0,3,1
2022-09-06,"2 - 1066",40,40,40,0,0,1
2022-09-06,"82 - 1163",110,178,110,0,68,1
2022-09-07,"40 - 1320",105,105,105,0,0,1
2022-09-07,"40 - 1114",224,231,224,0,7,1
2022-09-07,"53 - 1103",182,186,181,1,4,0.994505494505495
2022-09-07,"2 - 1066",40,40,40,0,0,1
2022-09-07,"82 - 1163",110,178,110,0,68,1
2022-09-08,"40 - 1320",105,105,105,0,0,1
2022-09-08,"40 - 1114",224,231,224,0,7,1
2022-09-08,"53 - 1103",182,186,182,0,4,1
2022-09-08,"2 - 1066",39,40,39,0,1,1
2022-09-08,"82 - 1163",109,178,109,0,69,1
2022-09-09,"40 - 1320",105,105,105,0,0,1
2022-09-09,"40 - 1114",225,231,225,0,6,1
2022-09-09,"53 - 1103",183,186,180,3,3,0.983606557377049
2022-09-09,"2 - 1066",37,40,37,0,3,1
2022-09-09,"82 - 1163",105,178,105,0,73,1
2022-09-10,"40 - 1320",105,105,105,0,0,1
2022-09-10,"40 - 1114",227,231,227,0,4,1
2022-09-10,"53 - 1103",183,186,180,3,3,0.983606557377049
2022-09-10,"2 - 1066",36,40,36,0,4,1
2022-09-10,"82 - 1163",105,178,105,0,73,1
2022-09-11,"40 - 1320",105,105,105,0,0,1
2022-09-11,"40 - 1114",227,231,227,0,4,1
2022-09-11,"53 - 1103",183,186,182,1,3,0.994535519125683
2022-09-11,"2 - 1066",36,40,36,0,4,1
2022-09-11,"82 - 1163",105,178,105,0,73,1
2022-09-12,"40 - 1320",105,105,105,0,0,1
2022-09-12,"40 - 1114",227,231,227,0,4,1
2022-09-12,"53 - 1103",183,186,182,1,3,0.994535519125683
2022-09-12,"2 - 1066",36,40,36,0,4,1
2022-09-12,"82 - 1163",105,178,105,0,73,1
2022-09-13,"40 - 1320",105,105,104,1,0,0.99047619047619
2022-09-13,"40 - 1114",226,231,225,1,5,0.995575221238938
2022-09-13,"53 - 1103",182,186,181,1,4,0.994505494505495
2022-09-13,"2 - 1066",36,40,36,0,4,1
2022-09-13,"82 - 1163",104,178,104,0,74,1
2022-09-14,"40 - 1320",105,105,105,0,0,1
2022-09-14,"40 - 1114",226,231,226,0,5,1
2022-09-14,"53 - 1103",185,186,184,1,1,0.994594594594595
2022-09-14,"2 - 1066",36,40,36,0,4,1
2022-09-14,"82 - 1163",104,178,104,0,74,1
2022-09-15,"40 - 1320",105,105,105,0,0,1
2022-09-15,"40 - 1114",224,231,224,0,7,1
2022-09-15,"53 - 1103",185,186,185,0,1,1
2022-09-15,"2 - 1066",38,40,38,0,2,1
2022-09-15,"82 - 1163",106,178,106,0,72,1
2022-09-16,"40 - 1320",105,105,105,0,0,1
2022-09-16,"40 - 1114",225,231,225,0,6,1
2022-09-16,"53 - 1103",185,186,183,2,1,0.989189189189189
2022-09-16,"2 - 1066",39,40,39,0,1,1
2022-09-16,"82 - 1163",108,178,108,0,70,1
2022-09-17,"40 - 1320",105,105,105,0,0,1
2022-09-17,"40 - 1114",226,231,226,0,5,1
2022-09-17,"53 - 1103",185,186,183,2,1,0.989189189189189
2022-09-17,"2 - 1066",38,40,38,0,2,1
2022-09-17,"82 - 1163",107,178,107,0,71,1
2022-09-18,"40 - 1320",105,105,105,0,0,1
2022-09-18,"40 - 1114",227,231,227,0,4,1
2022-09-18,"53 - 1103",185,186,184,1,1,0.994594594594595
2022-09-18,"2 - 1066",39,40,39,0,1,1
2022-09-18,"82 - 1163",107,178,107,0,71,1
2022-09-19,"40 - 1320",105,105,105,0,0,1
2022-09-19,"40 - 1114",229,231,229,0,2,1
2022-09-19,"53 - 1103",185,186,184,1,1,0.994594594594595
2022-09-19,"2 - 1066",39,40,39,0,1,1
2022-09-19,"82 - 1163",107,178,107,0,71,1
2022-09-20,"40 - 1320",105,105,105,0,0,1
2022-09-20,"40 - 1114",229,231,228,1,2,0.995633187772926
2022-09-20,"53 - 1103",184,186,184,0,2,1
2022-09-20,"2 - 1066",40,40,40,0,0,1
2022-09-20,"82 - 1163",108,178,107,1,70,0.990740740740741
2022-09-21,"40 - 1320",105,105,105,0,0,1
2022-09-21,"40 - 1114",230,231,230,0,1,1
2022-09-21,"53 - 1103",184,186,183,1,2,0.994565217391304
2022-09-21,"2 - 1066",40,40,40,0,0,1
2022-09-21,"82 - 1163",120,178,111,9,58,0.925
2022-09-22,"40 - 1320",105,105,105,0,0,1
2022-09-22,"40 - 1114",230,231,230,0,1,1
2022-09-22,"53 - 1103",185,186,185,0,1,1
2022-09-22,"2 - 1066",42,40,42,0,-2,1
2022-09-22,"82 - 1163",118,178,118,0,60,1
2022-09-23,"40 - 1320",105,105,104,1,0,0.99047619047619
2022-09-23,"40 - 1114",231,231,230,1,0,0.995670995670996
2022-09-23,"53 - 1103",186,186,186,0,0,1
2022-09-23,"2 - 1066",42,40,42,0,-2,1
2022-09-23,"82 - 1163",119,178,119,0,59,1
2022-09-24,"40 - 1320",105,105,104,1,0,0.99047619047619
2022-09-24,"40 - 1114",230,231,229,1,1,0.995652173913044
2022-09-24,"53 - 1103",185,186,185,0,1,1
2022-09-24,"2 - 1066",42,40,42,0,-2,1
2022-09-24,"82 - 1163",118,148,118,0,30,1
2022-09-25,"40 - 1320",105,105,104,1,0,0.99047619047619
2022-09-25,"40 - 1114",230,231,229,1,1,0.995652173913044
2022-09-25,"53 - 1103",183,186,183,0,3,1
2022-09-25,"2 - 1066",42,40,42,0,-2,1
2022-09-25,"82 - 1163",117,148,117,0,31,1
2022-09-26,"40 - 1320",105,105,104,1,0,0.99047619047619
2022-09-26,"40 - 1114",230,231,230,0,1,1
2022-09-26,"53 - 1103",184,186,184,0,2,1
2022-09-26,"2 - 1066",42,40,42,0,-2,1
2022-09-26,"82 - 1163",116,148,116,0,32,1
2022-09-27,"40 - 1320",105,105,104,1,0,0.99047619047619
2022-09-27,"40 - 1114",230,231,230,0,1,1
2022-09-27,"53 - 1103",181,186,181,0,5,1
2022-09-27,"2 - 1066",43,40,43,0,-3,1
2022-09-27,"82 - 1163",118,148,118,0,30,1
2022-09-28,"40 - 1320",105,105,104,1,0,0.99047619047619
2022-09-28,"40 - 1114",230,231,230,0,1,1
2022-09-28,"53 - 1103",185,186,184,1,1,0.994594594594595
2022-09-28,"2 - 1066",45,40,45,0,-5,1
2022-09-28,"82 - 1163",119,178,119,0,59,1
2022-09-29,"40 - 1320",105,105,104,1,0,0.99047619047619
2022-09-29,"40 - 1114",231,231,231,0,0,1
2022-09-29,"53 - 1103",185,186,184,1,1,0.994594594594595
2022-09-29,"2 - 1066",45,40,45,0,-5,1
2022-09-29,"82 - 1163",119,178,119,0,59,1
2022-09-30,"40 - 1320",105,105,104,1,0,0.99047619047619
2022-09-30,"40 - 1114",230,231,230,0,1,1
2022-09-30,"53 - 1103",186,186,185,1,0,0.994623655913978
2022-09-30,"2 - 1066",45,40,45,0,-5,1
2022-09-30,"82 - 1163",120,178,120,0,58,1
2022-10-01,"40 - 1320",103,105,103,0,2,1
2022-10-01,"40 - 1114",228,231,228,0,3,1
2022-10-01,"53 - 1103",186,186,185,1,0,0.994623655913978
2022-10-01,"2 - 1066",44,40,44,0,-4,1
2022-10-01,"82 - 1163",120,178,120,0,58,1
2022-10-02,"40 - 1320",104,105,104,0,1,1
2022-10-02,"40 - 1114",226,231,226,0,5,1
2022-10-02,"53 - 1103",186,186,183,3,0,0.983870967741935
2022-10-02,"2 - 1066",44,40,44,0,-4,1
2022-10-02,"82 - 1163",118,178,118,0,60,1
2022-10-03,"40 - 1320",104,105,104,0,1,1
2022-10-03,"40 - 1114",226,231,226,0,5,1
2022-10-03,"53 - 1103",185,186,185,0,1,1
2022-10-03,"2 - 1066",43,40,43,0,-3,1
2022-10-03,"82 - 1163",116,178,116,0,62,1
2022-10-04,"40 - 1320",104,105,104,0,1,1
2022-10-04,"40 - 1114",228,231,228,0,3,1
2022-10-04,"53 - 1103",185,186,183,2,1,0.989189189189189
2022-10-04,"2 - 1066",44,40,44,0,-4,1
2022-10-04,"82 - 1163",114,178,114,0,64,1
2022-10-05,"40 - 1320",104,105,104,0,1,1
2022-10-05,"40 - 1114",224,231,224,0,7,1
2022-10-05,"53 - 1103",183,186,182,1,3,0.994535519125683
2022-10-05,"2 - 1066",46,40,45,1,-6,0.978260869565217
2022-10-05,"82 - 1163",116,178,115,1,62,0.991379310344828
2022-10-06,"40 - 1320",104,105,104,0,1,1
2022-10-06,"40 - 1114",224,231,223,1,7,0.995535714285714
2022-10-06,"53 - 1103",182,186,182,0,4,1
2022-10-06,"2 - 1066",46,40,46,0,-6,1
2022-10-06,"82 - 1163",114,178,114,0,64,1
2022-10-07,"40 - 1320",104,105,104,0,1,1
2022-10-07,"40 - 1114",223,231,223,0,8,1
2022-10-07,"53 - 1103",185,186,185,0,1,1
2022-10-07,"2 - 1066",46,40,46,0,-6,1
2022-10-07,"82 - 1163",118,178,118,0,60,1
2022-10-08,"40 - 1320",104,105,104,0,1,1
2022-10-08,"40 - 1114",221,231,221,0,10,1
2022-10-08,"53 - 1103",185,186,185,0,1,1
2022-10-08,"2 - 1066",46,40,46,0,-6,1
2022-10-08,"82 - 1163",119,178,119,0,59,1
2022-10-09,"40 - 1320",104,105,104,0,1,1
2022-10-09,"40 - 1114",221,231,221,0,10,1
2022-10-09,"53 - 1103",184,186,184,0,2,1
2022-10-09,"2 - 1066",46,40,46,0,-6,1
2022-10-09,"82 - 1163",117,178,116,1,61,0.991452991452991
2022-10-10,"40 - 1320",104,105,104,0,1,1
2022-10-10,"40 - 1114",221,231,221,0,10,1
2022-10-10,"53 - 1103",183,186,183,0,3,1
2022-10-10,"2 - 1066",46,40,46,0,-6,1
2022-10-10,"82 - 1163",116,178,116,0,62,1
2022-10-11,"40 - 1320",104,105,103,1,1,0.990384615384615
2022-10-11,"40 - 1114",221,231,219,2,10,0.990950226244344
2022-10-11,"53 - 1103",186,186,184,2,0,0.989247311827957
2022-10-11,"2 - 1066",46,40,46,0,-6,1
2022-10-11,"82 - 1163",112,148,112,0,36,1
2022-10-12,"40 - 1320",105,105,104,1,0,0.99047619047619
2022-10-12,"40 - 1114",221,231,220,1,10,0.995475113122172
2022-10-12,"53 - 1103",186,186,185,1,0,0.994623655913978
2022-10-12,"2 - 1066",46,40,46,0,-6,1
2022-10-12,"82 - 1163",114,148,114,0,34,1
2022-10-13,"40 - 1320",103,105,102,1,2,0.990291262135922
2022-10-13,"40 - 1114",221,231,218,3,10,0.986425339366516
2022-10-13,"53 - 1103",186,186,186,0,0,1
2022-10-13,"2 - 1066",47,40,47,0,-7,1
2022-10-13,"82 - 1163",117,148,117,0,31,1
2022-10-14,"40 - 1320",103,105,103,0,2,1
2022-10-14,"40 - 1114",219,231,219,0,12,1
2022-10-14,"53 - 1103",185,186,185,0,1,1
2022-10-14,"2 - 1066",47,40,47,0,-7,1
2022-10-14,"82 - 1163",119,148,119,0,29,1
2022-10-15,"40 - 1320",103,105,103,0,2,1
2022-10-15,"40 - 1114",220,231,220,0,11,1
2022-10-15,"53 - 1103",185,186,185,0,1,1
2022-10-15,"2 - 1066",47,40,47,0,-7,1
2022-10-15,"82 - 1163",120,148,120,0,28,1
2022-10-16,"40 - 1320",103,105,103,0,2,1
2022-10-16,"40 - 1114",219,231,219,0,12,1
2022-10-16,"53 - 1103",185,186,185,0,1,1
2022-10-16,"2 - 1066",47,40,47,0,-7,1
2022-10-16,"82 - 1163",120,148,120,0,28,1
2022-10-17,"40 - 1320",104,105,104,0,1,1
2022-10-17,"40 - 1114",219,231,219,0,12,1
2022-10-17,"53 - 1103",184,186,183,1,2,0.994565217391304
2022-10-17,"2 - 1066",46,40,46,0,-6,1
2022-10-17,"82 - 1163",119,148,119,0,29,1
2022-10-18,"40 - 1320",104,105,104,0,1,1
2022-10-18,"40 - 1114",219,231,219,0,12,1
2022-10-18,"53 - 1103",185,186,185,0,1,1
2022-10-18,"2 - 1066",46,40,46,0,-6,1
2022-10-18,"82 - 1163",119,148,119,0,29,1
2022-10-19,"40 - 1320",104,105,104,0,1,1
2022-10-19,"40 - 1114",219,231,219,0,12,1
2022-10-19,"53 - 1103",185,186,184,1,1,0.994594594594595
2022-10-19,"2 - 1066",46,40,46,0,-6,1
2022-10-19,"82 - 1163",120,178,120,0,58,1
2022-10-20,"40 - 1320",103,105,103,0,2,1
2022-10-20,"40 - 1114",219,231,219,0,12,1
2022-10-20,"53 - 1103",184,186,183,1,2,0.994565217391304
2022-10-20,"2 - 1066",46,40,46,0,-6,1
2022-10-20,"82 - 1163",120,178,120,0,58,1
2022-10-21,"40 - 1320",104,105,104,0,1,1
2022-10-21,"40 - 1114",221,231,220,1,10,0.995475113122172
2022-10-21,"53 - 1103",185,186,184,1,1,0.994594594594595
2022-10-21,"2 - 1066",44,40,44,0,-4,1
2022-10-21,"82 - 1163",118,148,118,0,30,1
2022-10-22,"40 - 1320",105,105,105,0,0,1
2022-10-22,"40 - 1114",222,231,222,0,9,1
2022-10-22,"53 - 1103",186,186,185,1,0,0.994623655913978
2022-10-22,"2 - 1066",46,40,46,0,-6,1
2022-10-22,"82 - 1163",119,148,118,1,29,0.991596638655462
2022-10-23,"40 - 1320",105,105,105,0,0,1
2022-10-23,"40 - 1114",222,231,222,0,9,1
2022-10-23,"53 - 1103",186,186,185,1,0,0.994623655913978
2022-10-23,"2 - 1066",47,40,47,0,-7,1
2022-10-23,"82 - 1163",118,148,118,0,30,1
2022-10-24,"40 - 1320",105,105,105,0,0,1
2022-10-24,"40 - 1114",218,231,218,0,13,1
2022-10-24,"53 - 1103",186,186,185,1,0,0.994623655913978
2022-10-24,"2 - 1066",47,40,47,0,-7,1
2022-10-24,"82 - 1163",114,148,114,0,34,1
2022-10-25,"40 - 1320",104,105,104,0,1,1
2022-10-25,"40 - 1114",219,230,219,0,11,1
2022-10-25,"53 - 1103",186,186,185,1,0,0.994623655913978
2022-10-25,"2 - 1066",47,40,47,0,-7,1
2022-10-25,"82 - 1163",112,148,112,0,36,1
2022-10-26,"40 - 1320",104,105,103,1,1,0.990384615384615
2022-10-26,"40 - 1114",222,230,222,0,8,1
2022-10-26,"53 - 1103",184,186,183,1,2,0.994565217391304
2022-10-26,"2 - 1066",48,40,48,0,-8,1
2022-10-26,"82 - 1163",115,148,114,1,33,0.991304347826087
2022-10-27,"40 - 1320",104,105,103,1,1,0.990384615384615
2022-10-27,"40 - 1114",224,231,224,0,7,1
2022-10-27,"53 - 1103",184,186,181,3,2,0.983695652173913
2022-10-27,"2 - 1066",48,40,48,0,-8,1
2022-10-27,"82 - 1163",115,148,115,0,33,1
2022-10-28,"40 - 1320",104,105,104,0,1,1
2022-10-28,"40 - 1114",224,231,222,2,7,0.991071428571429
2022-10-28,"53 - 1103",184,186,183,1,2,0.994565217391304
2022-10-28,"2 - 1066",48,40,48,0,-8,1
2022-10-28,"82 - 1163",115,148,115,0,33,1
2022-10-29,"40 - 1320",104,105,104,0,1,1
2022-10-29,"40 - 1114",224,231,224,0,7,1
2022-10-29,"53 - 1103",184,186,183,1,2,0.994565217391304
2022-10-29,"2 - 1066",47,40,47,0,-7,1
2022-10-29,"82 - 1163",114,148,114,0,34,1
2022-10-30,"40 - 1320",105,105,105,0,0,1
2022-10-30,"40 - 1114",224,231,224,0,7,1
2022-10-30,"53 - 1103",185,186,184,1,1,0.994594594594595
2022-10-30,"2 - 1066",47,40,47,0,-7,1
2022-10-30,"82 - 1163",115,148,115,0,33,1
2022-10-31,"40 - 1320",105,105,105,0,0,1
2022-10-31,"40 - 1114",224,231,223,1,7,0.995535714285714
2022-10-31,"53 - 1103",184,186,182,2,2,0.989130434782609
2022-10-31,"2 - 1066",48,40,48,0,-8,1
2022-10-31,"82 - 1163",115,148,115,0,33,1
2022-11-01,"40 - 1320",104,105,104,0,1,1
2022-11-01,"40 - 1114",222,231,222,0,9,1
2022-11-01,"53 - 1103",185,186,184,1,1,0.994594594594595
2022-11-01,"2 - 1066",48,40,48,0,-8,1
2022-11-01,"82 - 1163",118,148,116,2,30,0.983050847457627
2022-11-02,"40 - 1320",104,105,104,0,1,1
2022-11-02,"40 - 1114",224,231,224,0,7,1
2022-11-02,"53 - 1103",186,186,186,0,0,1
2022-11-02,"2 - 1066",46,40,46,0,-6,1
2022-11-02,"82 - 1163",120,148,120,0,28,1
2022-11-03,"40 - 1320",104,105,104,0,1,1
2022-11-03,"40 - 1114",222,231,221,1,9,0.995495495495496
2022-11-03,"53 - 1103",185,186,185,0,1,1
2022-11-03,"2 - 1066",47,40,47,0,-7,1
2022-11-03,"82 - 1163",126,148,126,0,22,1
2022-11-04,"40 - 1320",105,105,105,0,0,1
2022-11-04,"40 - 1114",219,231,219,0,12,1
2022-11-04,"53 - 1103",185,186,185,0,1,1
2022-11-04,"2 - 1066",46,40,46,0,-6,1
2022-11-04,"82 - 1163",126,148,126,0,22,1
2022-11-05,"40 - 1320",105,105,105,0,0,1
2022-11-05,"40 - 1114",219,231,219,0,12,1
2022-11-05,"53 - 1103",186,186,185,1,0,0.994623655913978
2022-11-05,"2 - 1066",46,40,46,0,-6,1
2022-11-05,"82 - 1163",124,148,124,0,24,1
2022-11-06,"40 - 1320",104,105,104,0,1,1
2022-11-06,"40 - 1114",219,231,218,1,12,0.995433789954338
2022-11-06,"53 - 1103",185,186,182,3,1,0.983783783783784
2022-11-06,"2 - 1066",46,40,46,0,-6,1
2022-11-06,"82 - 1163",124,148,124,0,24,1
2022-11-07,"40 - 1320",105,105,105,0,0,1
2022-11-07,"40 - 1114",219,231,219,0,12,1
2022-11-07,"53 - 1103",185,186,183,2,1,0.989189189189189
2022-11-07,"2 - 1066",47,40,47,0,-7,1
2022-11-07,"82 - 1163",124,148,124,0,24,1
2022-11-08,"40 - 1320",105,105,105,0,0,1
2022-11-08,"40 - 1114",222,231,222,0,9,1
2022-11-08,"53 - 1103",185,186,183,2,1,0.989189189189189
2022-11-08,"2 - 1066",47,40,47,0,-7,1
2022-11-08,"82 - 1163",123,148,123,0,25,1
2022-11-09,"40 - 1320",105,105,105,0,0,1
2022-11-09,"40 - 1114",220,231,220,0,11,1
2022-11-09,"53 - 1103",186,186,185,1,0,0.994623655913978
2022-11-09,"2 - 1066",47,40,47,0,-7,1
2022-11-09,"82 - 1163",125,178,125,0,53,1
2022-11-10,"40 - 1320",104,105,104,0,1,1
2022-11-10,"40 - 1114",223,231,222,1,8,0.995515695067265
2022-11-10,"53 - 1103",185,186,185,0,1,1
2022-11-10,"2 - 1066",47,40,47,0,-7,1
2022-11-10,"82 - 1163",126,178,126,0,52,1
2022-11-11,"40 - 1320",104,105,104,0,1,1
2022-11-11,"40 - 1114",225,231,223,2,6,0.991111111111111
2022-11-11,"53 - 1103",186,186,186,0,0,1
2022-11-11,"2 - 1066",47,40,47,0,-7,1
2022-11-11,"82 - 1163",125,178,125,0,53,1
2022-11-12,"40 - 1320",104,105,104,0,1,1
2022-11-12,"40 - 1114",225,231,223,2,6,0.991111111111111
2022-11-12,"53 - 1103",185,186,185,0,1,1
2022-11-12,"2 - 1066",47,40,47,0,-7,1
2022-11-12,"82 - 1163",126,178,126,0,52,1
2022-11-13,"40 - 1320",105,105,104,1,0,0.99047619047619
2022-11-13,"40 - 1114",222,231,222,0,9,1
2022-11-13,"53 - 1103",185,186,183,2,1,0.989189189189189
2022-11-13,"2 - 1066",47,40,47,0,-7,1
2022-11-13,"82 - 1163",123,178,123,0,55,1
2022-11-14,"40 - 1320",105,105,105,0,0,1
2022-11-14,"40 - 1114",223,231,223,0,8,1
2022-11-14,"53 - 1103",185,186,185,0,1,1
2022-11-14,"2 - 1066",47,40,47,0,-7,1
2022-11-14,"82 - 1163",119,178,119,0,59,1
2022-11-15,"40 - 1320",105,105,105,0,0,1
2022-11-15,"40 - 1114",223,231,223,0,8,1
2022-11-15,"53 - 1103",185,186,184,1,1,0.994594594594595
2022-11-15,"2 - 1066",47,40,47,0,-7,1
2022-11-15,"82 - 1163",117,178,117,0,61,1
2022-11-16,"40 - 1320",105,105,105,0,0,1
2022-11-16,"40 - 1114",225,231,223,2,6,0.991111111111111
2022-11-16,"53 - 1103",185,186,184,1,1,0.994594594594595
2022-11-16,"2 - 1066",47,40,47,0,-7,1
2022-11-16,"82 - 1163",118,178,118,0,60,1
2022-11-17,"40 - 1320",105,105,105,0,0,1
2022-11-17,"40 - 1114",225,231,224,1,6,0.995555555555556
2022-11-17,"53 - 1103",186,186,185,1,0,0.994623655913978
2022-11-17,"2 - 1066",47,40,47,0,-7,1
2022-11-17,"82 - 1163",117,178,116,1,61,0.991452991452991
2022-11-18,"40 - 1320",105,105,105,0,0,1
2022-11-18,"40 - 1114",224,231,224,0,7,1
2022-11-18,"53 - 1103",185,186,184,1,1,0.994594594594595
2022-11-18,"2 - 1066",47,40,47,0,-7,1
2022-11-18,"82 - 1163",116,178,116,0,62,1
2022-11-19,"40 - 1320",105,105,105,0,0,1
2022-11-19,"40 - 1114",226,231,225,1,5,0.995575221238938
2022-11-19,"53 - 1103",184,186,183,1,2,0.994565217391304
2022-11-19,"2 - 1066",47,40,47,0,-7,1
2022-11-19,"82 - 1163",114,178,114,0,64,1
2022-11-20,"40 - 1320",105,105,105,0,0,1
2022-11-20,"40 - 1114",226,231,226,0,5,1
2022-11-20,"53 - 1103",183,186,183,0,3,1
2022-11-20,"2 - 1066",47,40,47,0,-7,1
2022-11-20,"82 - 1163",115,178,114,1,63,0.991304347826087
2022-11-21,"40 - 1320",109,118,109,0,9,1
2022-11-21,"40 - 1114",224,231,224,0,7,1
2022-11-21,"53 - 1103",183,186,183,0,3,1
2022-11-21,"2 - 1066",47,40,47,0,-7,1
2022-11-21,"82 - 1163",118,178,118,0,60,1
2022-11-22,"40 - 1320",110,118,110,0,8,1
2022-11-22,"40 - 1114",223,231,223,0,8,1
2022-11-22,"53 - 1103",182,186,182,0,4,1
2022-11-22,"2 - 1066",46,40,46,0,-6,1
2022-11-22,"82 - 1163",118,178,118,0,60,1
2022-11-23,"40 - 1320",114,118,114,0,4,1
2022-11-23,"40 - 1114",223,231,221,2,8,0.991031390134529
2022-11-23,"53 - 1103",184,186,183,1,2,0.994565217391304
2022-11-23,"2 - 1066",46,40,46,0,-6,1
2022-11-23,"82 - 1163",120,178,120,0,58,1
2022-11-24,"40 - 1320",118,118,118,0,0,1
2022-11-24,"40 - 1114",224,231,223,1,7,0.995535714285714
2022-11-24,"53 - 1103",182,186,181,1,4,0.994505494505495
2022-11-24,"2 - 1066",46,40,46,0,-6,1
2022-11-24,"82 - 1163",118,178,118,0,60,1
2022-11-25,"40 - 1320",121,130,121,0,9,1
2022-11-25,"40 - 1114",225,231,225,0,6,1
2022-11-25,"53 - 1103",184,186,182,2,2,0.989130434782609
2022-11-25,"2 - 1066",46,40,46,0,-6,1
2022-11-25,"82 - 1163",117,178,117,0,61,1
2022-11-26,"40 - 1320",121,130,121,0,9,1
2022-11-26,"40 - 1114",226,231,225,1,5,0.995575221238938
2022-11-26,"53 - 1103",185,186,182,3,1,0.983783783783784
2022-11-26,"2 - 1066",46,40,46,0,-6,1
2022-11-26,"82 - 1163",115,178,115,0,63,1
2022-11-27,"40 - 1320",122,130,122,0,8,1
2022-11-27,"40 - 1114",225,231,223,2,6,0.991111111111111
2022-11-27,"53 - 1103",184,186,182,2,2,0.989130434782609
2022-11-27,"2 - 1066",46,40,46,0,-6,1
2022-11-27,"82 - 1163",111,178,110,1,67,0.990990990990991
2022-11-28,"40 - 1320",124,130,124,0,6,1
2022-11-28,"40 - 1114",224,229,224,0,5,1
2022-11-28,"53 - 1103",185,186,184,1,1,0.994594594594595
2022-11-28,"2 - 1066",46,40,46,0,-6,1
2022-11-28,"82 - 1163",111,178,111,0,67,1
2022-11-29,"40 - 1320",127,130,127,0,3,1
2022-11-29,"40 - 1114",226,229,226,0,3,1
2022-11-29,"53 - 1103",185,186,184,1,1,0.994594594594595
2022-11-29,"2 - 1066",46,40,46,0,-6,1
2022-11-29,"82 - 1163",112,178,112,0,66,1
2022-11-30,"40 - 1320",130,130,130,0,0,1
2022-11-30,"40 - 1114",226,229,225,1,3,0.995575221238938
2022-11-30,"53 - 1103",185,186,183,2,1,0.989189189189189
2022-11-30,"2 - 1066",45,40,45,0,-5,1
2022-11-30,"82 - 1163",109,148,109,0,39,1
2022-12-01,"40 - 1320",129,155,129,0,26,1
2022-12-01,"40 - 1114",227,229,221,6,2,0.973568281938326
2022-12-01,"53 - 1103",183,186,183,0,3,1
2022-12-01,"2 - 1066",43,40,43,0,-3,1
2022-12-01,"82 - 1163",109,178,109,0,69,1
2022-12-02,"40 - 1320",132,156,131,1,24,0.992424242424242
2022-12-02,"40 - 1114",223,229,222,1,6,0.995515695067265
2022-12-02,"53 - 1103",184,186,182,2,2,0.989130434782609
2022-12-02,"2 - 1066",43,40,43,0,-3,1
2022-12-02,"82 - 1163",111,178,111,0,67,1
2022-12-03,"40 - 1320",135,156,135,0,21,1
2022-12-03,"40 - 1114",218,229,217,1,11,0.995412844036697
2022-12-03,"53 - 1103",182,186,181,1,4,0.994505494505495
2022-12-03,"2 - 1066",42,40,42,0,-2,1
2022-12-03,"82 - 1163",112,178,112,0,66,1
2022-12-04,"40 - 1320",137,156,137,0,19,1
2022-12-04,"40 - 1114",221,229,219,2,8,0.990950226244344
2022-12-04,"53 - 1103",185,186,181,4,1,0.978378378378378
2022-12-04,"2 - 1066",42,40,42,0,-2,1
2022-12-04,"82 - 1163",110,178,110,0,68,1
2022-12-05,"40 - 1320",136,156,136,0,20,1
2022-12-05,"40 - 1114",218,229,218,0,11,1
2022-12-05,"53 - 1103",185,186,183,2,1,0.989189189189189
2022-12-05,"2 - 1066",41,40,41,0,-1,1
2022-12-05,"82 - 1163",113,178,113,0,65,1
2022-12-06,"40 - 1320",141,156,141,0,15,1
2022-12-06,"40 - 1114",221,229,221,0,8,1
2022-12-06,"53 - 1103",185,186,184,1,1,0.994594594594595
2022-12-06,"2 - 1066",41,40,41,0,-1,1
2022-12-06,"82 - 1163",114,178,114,0,64,1
2022-12-07,"40 - 1320",146,156,146,0,10,1
2022-12-07,"40 - 1114",222,229,222,0,7,1
2022-12-07,"53 - 1103",186,186,185,1,0,0.994623655913978
2022-12-07,"2 - 1066",41,40,41,0,-1,1
2022-12-07,"82 - 1163",112,178,112,0,66,1
2022-12-08,"40 - 1320",150,181,150,0,31,1
2022-12-08,"40 - 1114",226,229,225,1,3,0.995575221238938
2022-12-08,"53 - 1103",185,186,185,0,1,1
2022-12-08,"2 - 1066",40,40,40,0,0,1
2022-12-08,"82 - 1163",119,178,119,0,59,1
2022-12-09,"40 - 1320",152,181,152,0,29,1
2022-12-09,"40 - 1114",227,229,226,1,2,0.995594713656388
2022-12-09,"53 - 1103",185,186,185,0,1,1
2022-12-09,"2 - 1066",39,40,39,0,1,1
2022-12-09,"82 - 1163",128,148,124,4,20,0.96875
2022-12-10,"40 - 1320",154,181,154,0,27,1
2022-12-10,"40 - 1114",227,229,225,2,2,0.991189427312775
2022-12-10,"53 - 1103",186,186,186,0,0,1
2022-12-10,"2 - 1066",39,40,39,0,1,1
2022-12-10,"82 - 1163",135,148,130,5,13,0.962962962962963
2022-12-11,"40 - 1320",157,181,157,0,24,1
2022-12-11,"40 - 1114",224,229,224,0,5,1
2022-12-11,"53 - 1103",185,186,185,0,1,1
2022-12-11,"2 - 1066",39,40,39,0,1,1
2022-12-11,"82 - 1163",131,148,131,0,17,1
2022-12-12,"40 - 1320",159,181,159,0,22,1
2022-12-12,"40 - 1114",225,229,225,0,4,1
2022-12-12,"53 - 1103",186,186,186,0,0,1
2022-12-12,"2 - 1066",39,40,38,1,1,0.974358974358974
2022-12-12,"82 - 1163",131,148,131,0,17,1
2022-12-13,"40 - 1320",164,181,163,1,17,0.99390243902439
2022-12-13,"40 - 1114",225,229,225,0,4,1
2022-12-13,"53 - 1103",186,186,186,0,0,1
2022-12-13,"2 - 1066",33,58,33,0,25,1
2022-12-13,"82 - 1163",133,148,133,0,15,1
2022-12-14,"40 - 1320",171,186,171,0,15,1
2022-12-14,"40 - 1114",226,227,226,0,1,1
2022-12-14,"53 - 1103",186,186,186,0,0,1
2022-12-14,"2 - 1066",32,58,32,0,26,1
2022-12-14,"82 - 1163",133,148,131,2,15,0.984962406015038
2022-12-15,"40 - 1320",171,206,171,0,35,1
2022-12-15,"40 - 1114",225,227,225,0,2,1
2022-12-15,"53 - 1103",185,186,185,0,1,1
2022-12-15,"2 - 1066",32,58,32,0,26,1
2022-12-15,"82 - 1163",127,148,127,0,21,1
2022-12-16,"40 - 1320",171,206,171,0,35,1
2022-12-16,"40 - 1114",224,229,223,1,5,0.995535714285714
2022-12-16,"53 - 1103",184,186,184,0,2,1
2022-12-16,"2 - 1066",33,58,33,0,25,1
2022-12-16,"82 - 1163",121,148,121,0,27,1
2022-12-17,"40 - 1320",173,206,172,1,33,0.994219653179191
2022-12-17,"40 - 1114",224,229,224,0,5,1
2022-12-17,"53 - 1103",186,186,183,3,0,0.983870967741935
2022-12-17,"2 - 1066",34,58,34,0,24,1
2022-12-17,"82 - 1163",124,148,124,0,24,1
2022-12-18,"40 - 1320",173,206,173,0,33,1
2022-12-18,"40 - 1114",224,229,222,2,5,0.991071428571429
2022-12-18,"53 - 1103",186,186,183,3,0,0.983870967741935
2022-12-18,"2 - 1066",35,58,34,1,23,0.971428571428571
2022-12-18,"82 - 1163",124,148,124,0,24,1
2022-12-19,"40 - 1320",174,206,174,0,32,1
2022-12-19,"40 - 1114",220,229,220,0,9,1
2022-12-19,"53 - 1103",185,186,185,0,1,1
2022-12-19,"2 - 1066",35,58,35,0,23,1
2022-12-19,"82 - 1163",125,148,125,0,23,1
2022-12-20,"40 - 1320",175,206,175,0,31,1
2022-12-20,"40 - 1114",218,229,218,0,11,1
2022-12-20,"53 - 1103",186,186,185,1,0,0.994623655913978
2022-12-20,"2 - 1066",38,58,37,1,20,0.973684210526316
2022-12-20,"82 - 1163",128,148,128,0,20,1
2022-12-21,"40 - 1320",178,206,178,0,28,1
2022-12-21,"40 - 1114",221,229,219,2,8,0.990950226244344
2022-12-21,"53 - 1103",186,186,186,0,0,1
2022-12-21,"2 - 1066",38,58,37,1,20,0.973684210526316
2022-12-21,"82 - 1163",129,148,128,1,19,0.992248062015504
2022-12-22,"40 - 1320",182,206,182,0,24,1
2022-12-22,"40 - 1114",216,229,216,0,13,1
2022-12-22,"53 - 1103",186,186,185,1,0,0.994623655913978
2022-12-22,"2 - 1066",39,58,39,0,19,1
2022-12-22,"82 - 1163",133,148,133,0,15,1
2022-12-23,"40 - 1320",187,206,187,0,19,1
2022-12-23,"40 - 1114",215,229,215,0,14,1
2022-12-23,"53 - 1103",186,186,186,0,0,1
2022-12-23,"2 - 1066",39,58,39,0,19,1
2022-12-23,"82 - 1163",140,148,137,3,8,0.978571428571429
2022-12-24,"40 - 1320",190,206,190,0,16,1
2022-12-24,"40 - 1114",218,229,216,2,11,0.990825688073395
2022-12-24,"53 - 1103",186,186,186,0,0,1
2022-12-24,"2 - 1066",39,58,39,0,19,1
2022-12-24,"82 - 1163",135,148,135,0,13,1
2022-12-25,"40 - 1320",194,206,194,0,12,1
2022-12-25,"40 - 1114",218,228,217,1,10,0.995412844036697
2022-12-25,"53 - 1103",186,186,186,0,0,1
2022-12-25,"2 - 1066",39,58,39,0,19,1
2022-12-25,"82 - 1163",133,148,133,0,15,1
2022-12-26,"40 - 1320",196,206,196,0,10,1
2022-12-26,"40 - 1114",218,228,218,0,10,1
2022-12-26,"53 - 1103",186,186,186,0,0,1
2022-12-26,"2 - 1066",40,58,39,1,18,0.975
2022-12-26,"82 - 1163",136,148,136,0,12,1
2022-12-27,"40 - 1320",199,206,199,0,7,1
2022-12-27,"40 - 1114",220,228,219,1,8,0.995454545454545
2022-12-27,"53 - 1103",182,186,182,0,4,1
2022-12-27,"2 - 1066",41,58,39,2,17,0.951219512195122
2022-12-27,"82 - 1163",142,148,142,0,6,1
2022-12-28,"40 - 1320",201,206,201,0,5,1
2022-12-28,"40 - 1114",219,228,219,0,9,1
2022-12-28,"53 - 1103",186,186,181,5,0,0.973118279569892
2022-12-28,"2 - 1066",42,58,40,2,16,0.952380952380952
2022-12-28,"82 - 1163",144,148,144,0,4,1
2022-12-29,"40 - 1320",204,206,204,0,2,1
2022-12-29,"40 - 1114",221,228,221,0,7,1
2022-12-29,"53 - 1103",186,186,183,3,0,0.983870967741935
2022-12-29,"2 - 1066",43,58,40,3,15,0.930232558139535
2022-12-29,"82 - 1163",143,148,143,0,5,1
2022-12-30,"40 - 1320",205,206,205,0,1,1
2022-12-30,"40 - 1114",222,231,221,1,9,0.995495495495496
2022-12-30,"53 - 1103",186,186,186,0,0,1
2022-12-30,"2 - 1066",43,58,42,1,15,0.976744186046512
2022-12-30,"82 - 1163",143,148,142,1,5,0.993006993006993
2022-12-31,"40 - 1320",205,206,205,0,1,1
2022-12-31,"40 - 1114",224,231,224,0,7,1
2022-12-31,"53 - 1103",186,186,186,0,0,1
2022-12-31,"2 - 1066",43,58,43,0,15,1
2022-12-31,"82 - 1163",142,148,142,0,6,1
2023-01-01,"40 - 1320",204,206,204,0,2,1
2023-01-01,"40 - 1114",224,231,224,0,7,1
2023-01-01,"53 - 1103",186,186,186,0,0,1
2023-01-01,"2 - 1066",43,58,43,0,15,1
2023-01-01,"82 - 1163",141,148,141,0,7,1
2023-01-02,"40 - 1320",204,206,204,0,2,1
2023-01-02,"40 - 1114",225,231,225,0,6,1
2023-01-02,"53 - 1103",186,186,186,0,0,1
2023-01-02,"2 - 1066",42,58,42,0,16,1
2023-01-02,"82 - 1163",139,148,139,0,9,1
2023-01-03,"40 - 1320",205,206,205,0,1,1
2023-01-03,"40 - 1114",224,231,223,1,7,0.995535714285714
2023-01-03,"53 - 1103",185,186,184,1,1,0.994594594594595
2023-01-03,"2 - 1066",42,58,42,0,16,1
2023-01-03,"82 - 1163",139,148,138,1,9,0.992805755395683
2023-01-04,"40 - 1320",207,207,207,0,0,1
2023-01-04,"40 - 1114",221,231,221,0,10,1
2023-01-04,"53 - 1103",183,186,183,0,3,1
2023-01-04,"2 - 1066",44,58,43,1,14,0.977272727272727
2023-01-04,"82 - 1163",137,148,137,0,11,1
2023-01-05,"40 - 1320",207,207,207,0,0,1
2023-01-05,"40 - 1114",222,231,222,0,9,1
2023-01-05,"53 - 1103",184,186,184,0,2,1
2023-01-05,"2 - 1066",44,58,44,0,14,1
2023-01-05,"82 - 1163",137,148,137,0,11,1
2023-01-06,"40 - 1320",207,207,207,0,0,1
2023-01-06,"40 - 1114",221,231,221,0,10,1
2023-01-06,"53 - 1103",184,186,183,1,2,0.994565217391304
2023-01-06,"2 - 1066",46,58,45,1,12,0.978260869565217
2023-01-06,"82 - 1163",131,148,129,2,17,0.984732824427481
2023-01-07,"40 - 1320",207,207,207,0,0,1
2023-01-07,"40 - 1114",221,231,221,0,10,1
2023-01-07,"53 - 1103",184,186,183,1,2,0.994565217391304
2023-01-07,"2 - 1066",47,58,47,0,11,1
2023-01-07,"82 - 1163",130,148,126,4,18,0.969230769230769
2023-01-08,"40 - 1320",207,207,207,0,0,1
2023-01-08,"40 - 1114",221,231,220,1,10,0.995475113122172
2023-01-08,"53 - 1103",184,186,182,2,2,0.989130434782609
2023-01-08,"2 - 1066",47,58,47,0,11,1
2023-01-08,"82 - 1163",125,148,125,0,23,1
2023-01-09,"40 - 1320",207,207,207,0,0,1
2023-01-09,"40 - 1114",222,231,222,0,9,1
2023-01-09,"53 - 1103",184,186,182,2,2,0.989130434782609
2023-01-09,"2 - 1066",47,58,47,0,11,1
2023-01-09,"82 - 1163",128,148,128,0,20,1
2023-01-10,"40 - 1320",207,207,207,0,0,1
2023-01-10,"40 - 1114",221,231,221,0,10,1
2023-01-10,"53 - 1103",184,186,184,0,2,1
2023-01-10,"2 - 1066",46,58,46,0,12,1
2023-01-10,"82 - 1163",127,148,127,0,21,1
2023-01-11,"40 - 1320",207,207,207,0,0,1
2023-01-11,"40 - 1114",223,231,223,0,8,1
2023-01-11,"53 - 1103",185,186,185,0,1,1
2023-01-11,"2 - 1066",46,58,46,0,12,1
2023-01-11,"82 - 1163",126,148,126,0,22,1
2023-01-12,"40 - 1320",207,207,207,0,0,1
2023-01-12,"40 - 1114",222,231,221,1,9,0.995495495495496
2023-01-12,"53 - 1103",185,186,185,0,1,1
2023-01-12,"2 - 1066",46,58,46,0,12,1
2023-01-12,"82 - 1163",127,148,127,0,21,1
2023-01-13,"40 - 1320",207,207,207,0,0,1
2023-01-13,"40 - 1114",222,231,222,0,9,1
2023-01-13,"53 - 1103",185,186,184,1,1,0.994594594594595
2023-01-13,"2 - 1066",45,58,45,0,13,1
2023-01-13,"82 - 1163",131,148,131,0,17,1
2023-01-14,"40 - 1320",207,207,207,0,0,1
2023-01-14,"40 - 1114",223,231,223,0,8,1
2023-01-14,"53 - 1103",185,186,184,1,1,0.994594594594595
2023-01-14,"2 - 1066",45,58,45,0,13,1
2023-01-14,"82 - 1163",128,148,128,0,20,1
2023-01-15,"40 - 1320",207,207,207,0,0,1
2023-01-15,"40 - 1114",224,231,223,1,7,0.995535714285714
2023-01-15,"53 - 1103",186,186,186,0,0,1
2023-01-15,"2 - 1066",45,58,45,0,13,1
2023-01-15,"82 - 1163",124,148,123,1,24,0.991935483870968
2023-01-16,"40 - 1320",207,207,207,0,0,1
2023-01-16,"40 - 1114",220,231,220,0,11,1
2023-01-16,"53 - 1103",185,186,183,2,1,0.989189189189189
2023-01-16,"2 - 1066",45,58,45,0,13,1
2023-01-16,"82 - 1163",120,148,120,0,28,1
2023-01-17,"40 - 1320",207,207,207,0,0,1
2023-01-17,"40 - 1114",222,231,222,0,9,1
2023-01-17,"53 - 1103",186,186,183,3,0,0.983870967741935
2023-01-17,"2 - 1066",45,58,44,1,13,0.977777777777778
2023-01-17,"82 - 1163",121,148,121,0,27,1
2023-01-18,"40 - 1320",207,207,207,0,0,1
2023-01-18,"40 - 1114",222,231,222,0,9,1
2023-01-18,"53 - 1103",186,186,183,3,0,0.983870967741935
2023-01-18,"2 - 1066",44,58,44,0,14,1
2023-01-18,"82 - 1163",127,148,127,0,21,1
2023-01-19,"40 - 1320",206,207,206,0,1,1
2023-01-19,"40 - 1114",224,232,223,1,8,0.995535714285714
2023-01-19,"53 - 1103",186,186,184,2,0,0.989247311827957
2023-01-19,"2 - 1066",45,58,43,2,13,0.955555555555556
2023-01-19,"82 - 1163",123,148,123,0,25,1
2023-01-20,"40 - 1320",206,207,206,0,1,1
2023-01-20,"40 - 1114",223,232,222,1,9,0.995515695067265
2023-01-20,"53 - 1103",186,186,182,4,0,0.978494623655914
2023-01-20,"2 - 1066",45,58,43,2,13,0.955555555555556
2023-01-20,"82 - 1163",130,148,122,8,18,0.938461538461538
2023-01-21,"40 - 1320",207,207,206,1,0,0.995169082125604
2023-01-21,"40 - 1114",223,232,223,0,9,1
2023-01-21,"53 - 1103",186,186,182,4,0,0.978494623655914
2023-01-21,"2 - 1066",46,58,44,2,12,0.956521739130435
2023-01-21,"82 - 1163",122,148,122,0,26,1
2023-01-22,"40 - 1320",207,207,207,0,0,1
2023-01-22,"40 - 1114",223,232,223,0,9,1
2023-01-22,"53 - 1103",186,186,182,4,0,0.978494623655914
2023-01-22,"2 - 1066",46,58,44,2,12,0.956521739130435
2023-01-22,"82 - 1163",119,148,119,0,29,1
2023-01-23,"40 - 1320",206,207,206,0,1,1
2023-01-23,"40 - 1114",224,232,224,0,8,1
2023-01-23,"53 - 1103",186,186,183,3,0,0.983870967741935
2023-01-23,"2 - 1066",46,58,44,2,12,0.956521739130435
2023-01-23,"82 - 1163",116,148,116,0,32,1
2023-01-24,"40 - 1320",207,207,207,0,0,1
2023-01-24,"40 - 1114",224,232,224,0,8,1
2023-01-24,"53 - 1103",185,186,183,2,1,0.989189189189189
2023-01-24,"2 - 1066",46,58,44,2,12,0.956521739130435
2023-01-24,"82 - 1163",116,148,115,1,32,0.991379310344828
2023-01-25,"40 - 1320",207,207,207,0,0,1
2023-01-25,"40 - 1114",227,232,225,2,5,0.991189427312775
2023-01-25,"53 - 1103",185,186,184,1,1,0.994594594594595
2023-01-25,"2 - 1066",47,58,44,3,11,0.936170212765957
2023-01-25,"82 - 1163",116,148,116,0,32,1
2023-01-26,"40 - 1320",207,207,207,0,0,1
2023-01-26,"40 - 1114",227,232,226,1,5,0.995594713656388
2023-01-26,"53 - 1103",184,186,183,1,2,0.994565217391304
2023-01-26,"2 - 1066",47,58,46,1,11,0.978723404255319
2023-01-26,"82 - 1163",118,148,118,0,30,1
2023-01-27,"40 - 1320",207,207,207,0,0,1
2023-01-27,"40 - 1114",225,232,225,0,7,1
2023-01-27,"53 - 1103",184,186,183,1,2,0.994565217391304
2023-01-27,"2 - 1066",48,58,46,2,10,0.958333333333333
2023-01-27,"82 - 1163",114,148,114,0,34,1
2023-01-28,"40 - 1320",207,207,207,0,0,1
2023-01-28,"40 - 1114",225,232,225,0,7,1
2023-01-28,"53 - 1103",184,186,183,1,2,0.994565217391304
2023-01-28,"2 - 1066",49,58,46,3,9,0.938775510204082
2023-01-28,"82 - 1163",113,148,113,0,35,1
2023-01-29,"40 - 1320",207,207,207,0,0,1
2023-01-29,"40 - 1114",225,232,225,0,7,1
2023-01-29,"53 - 1103",184,186,183,1,2,0.994565217391304
2023-01-29,"2 - 1066",49,58,46,3,9,0.938775510204082
2023-01-29,"82 - 1163",110,148,110,0,38,1
2023-01-30,"40 - 1320",206,207,206,0,1,1
2023-01-30,"40 - 1114",225,232,225,0,7,1
2023-01-30,"53 - 1103",184,186,183,1,2,0.994565217391304
2023-01-30,"2 - 1066",48,58,46,2,10,0.958333333333333
2023-01-30,"82 - 1163",113,148,113,0,35,1
2023-01-31,"40 - 1320",207,207,207,0,0,1
2023-01-31,"40 - 1114",225,232,225,0,7,1
2023-01-31,"53 - 1103",185,186,184,1,1,0.994594594594595
2023-01-31,"2 - 1066",48,58,46,2,10,0.958333333333333
2023-01-31,"82 - 1163",114,148,112,2,34,0.982456140350877
2023-02-01,"40 - 1320",201,207,201,0,6,1
2023-02-01,"40 - 1114",222,232,222,0,10,1
2023-02-01,"53 - 1103",184,186,184,0,2,1
2023-02-01,"2 - 1066",48,58,46,2,10,0.958333333333333
2023-02-01,"82 - 1163",117,148,117,0,31,1
2023-02-02,"40 - 1320",202,207,202,0,5,1
2023-02-02,"40 - 1114",223,232,222,1,9,0.995515695067265
2023-02-02,"53 - 1103",184,186,184,0,2,1
2023-02-02,"2 - 1066",46,58,44,2,12,0.956521739130435
2023-02-02,"82 - 1163",123,148,123,0,25,1
2023-02-03,"40 - 1320",205,207,203,2,2,0.990243902439024
2023-02-03,"40 - 1114",223,232,222,1,9,0.995515695067265
2023-02-03,"53 - 1103",184,186,184,0,2,1
2023-02-03,"2 - 1066",45,58,43,2,13,0.955555555555556
2023-02-03,"82 - 1163",126,148,126,0,22,1
2023-02-04,"40 - 1320",206,207,206,0,1,1
2023-02-04,"40 - 1114",222,232,221,1,10,0.995495495495496
2023-02-04,"53 - 1103",185,186,183,2,1,0.989189189189189
2023-02-04,"2 - 1066",45,58,43,2,13,0.955555555555556
2023-02-04,"82 - 1163",124,148,124,0,24,1
2023-02-05,"40 - 1320",206,207,206,0,1,1
2023-02-05,"40 - 1114",222,232,221,1,10,0.995495495495496
2023-02-05,"53 - 1103",185,186,181,4,1,0.978378378378378
2023-02-05,"2 - 1066",45,58,43,2,13,0.955555555555556
2023-02-05,"82 - 1163",125,148,125,0,23,1
2023-02-06,"40 - 1320",206,207,206,0,1,1
2023-02-06,"40 - 1114",217,232,217,0,15,1
2023-02-06,"53 - 1103",184,186,180,4,2,0.978260869565217
2023-02-06,"2 - 1066",50,58,43,7,8,0.86
2023-02-06,"82 - 1163",125,148,125,0,23,1
2023-02-07,"40 - 1320",206,207,206,0,1,1
2023-02-07,"40 - 1114",215,232,215,0,17,1
2023-02-07,"53 - 1103",184,186,180,4,2,0.978260869565217
2023-02-07,"2 - 1066",45,58,42,3,13,0.933333333333333
2023-02-07,"82 - 1163",123,148,123,0,25,1
2023-02-08,"40 - 1320",205,207,205,0,2,1
2023-02-08,"40 - 1114",215,232,215,0,17,1
2023-02-08,"53 - 1103",183,186,179,4,3,0.978142076502732
2023-02-08,"2 - 1066",44,58,42,2,14,0.954545454545455
2023-02-08,"82 - 1163",122,148,121,1,26,0.991803278688525
2023-02-09,"40 - 1320",205,207,205,0,2,1
2023-02-09,"40 - 1114",217,232,217,0,15,1
2023-02-09,"53 - 1103",185,186,181,4,1,0.978378378378378
2023-02-09,"2 - 1066",44,58,43,1,14,0.977272727272727
2023-02-09,"82 - 1163",121,148,121,0,27,1
2023-02-10,"40 - 1320",206,207,206,0,1,1
2023-02-10,"40 - 1114",220,232,220,0,12,1
2023-02-10,"53 - 1103",185,186,181,4,1,0.978378378378378
2023-02-10,"2 - 1066",43,58,43,0,15,1
2023-02-10,"82 - 1163",122,148,122,0,26,1
2023-02-11,"40 - 1320",206,207,206,0,1,1
2023-02-11,"40 - 1114",218,232,218,0,14,1
2023-02-11,"53 - 1103",185,186,180,5,1,0.972972972972973
2023-02-11,"2 - 1066",44,58,44,0,14,1
2023-02-11,"82 - 1163",121,148,121,0,27,1
2023-02-12,"40 - 1320",206,207,206,0,1,1
2023-02-12,"40 - 1114",216,232,216,0,16,1
2023-02-12,"53 - 1103",184,186,180,4,2,0.978260869565217
2023-02-12,"2 - 1066",44,58,44,0,14,1
2023-02-12,"82 - 1163",121,148,121,0,27,1
2023-02-13,"40 - 1320",204,207,204,0,3,1
2023-02-13,"40 - 1114",217,232,217,0,15,1
2023-02-13,"53 - 1103",184,186,184,0,2,1
2023-02-13,"2 - 1066",44,58,44,0,14,1
2023-02-13,"82 - 1163",118,148,118,0,30,1
2023-02-14,"40 - 1320",205,207,205,0,2,1
2023-02-14,"40 - 1114",218,232,218,0,14,1
2023-02-14,"53 - 1103",185,186,184,1,1,0.994594594594595
2023-02-14,"2 - 1066",44,58,44,0,14,1
2023-02-14,"82 - 1163",119,148,119,0,29,1
2023-02-15,"40 - 1320",205,207,205,0,2,1
2023-02-15,"40 - 1114",221,232,221,0,11,1
2023-02-15,"53 - 1103",185,186,183,2,1,0.989189189189189
2023-02-15,"2 - 1066",44,58,43,1,14,0.977272727272727
2023-02-15,"82 - 1163",118,148,118,0,30,1
2023-02-16,"40 - 1320",206,207,206,0,1,1
2023-02-16,"40 - 1114",224,232,223,1,8,0.995535714285714
2023-02-16,"53 - 1103",186,186,183,3,0,0.983870967741935
2023-02-16,"2 - 1066",43,58,43,0,15,1
2023-02-16,"82 - 1163",118,148,118,0,30,1
2023-02-17,"40 - 1320",205,207,205,0,2,1
2023-02-17,"40 - 1114",225,232,225,0,7,1
2023-02-17,"53 - 1103",186,186,183,3,0,0.983870967741935
2023-02-17,"2 - 1066",45,58,44,1,13,0.977777777777778
2023-02-17,"82 - 1163",120,148,119,1,28,0.991666666666667
2023-02-18,"40 - 1320",205,207,205,0,2,1
2023-02-18,"40 - 1114",225,232,225,0,7,1
2023-02-18,"53 - 1103",186,186,180,6,0,0.967741935483871
2023-02-18,"2 - 1066",45,58,44,1,13,0.977777777777778
2023-02-18,"82 - 1163",124,148,124,0,24,1
2023-02-19,"40 - 1320",205,207,205,0,2,1
2023-02-19,"40 - 1114",225,232,225,0,7,1
2023-02-19,"53 - 1103",186,186,180,6,0,0.967741935483871
2023-02-19,"2 - 1066",45,58,44,1,13,0.977777777777778
2023-02-19,"82 - 1163",126,148,126,0,22,1
2023-02-20,"40 - 1320",206,207,206,0,1,1
2023-02-20,"40 - 1114",226,232,225,1,6,0.995575221238938
2023-02-20,"53 - 1103",186,186,183,3,0,0.983870967741935
2023-02-20,"2 - 1066",45,58,44,1,13,0.977777777777778
2023-02-20,"82 - 1163",130,148,130,0,18,1
2023-02-21,"40 - 1320",206,207,206,0,1,1
2023-02-21,"40 - 1114",226,232,226,0,6,1
2023-02-21,"53 - 1103",186,186,183,3,0,0.983870967741935
2023-02-21,"2 - 1066",46,58,45,1,12,0.978260869565217
2023-02-21,"82 - 1163",135,148,135,0,13,1
2023-02-22,"40 - 1320",206,207,206,0,1,1
2023-02-22,"40 - 1114",224,232,224,0,8,1
2023-02-22,"53 - 1103",186,186,184,2,0,0.989247311827957
2023-02-22,"2 - 1066",46,58,45,1,12,0.978260869565217
2023-02-22,"82 - 1163",135,148,135,0,13,1
2023-02-23,"40 - 1320",206,207,206,0,1,1
2023-02-23,"40 - 1114",225,232,225,0,7,1
2023-02-23,"53 - 1103",186,186,186,0,0,1
2023-02-23,"2 - 1066",46,58,45,1,12,0.978260869565217
2023-02-23,"82 - 1163",135,148,135,0,13,1
2023-02-24,"40 - 1320",207,207,207,0,0,1
2023-02-24,"40 - 1114",224,232,224,0,8,1
2023-02-24,"53 - 1103",186,186,185,1,0,0.994623655913978
2023-02-24,"2 - 1066",46,58,45,1,12,0.978260869565217
2023-02-24,"82 - 1163",136,148,136,0,12,1
2023-02-25,"40 - 1320",207,207,207,0,0,1
2023-02-25,"40 - 1114",224,232,224,0,8,1
2023-02-25,"53 - 1103",186,186,184,2,0,0.989247311827957
2023-02-25,"2 - 1066",46,58,44,2,12,0.956521739130435
2023-02-25,"82 - 1163",137,148,137,0,11,1
2023-02-26,"40 - 1320",207,207,207,0,0,1
2023-02-26,"40 - 1114",224,232,224,0,8,1
2023-02-26,"53 - 1103",184,186,184,0,2,1
2023-02-26,"2 - 1066",46,58,45,1,12,0.978260869565217
2023-02-26,"82 - 1163",138,148,138,0,10,1
2023-02-27,"40 - 1320",207,207,207,0,0,1
2023-02-27,"40 - 1114",224,232,223,1,8,0.995535714285714
2023-02-27,"53 - 1103",184,186,184,0,2,1
2023-02-27,"2 - 1066",46,58,45,1,12,0.978260869565217
2023-02-27,"82 - 1163",138,148,138,0,10,1
2023-02-28,"40 - 1320",207,207,207,0,0,1
2023-02-28,"40 - 1114",223,232,222,1,9,0.995515695067265
2023-02-28,"53 - 1103",185,186,183,2,1,0.989189189189189
2023-02-28,"2 - 1066",47,58,45,2,11,0.957446808510638
2023-02-28,"82 - 1163",138,148,138,0,10,1
2023-03-01,"40 - 1320",202,207,202,0,5,1
2023-03-01,"40 - 1114",222,232,222,0,10,1
2023-03-01,"53 - 1103",184,186,184,0,2,1
2023-03-01,"2 - 1066",43,58,41,2,15,0.953488372093023
2023-03-01,"82 - 1163",135,148,135,0,13,1
2023-03-02,"40 - 1320",206,207,205,1,1,0.995145631067961
2023-03-02,"40 - 1114",221,232,221,0,11,1
2023-03-02,"53 - 1103",184,186,184,0,2,1
2023-03-02,"2 - 1066",43,58,42,1,15,0.976744186046512
2023-03-02,"82 - 1163",138,148,138,0,10,1
2023-03-03,"40 - 1320",205,207,205,0,2,1
2023-03-03,"40 - 1114",222,232,221,1,10,0.995495495495496
2023-03-03,"53 - 1103",183,186,181,2,3,0.989071038251366
2023-03-03,"2 - 1066",44,58,42,2,14,0.954545454545455
2023-03-03,"82 - 1163",133,148,133,0,15,1
2023-03-04,"40 - 1320",204,207,204,0,3,1
2023-03-04,"40 - 1114",222,232,221,1,10,0.995495495495496
2023-03-04,"53 - 1103",184,186,181,3,2,0.983695652173913
2023-03-04,"2 - 1066",43,58,42,1,15,0.976744186046512
2023-03-04,"82 - 1163",132,148,132,0,16,1
2023-03-05,"40 - 1320",203,207,203,0,4,1
2023-03-05,"40 - 1114",223,232,223,0,9,1
2023-03-05,"53 - 1103",184,186,180,4,2,0.978260869565217
2023-03-05,"2 - 1066",42,58,42,0,16,1
2023-03-05,"82 - 1163",132,148,132,0,16,1
2023-03-06,"40 - 1320",204,207,204,0,3,1
2023-03-06,"40 - 1114",222,232,221,1,10,0.995495495495496
2023-03-06,"53 - 1103",183,186,182,1,3,0.994535519125683
2023-03-06,"2 - 1066",44,58,44,0,14,1
2023-03-06,"82 - 1163",132,148,132,0,16,1
2023-03-07,"40 - 1320",205,207,205,0,2,1
2023-03-07,"40 - 1114",222,232,222,0,10,1
2023-03-07,"53 - 1103",183,186,183,0,3,1
2023-03-07,"2 - 1066",44,58,44,0,14,1
2023-03-07,"82 - 1163",132,148,132,0,16,1
2023-03-08,"40 - 1320",205,207,205,0,2,1
2023-03-08,"40 - 1114",222,232,220,2,10,0.990990990990991
2023-03-08,"53 - 1103",184,186,184,0,2,1
2023-03-08,"2 - 1066",43,58,42,1,15,0.976744186046512
2023-03-08,"82 - 1163",131,148,131,0,17,1
2023-03-09,"40 - 1320",202,207,202,0,5,1
2023-03-09,"40 - 1114",223,232,223,0,9,1
2023-03-09,"53 - 1103",181,186,181,0,5,1
2023-03-09,"2 - 1066",44,58,43,1,14,0.977272727272727
2023-03-09,"82 - 1163",127,148,127,0,21,1
2023-03-10,"40 - 1320",202,207,202,0,5,1
2023-03-10,"40 - 1114",224,232,222,2,8,0.991071428571429
2023-03-10,"53 - 1103",184,186,181,3,2,0.983695652173913
2023-03-10,"2 - 1066",44,58,44,0,14,1
2023-03-10,"82 - 1163",125,148,125,0,23,1
2023-03-11,"40 - 1320",205,207,205,0,2,1
2023-03-11,"40 - 1114",225,232,225,0,7,1
2023-03-11,"53 - 1103",181,186,178,3,5,0.983425414364641
2023-03-11,"2 - 1066",44,58,44,0,14,1
2023-03-11,"82 - 1163",125,148,125,0,23,1
2023-03-12,"40 - 1320",206,207,206,0,1,1
2023-03-12,"40 - 1114",226,232,225,1,6,0.995575221238938
2023-03-12,"53 - 1103",183,186,177,6,3,0.967213114754098
2023-03-12,"2 - 1066",44,58,44,0,14,1
2023-03-12,"82 - 1163",127,148,127,0,21,1
2023-03-13,"40 - 1320",206,207,206,0,1,1
2023-03-13,"40 - 1114",227,232,226,1,5,0.995594713656388
2023-03-13,"53 - 1103",183,186,180,3,3,0.983606557377049
2023-03-13,"2 - 1066",43,58,43,0,15,1
2023-03-13,"82 - 1163",126,148,126,0,22,1
2023-03-14,"40 - 1320",207,207,207,0,0,1
2023-03-14,"40 - 1114",226,232,226,0,6,1
2023-03-14,"53 - 1103",184,186,181,3,2,0.983695652173913
2023-03-14,"2 - 1066",43,58,43,0,15,1
2023-03-14,"82 - 1163",128,148,128,0,20,1
2023-03-15,"40 - 1320",207,207,207,0,0,1
2023-03-15,"40 - 1114",226,232,226,0,6,1
2023-03-15,"53 - 1103",185,186,177,8,1,0.956756756756757
2023-03-15,"2 - 1066",43,58,43,0,15,1
2023-03-15,"82 - 1163",129,148,129,0,19,1
2023-03-16,"40 - 1320",206,207,206,0,1,1
2023-03-16,"40 - 1114",226,232,226,0,6,1
2023-03-16,"53 - 1103",184,186,181,3,2,0.983695652173913
2023-03-16,"2 - 1066",45,58,45,0,13,1
2023-03-16,"82 - 1163",129,148,129,0,19,1
2023-03-17,"40 - 1320",205,207,205,0,2,1
2023-03-17,"40 - 1114",225,232,225,0,7,1
2023-03-17,"53 - 1103",185,186,185,0,1,1
2023-03-17,"2 - 1066",45,58,45,0,13,1
2023-03-17,"82 - 1163",127,148,127,0,21,1
2023-03-18,"40 - 1320",206,207,206,0,1,1
2023-03-18,"40 - 1114",225,232,224,1,7,0.995555555555556
2023-03-18,"53 - 1103",184,186,184,0,2,1
2023-03-18,"2 - 1066",45,58,45,0,13,1
2023-03-18,"82 - 1163",128,148,128,0,20,1
2023-03-19,"40 - 1320",206,207,206,0,1,1
2023-03-19,"40 - 1114",225,232,224,1,7,0.995555555555556
2023-03-19,"53 - 1103",182,186,181,1,4,0.994505494505495
2023-03-19,"2 - 1066",45,58,45,0,13,1
2023-03-19,"82 - 1163",129,148,129,0,19,1
2023-03-20,"40 - 1320",207,207,207,0,0,1
2023-03-20,"40 - 1114",223,232,223,0,9,1
2023-03-20,"53 - 1103",184,186,183,1,2,0.994565217391304
2023-03-20,"2 - 1066",45,58,45,0,13,1
2023-03-20,"82 - 1163",126,148,126,0,22,1
2023-03-21,"40 - 1320",207,207,207,0,0,1
2023-03-21,"40 - 1114",223,232,223,0,9,1
2023-03-21,"53 - 1103",182,186,180,2,4,0.989010989010989
2023-03-21,"2 - 1066",45,58,45,0,13,1
2023-03-21,"82 - 1163",127,148,127,0,21,1
2023-03-22,"40 - 1320",207,207,207,0,0,1
2023-03-22,"40 - 1114",222,232,221,1,10,0.995495495495496
2023-03-22,"53 - 1103",183,186,181,2,3,0.989071038251366
2023-03-22,"2 - 1066",45,58,45,0,13,1
2023-03-22,"82 - 1163",131,148,130,1,17,0.99236641221374
2023-03-23,"40 - 1320",207,207,207,0,0,1
2023-03-23,"40 - 1114",220,232,220,0,12,1
2023-03-23,"53 - 1103",182,186,180,2,4,0.989010989010989
2023-03-23,"2 - 1066",46,58,46,0,12,1
2023-03-23,"82 - 1163",134,148,134,0,14,1
2023-03-24,"40 - 1320",206,207,206,0,1,1
2023-03-24,"40 - 1114",216,232,216,0,16,1
2023-03-24,"53 - 1103",182,186,180,2,4,0.989010989010989
2023-03-24,"2 - 1066",47,58,47,0,11,1
2023-03-24,"82 - 1163",132,148,132,0,16,1
2023-03-25,"40 - 1320",206,207,206,0,1,1
2023-03-25,"40 - 1114",216,232,216,0,16,1
2023-03-25,"53 - 1103",183,186,181,2,3,0.989071038251366
2023-03-25,"2 - 1066",47,58,47,0,11,1
2023-03-25,"82 - 1163",131,148,131,0,17,1
2023-03-26,"40 - 1320",207,207,207,0,0,1
2023-03-26,"40 - 1114",216,232,216,0,16,1
2023-03-26,"53 - 1103",184,186,182,2,2,0.989130434782609
2023-03-26,"2 - 1066",47,58,46,1,11,0.978723404255319
2023-03-26,"82 - 1163",132,148,132,0,16,1
2023-03-27,"40 - 1320",206,207,206,0,1,1
2023-03-27,"40 - 1114",215,231,215,0,16,1
2023-03-27,"53 - 1103",184,186,183,1,2,0.994565217391304
2023-03-27,"2 - 1066",46,58,46,0,12,1
2023-03-27,"82 - 1163",132,148,132,0,16,1
2023-03-28,"40 - 1320",207,207,207,0,0,1
2023-03-28,"40 - 1114",215,231,215,0,16,1
2023-03-28,"53 - 1103",184,186,183,1,2,0.994565217391304
2023-03-28,"2 - 1066",48,58,46,2,10,0.958333333333333
2023-03-28,"82 - 1163",135,148,135,0,13,1
2023-03-29,"40 - 1320",207,207,207,0,0,1
2023-03-29,"40 - 1114",217,231,217,0,14,1
2023-03-29,"53 - 1103",185,186,184,1,1,0.994594594594595
2023-03-29,"2 - 1066",48,58,48,0,10,1
2023-03-29,"82 - 1163",135,148,135,0,13,1
2023-03-30,"40 - 1320",207,207,207,0,0,1
2023-03-30,"40 - 1114",216,231,216,0,15,1
2023-03-30,"53 - 1103",185,186,185,0,1,1
2023-03-30,"2 - 1066",47,58,47,0,11,1
2023-03-30,"82 - 1163",134,148,134,0,14,1
2023-03-31,"40 - 1320",205,207,205,0,2,1
2023-03-31,"40 - 1114",213,231,213,0,18,1
2023-03-31,"53 - 1103",185,186,185,0,1,1
2023-03-31,"2 - 1066",47,58,47,0,11,1
2023-03-31,"82 - 1163",135,148,135,0,13,1
2023-04-01,"40 - 1320",205,207,205,0,2,1
2023-04-01,"40 - 1114",211,231,211,0,20,1
2023-04-01,"53 - 1103",185,186,183,2,1,0.989189189189189
2023-04-01,"2 - 1066",44,58,44,0,14,1
2023-04-01,"82 - 1163",130,148,130,0,18,1
2023-04-02,"40 - 1320",206,207,206,0,1,1
2023-04-02,"40 - 1114",211,231,211,0,20,1
2023-04-02,"53 - 1103",183,186,183,0,3,1
2023-04-02,"2 - 1066",44,58,44,0,14,1
2023-04-02,"82 - 1163",131,148,131,0,17,1
2023-04-03,"40 - 1320",207,207,207,0,0,1
2023-04-03,"40 - 1114",212,231,212,0,19,1
2023-04-03,"53 - 1103",184,186,181,3,2,0.983695652173913
2023-04-03,"2 - 1066",44,58,43,1,14,0.977272727272727
2023-04-03,"82 - 1163",132,148,132,0,16,1
2023-04-04,"40 - 1320",207,207,207,0,0,1
2023-04-04,"40 - 1114",213,231,213,0,18,1
2023-04-04,"53 - 1103",184,186,183,1,2,0.994565217391304
2023-04-04,"2 - 1066",45,58,44,1,13,0.977777777777778
2023-04-04,"82 - 1163",132,148,132,0,16,1
2023-04-05,"40 - 1320",204,207,204,0,3,1
2023-04-05,"40 - 1114",214,231,214,0,17,1
2023-04-05,"53 - 1103",185,186,182,3,1,0.983783783783784
2023-04-05,"2 - 1066",45,58,45,0,13,1
2023-04-05,"82 - 1163",131,148,131,0,17,1
2023-04-06,"40 - 1320",206,207,205,1,1,0.995145631067961
2023-04-06,"40 - 1114",215,232,215,0,17,1
2023-04-06,"53 - 1103",186,186,185,1,0,0.994623655913978
2023-04-06,"2 - 1066",45,58,45,0,13,1
2023-04-06,"82 - 1163",136,148,133,3,12,0.977941176470588
2023-04-07,"40 - 1320",206,207,206,0,1,1
2023-04-07,"40 - 1114",217,232,215,2,15,0.990783410138249
2023-04-07,"53 - 1103",185,186,183,2,1,0.989189189189189
2023-04-07,"2 - 1066",47,58,46,1,11,0.978723404255319
2023-04-07,"82 - 1163",133,148,133,0,15,1
2023-04-08,"40 - 1320",207,207,207,0,0,1
2023-04-08,"40 - 1114",217,232,215,2,15,0.990783410138249
2023-04-08,"53 - 1103",185,186,183,2,1,0.989189189189189
2023-04-08,"2 - 1066",47,58,47,0,11,1
2023-04-08,"82 - 1163",134,148,134,0,14,1
2023-04-09,"40 - 1320",207,207,207,0,0,1
2023-04-09,"40 - 1114",217,232,215,2,15,0.990783410138249
2023-04-09,"53 - 1103",186,186,183,3,0,0.983870967741935
2023-04-09,"2 - 1066",46,58,46,0,12,1
2023-04-09,"82 - 1163",134,148,134,0,14,1
2023-04-10,"40 - 1320",207,207,207,0,0,1
2023-04-10,"40 - 1114",216,232,214,2,16,0.990740740740741
2023-04-10,"53 - 1103",186,186,185,1,0,0.994623655913978
2023-04-10,"2 - 1066",47,58,46,1,11,0.978723404255319
2023-04-10,"82 - 1163",131,134,130,1,3,0.99236641221374
2023-04-11,"40 - 1320",206,207,206,0,1,1
2023-04-11,"40 - 1114",212,232,211,1,20,0.995283018867924
2023-04-11,"53 - 1103",185,186,185,0,1,1
2023-04-11,"2 - 1066",47,58,47,0,11,1
2023-04-11,"82 - 1163",134,134,134,0,0,1
2023-04-12,"40 - 1320",206,207,206,0,1,1
2023-04-12,"40 - 1114",213,232,213,0,19,1
2023-04-12,"53 - 1103",186,186,183,3,0,0.983870967741935
2023-04-12,"2 - 1066",46,58,46,0,12,1
2023-04-12,"82 - 1163",135,134,135,0,-1,1
2023-04-13,"40 - 1320",206,207,206,0,1,1
2023-04-13,"40 - 1114",215,232,214,1,17,0.995348837209302
2023-04-13,"53 - 1103",186,186,182,4,0,0.978494623655914
2023-04-13,"2 - 1066",46,58,46,0,12,1
2023-04-13,"82 - 1163",137,148,137,0,11,1
2023-04-14,"40 - 1320",204,207,204,0,3,1
2023-04-14,"40 - 1114",213,232,213,0,19,1
2023-04-14,"53 - 1103",184,186,182,2,2,0.989130434782609
2023-04-14,"2 - 1066",46,58,46,0,12,1
2023-04-14,"82 - 1163",139,148,139,0,9,1
2023-04-15,"40 - 1320",205,207,205,0,2,1
2023-04-15,"40 - 1114",214,232,213,1,18,0.995327102803738
2023-04-15,"53 - 1103",184,186,182,2,2,0.989130434782609
2023-04-15,"2 - 1066",46,58,46,0,12,1
2023-04-15,"82 - 1163",140,148,140,0,8,1
2023-04-16,"40 - 1320",205,207,205,0,2,1
2023-04-16,"40 - 1114",214,232,213,1,18,0.995327102803738
2023-04-16,"53 - 1103",183,186,180,3,3,0.983606557377049
2023-04-16,"2 - 1066",46,58,46,0,12,1
2023-04-16,"82 - 1163",138,148,136,2,10,0.985507246376812
2023-04-17,"40 - 1320",206,207,206,0,1,1
2023-04-17,"40 - 1114",213,232,213,0,19,1
2023-04-17,"53 - 1103",184,186,182,2,2,0.989130434782609
2023-04-17,"2 - 1066",46,58,46,0,12,1
2023-04-17,"82 - 1163",140,148,140,0,8,1
2023-04-18,"40 - 1320",205,207,205,0,2,1
2023-04-18,"40 - 1114",213,232,213,0,19,1
2023-04-18,"53 - 1103",184,186,183,1,2,0.994565217391304
2023-04-18,"2 - 1066",46,58,46,0,12,1
2023-04-18,"82 - 1163",138,148,138,0,10,1
2023-04-19,"40 - 1320",206,207,206,0,1,1
2023-04-19,"40 - 1114",210,232,210,0,22,1
2023-04-19,"53 - 1103",184,186,184,0,2,1
2023-04-19,"2 - 1066",46,58,46,0,12,1
2023-04-19,"82 - 1163",141,148,141,0,7,1
2023-04-20,"40 - 1320",206,207,206,0,1,1
2023-04-20,"40 - 1114",209,232,209,0,23,1
2023-04-20,"53 - 1103",183,186,183,0,3,1
2023-04-20,"2 - 1066",46,58,46,0,12,1
2023-04-20,"82 - 1163",140,148,140,0,8,1
2023-04-21,"40 - 1320",206,207,206,0,1,1
2023-04-21,"40 - 1114",209,232,209,0,23,1
2023-04-21,"53 - 1103",183,186,181,2,3,0.989071038251366
2023-04-21,"2 - 1066",45,58,45,0,13,1
2023-04-21,"82 - 1163",142,148,142,0,6,1
2023-04-22,"40 - 1320",207,207,206,1,0,0.995169082125604
2023-04-22,"40 - 1114",209,232,209,0,23,1
2023-04-22,"53 - 1103",182,186,180,2,4,0.989010989010989
2023-04-22,"2 - 1066",45,58,45,0,13,1
2023-04-22,"82 - 1163",143,148,143,0,5,1
2023-04-23,"40 - 1320",207,207,206,1,0,0.995169082125604
2023-04-23,"40 - 1114",209,232,209,0,23,1
2023-04-23,"53 - 1103",182,186,179,3,4,0.983516483516483
2023-04-23,"2 - 1066",45,58,45,0,13,1
2023-04-23,"82 - 1163",142,148,142,0,6,1
2023-04-24,"40 - 1320",207,207,206,1,0,0.995169082125604
2023-04-24,"40 - 1114",207,232,206,1,25,0.995169082125604
2023-04-24,"53 - 1103",184,186,183,1,2,0.994565217391304
2023-04-24,"2 - 1066",46,58,45,1,12,0.978260869565217
2023-04-24,"82 - 1163",144,148,144,0,4,1
2023-04-25,"40 - 1320",206,207,205,1,1,0.995145631067961
2023-04-25,"40 - 1114",207,232,205,2,25,0.990338164251208
2023-04-25,"53 - 1103",184,186,183,1,2,0.994565217391304
2023-04-25,"2 - 1066",46,58,45,1,12,0.978260869565217
2023-04-25,"82 - 1163",145,148,145,0,3,1
2023-04-26,"40 - 1320",206,207,205,1,1,0.995145631067961
2023-04-26,"40 - 1114",206,232,205,1,26,0.995145631067961
2023-04-26,"53 - 1103",185,186,184,1,1,0.994594594594595
2023-04-26,"2 - 1066",46,58,46,0,12,1
2023-04-26,"82 - 1163",145,148,145,0,3,1
2023-04-27,"40 - 1320",206,207,205,1,1,0.995145631067961
2023-04-27,"40 - 1114",205,232,205,0,27,1
2023-04-27,"53 - 1103",185,186,185,0,1,1
2023-04-27,"2 - 1066",46,58,46,0,12,1
2023-04-27,"82 - 1163",142,148,142,0,6,1
2023-04-28,"40 - 1320",206,207,206,0,1,1
2023-04-28,"40 - 1114",205,232,204,1,27,0.995121951219512
2023-04-28,"53 - 1103",186,186,185,1,0,0.994623655913978
2023-04-28,"2 - 1066",47,58,47,0,11,1
2023-04-28,"82 - 1163",139,148,139,0,9,1
2023-04-29,"40 - 1320",205,207,205,0,2,1
2023-04-29,"40 - 1114",207,232,206,1,25,0.995169082125604
2023-04-29,"53 - 1103",185,186,183,2,1,0.989189189189189
2023-04-29,"2 - 1066",47,58,47,0,11,1
2023-04-29,"82 - 1163",140,148,140,0,8,1
2023-04-30,"40 - 1320",206,207,206,0,1,1
2023-04-30,"40 - 1114",207,232,205,2,25,0.990338164251208
2023-04-30,"53 - 1103",183,186,182,1,3,0.994535519125683
2023-04-30,"2 - 1066",47,58,46,1,11,0.978723404255319
2023-04-30,"82 - 1163",136,148,136,0,12,1
2023-05-01,"40 - 1320",205,207,205,0,2,1
2023-05-01,"40 - 1114",205,232,204,1,27,0.995121951219512
2023-05-01,"53 - 1103",185,186,183,2,1,0.989189189189189
2023-05-01,"2 - 1066",46,58,46,0,12,1
2023-05-01,"82 - 1163",140,148,140,0,8,1
2023-05-02,"40 - 1320",204,207,204,0,3,1
2023-05-02,"40 - 1114",201,232,200,1,31,0.995024875621891
2023-05-02,"53 - 1103",182,186,182,0,4,1
2023-05-02,"2 - 1066",45,58,45,0,13,1
2023-05-02,"82 - 1163",140,148,140,0,8,1
2023-05-03,"40 - 1320",202,207,201,1,5,0.995049504950495
2023-05-03,"40 - 1114",200,232,198,2,32,0.99
2023-05-03,"53 - 1103",183,186,183,0,3,1
2023-05-03,"2 - 1066",45,58,45,0,13,1
2023-05-03,"82 - 1163",140,148,140,0,8,1
2023-05-04,"40 - 1320",204,207,204,0,3,1
2023-05-04,"40 - 1114",201,232,201,0,31,1
2023-05-04,"53 - 1103",185,186,185,0,1,1
2023-05-04,"2 - 1066",45,58,45,0,13,1
2023-05-04,"82 - 1163",136,134,136,0,-2,1
2023-05-05,"40 - 1320",205,207,204,1,2,0.995121951219512
2023-05-05,"40 - 1114",204,232,204,0,28,1
2023-05-05,"53 - 1103",183,186,183,0,3,1
2023-05-05,"2 - 1066",44,58,44,0,14,1
2023-05-05,"82 - 1163",140,148,140,0,8,1
2023-05-06,"40 - 1320",202,207,202,0,5,1
2023-05-06,"40 - 1114",209,232,209,0,23,1
2023-05-06,"53 - 1103",184,186,183,1,2,0.994565217391304
2023-05-06,"2 - 1066",43,58,43,0,15,1
2023-05-06,"82 - 1163",140,148,140,0,8,1
2023-05-07,"40 - 1320",205,207,205,0,2,1
2023-05-07,"40 - 1114",211,232,211,0,21,1
2023-05-07,"53 - 1103",183,186,183,0,3,1
2023-05-07,"2 - 1066",45,58,45,0,13,1
2023-05-07,"82 - 1163",140,148,139,1,8,0.992857142857143
2023-05-08,"40 - 1320",206,207,206,0,1,1
2023-05-08,"40 - 1114",212,232,212,0,20,1
2023-05-08,"53 - 1103",184,186,184,0,2,1
2023-05-08,"2 - 1066",45,58,45,0,13,1
2023-05-08,"82 - 1163",140,148,140,0,8,1
2023-05-09,"40 - 1320",206,207,206,0,1,1
2023-05-09,"40 - 1114",211,232,211,0,21,1
2023-05-09,"53 - 1103",185,186,185,0,1,1
2023-05-09,"2 - 1066",43,58,43,0,15,1
2023-05-09,"82 - 1163",138,148,138,0,10,1
2023-05-10,"40 - 1320",207,207,207,0,0,1
2023-05-10,"40 - 1114",209,232,208,1,23,0.995215311004785
2023-05-10,"53 - 1103",184,186,184,0,2,1
2023-05-10,"2 - 1066",43,58,43,0,15,1
2023-05-10,"82 - 1163",137,148,137,0,11,1
2023-05-11,"40 - 1320",207,207,207,0,0,1
2023-05-11,"40 - 1114",211,232,210,1,21,0.995260663507109
2023-05-11,"53 - 1103",185,186,185,0,1,1
2023-05-11,"2 - 1066",44,58,43,1,14,0.977272727272727
2023-05-11,"82 - 1163",138,148,138,0,10,1
2023-05-12,"40 - 1320",205,207,205,0,2,1
2023-05-12,"40 - 1114",210,232,210,0,22,1
2023-05-12,"53 - 1103",185,186,185,0,1,1
2023-05-12,"2 - 1066",49,58,44,5,9,0.897959183673469
2023-05-12,"82 - 1163",142,148,142,0,6,1
2023-05-13,"40 - 1320",205,207,205,0,2,1
2023-05-13,"40 - 1114",209,232,209,0,23,1
2023-05-13,"53 - 1103",183,186,183,0,3,1
2023-05-13,"2 - 1066",49,58,46,3,9,0.938775510204082
2023-05-13,"82 - 1163",140,148,140,0,8,1
2023-05-14,"40 - 1320",207,207,207,0,0,1
2023-05-14,"40 - 1114",213,232,211,2,19,0.990610328638498
2023-05-14,"53 - 1103",184,186,183,1,2,0.994565217391304
2023-05-14,"2 - 1066",48,58,46,2,10,0.958333333333333
2023-05-14,"82 - 1163",142,148,142,0,6,1
2023-05-15,"40 - 1320",207,207,204,3,0,0.985507246376812
2023-05-15,"40 - 1114",212,232,212,0,20,1
2023-05-15,"53 - 1103",185,186,183,2,1,0.989189189189189
2023-05-15,"2 - 1066",48,58,48,0,10,1
2023-05-15,"82 - 1163",143,148,143,0,5,1
2023-05-16,"40 - 1320",205,207,205,0,2,1
2023-05-16,"40 - 1114",211,232,209,2,21,0.990521327014218
2023-05-16,"53 - 1103",182,186,182,0,4,1
2023-05-16,"2 - 1066",48,58,47,1,10,0.979166666666667
2023-05-16,"82 - 1163",146,148,146,0,2,1
2023-05-17,"40 - 1320",206,207,205,1,1,0.995145631067961
2023-05-17,"40 - 1114",208,232,208,0,24,1
2023-05-17,"53 - 1103",182,186,179,3,4,0.983516483516483
2023-05-17,"2 - 1066",48,58,48,0,10,1
2023-05-17,"82 - 1163",145,148,145,0,3,1
2023-05-18,"40 - 1320",207,207,207,0,0,1
2023-05-18,"40 - 1114",207,232,207,0,25,1
2023-05-18,"53 - 1103",181,186,181,0,5,1
2023-05-18,"2 - 1066",47,58,47,0,11,1
2023-05-18,"82 - 1163",145,148,145,0,3,1
2023-05-19,"40 - 1320",207,207,207,0,0,1
2023-05-19,"40 - 1114",209,232,208,1,23,0.995215311004785
2023-05-19,"53 - 1103",182,186,181,1,4,0.994505494505495
2023-05-19,"2 - 1066",47,58,47,0,11,1
2023-05-19,"82 - 1163",145,148,145,0,3,1
2023-05-20,"40 - 1320",207,207,207,0,0,1
2023-05-20,"40 - 1114",210,232,210,0,22,1
2023-05-20,"53 - 1103",185,186,183,2,1,0.989189189189189
2023-05-20,"2 - 1066",49,58,48,1,9,0.979591836734694
2023-05-20,"82 - 1163",145,148,145,0,3,1
2023-05-21,"40 - 1320",207,207,207,0,0,1
2023-05-21,"40 - 1114",212,232,212,0,20,1
2023-05-21,"53 - 1103",185,186,185,0,1,1
2023-05-21,"2 - 1066",49,58,48,1,9,0.979591836734694
2023-05-21,"82 - 1163",144,148,144,0,4,1
2023-05-22,"40 - 1320",207,207,207,0,0,1
2023-05-22,"40 - 1114",212,232,212,0,20,1
2023-05-22,"53 - 1103",186,186,185,1,0,0.994623655913978
2023-05-22,"2 - 1066",49,58,49,0,9,1
2023-05-22,"82 - 1163",142,148,142,0,6,1
2023-05-23,"40 - 1320",206,207,206,0,1,1
2023-05-23,"40 - 1114",211,232,211,0,21,1
2023-05-23,"53 - 1103",185,186,183,2,1,0.989189189189189
2023-05-23,"2 - 1066",49,58,49,0,9,1
2023-05-23,"82 - 1163",143,148,142,1,5,0.993006993006993
2023-05-24,"40 - 1320",207,207,206,1,0,0.995169082125604
2023-05-24,"40 - 1114",211,232,210,1,21,0.995260663507109
2023-05-24,"53 - 1103",185,186,183,2,1,0.989189189189189
2023-05-24,"2 - 1066",49,58,49,0,9,1
2023-05-24,"82 - 1163",144,148,144,0,4,1
2023-05-25,"40 - 1320",207,207,207,0,0,1
2023-05-25,"40 - 1114",212,232,211,1,20,0.995283018867924
2023-05-25,"53 - 1103",185,186,184,1,1,0.994594594594595
2023-05-25,"2 - 1066",47,58,47,0,11,1
2023-05-25,"82 - 1163",143,148,143,0,5,1
2023-05-26,"40 - 1320",207,207,207,0,0,1
2023-05-26,"40 - 1114",213,232,213,0,19,1
2023-05-26,"53 - 1103",185,186,184,1,1,0.994594594594595
2023-05-26,"2 - 1066",47,58,47,0,11,1
2023-05-26,"82 - 1163",146,148,146,0,2,1
2023-05-27,"40 - 1320",207,207,207,0,0,1
2023-05-27,"40 - 1114",213,232,213,0,19,1
2023-05-27,"53 - 1103",185,186,185,0,1,1
2023-05-27,"2 - 1066",48,58,47,1,10,0.979166666666667
2023-05-27,"82 - 1163",144,148,144,0,4,1
2023-05-28,"40 - 1320",206,207,206,0,1,1
2023-05-28,"40 - 1114",213,232,213,0,19,1
2023-05-28,"53 - 1103",184,186,184,0,2,1
2023-05-28,"2 - 1066",48,58,47,1,10,0.979166666666667
2023-05-28,"82 - 1163",143,148,143,0,5,1
2023-05-29,"40 - 1320",206,207,206,0,1,1
2023-05-29,"40 - 1114",214,232,214,0,18,1
2023-05-29,"53 - 1103",185,186,184,1,1,0.994594594594595
2023-05-29,"2 - 1066",48,58,47,1,10,0.979166666666667
2023-05-29,"82 - 1163",143,148,142,1,5,0.993006993006993
2023-05-30,"40 - 1320",206,207,206,0,1,1
2023-05-30,"40 - 1114",216,232,215,1,16,0.99537037037037
2023-05-30,"53 - 1103",185,186,184,1,1,0.994594594594595
2023-05-30,"2 - 1066",48,58,47,1,10,0.979166666666667
2023-05-30,"82 - 1163",143,148,143,0,5,1
2023-05-31,"40 - 1320",206,207,206,0,1,1
2023-05-31,"40 - 1114",213,232,213,0,19,1
2023-05-31,"53 - 1103",185,186,184,1,1,0.994594594594595
2023-05-31,"2 - 1066",47,58,47,0,11,1
2023-05-31,"82 - 1163",142,148,142,0,6,1
2023-06-01,"40 - 1320",205,207,205,0,2,1
2023-06-01,"40 - 1114",214,232,212,2,18,0.990654205607477
2023-06-01,"53 - 1103",182,186,181,1,4,0.994505494505495
2023-06-01,"2 - 1066",48,58,48,0,10,1
2023-06-01,"82 - 1163",143,148,143,0,5,1
2023-06-02,"40 - 1320",203,207,203,0,4,1
2023-06-02,"40 - 1114",212,232,212,0,20,1
2023-06-02,"53 - 1103",180,186,177,3,6,0.983333333333333
2023-06-02,"2 - 1066",48,58,48,0,10,1
2023-06-02,"82 - 1163",142,148,142,0,6,1
2023-06-03,"40 - 1320",203,207,202,1,4,0.995073891625616
2023-06-03,"40 - 1114",214,232,213,1,18,0.995327102803738
2023-06-03,"53 - 1103",184,186,179,5,2,0.972826086956522
2023-06-03,"2 - 1066",49,58,48,1,9,0.979591836734694
2023-06-03,"82 - 1163",142,148,142,0,6,1
2023-06-04,"40 - 1320",205,207,205,0,2,1
2023-06-04,"40 - 1114",215,232,215,0,17,1
2023-06-04,"53 - 1103",184,186,181,3,2,0.983695652173913
2023-06-04,"2 - 1066",48,58,47,1,10,0.979166666666667
2023-06-04,"82 - 1163",143,148,143,0,5,1
2023-06-05,"40 - 1320",205,207,205,0,2,1
2023-06-05,"40 - 1114",219,232,218,1,13,0.995433789954338
2023-06-05,"53 - 1103",183,186,182,1,3,0.994535519125683
2023-06-05,"2 - 1066",48,58,48,0,10,1
2023-06-05,"82 - 1163",141,148,141,0,7,1
2023-06-06,"40 - 1320",205,207,205,0,2,1
2023-06-06,"40 - 1114",219,232,218,1,13,0.995433789954338
2023-06-06,"53 - 1103",184,186,183,1,2,0.994565217391304
2023-06-06,"2 - 1066",48,58,47,1,10,0.979166666666667
2023-06-06,"82 - 1163",139,148,139,0,9,1
2023-06-07,"40 - 1320",205,207,205,0,2,1
2023-06-07,"40 - 1114",221,232,220,1,11,0.995475113122172
2023-06-07,"53 - 1103",184,186,183,1,2,0.994565217391304
2023-06-07,"2 - 1066",48,58,48,0,10,1
2023-06-07,"82 - 1163",145,148,145,0,3,1
2023-06-08,"40 - 1320",205,207,205,0,2,1
2023-06-08,"40 - 1114",224,232,223,1,8,0.995535714285714
2023-06-08,"53 - 1103",184,186,184,0,2,1
2023-06-08,"2 - 1066",48,58,48,0,10,1
2023-06-08,"82 - 1163",145,148,145,0,3,1
2023-06-09,"40 - 1320",205,207,205,0,2,1
2023-06-09,"40 - 1114",225,232,225,0,7,1
2023-06-09,"53 - 1103",183,186,181,2,3,0.989071038251366
2023-06-09,"2 - 1066",48,58,48,0,10,1
2023-06-09,"82 - 1163",145,148,145,0,3,1
2023-06-10,"40 - 1320",205,207,205,0,2,1
2023-06-10,"40 - 1114",226,232,225,1,6,0.995575221238938
2023-06-10,"53 - 1103",182,186,181,1,4,0.994505494505495
2023-06-10,"2 - 1066",48,58,48,0,10,1
2023-06-10,"82 - 1163",144,134,144,0,-10,1
2023-06-11,"40 - 1320",205,207,205,0,2,1
2023-06-11,"40 - 1114",225,232,225,0,7,1
2023-06-11,"53 - 1103",183,186,183,0,3,1
2023-06-11,"2 - 1066",48,58,48,0,10,1
2023-06-11,"82 - 1163",146,134,146,0,-12,1
2023-06-12,"40 - 1320",205,207,205,0,2,1
2023-06-12,"40 - 1114",225,232,223,2,7,0.991111111111111
2023-06-12,"53 - 1103",186,186,185,1,0,0.994623655913978
2023-06-12,"2 - 1066",48,58,48,0,10,1
2023-06-12,"82 - 1163",144,134,144,0,-10,1
2023-06-13,"40 - 1320",206,207,206,0,1,1
2023-06-13,"40 - 1114",223,232,222,1,9,0.995515695067265
2023-06-13,"53 - 1103",186,186,185,1,0,0.994623655913978
2023-06-13,"2 - 1066",48,58,48,0,10,1
2023-06-13,"82 - 1163",143,134,143,0,-9,1
2023-06-14,"40 - 1320",206,207,206,0,1,1
2023-06-14,"40 - 1114",221,232,221,0,11,1
2023-06-14,"53 - 1103",186,186,185,1,0,0.994623655913978
2023-06-14,"2 - 1066",48,58,48,0,10,1
2023-06-14,"82 - 1163",141,134,141,0,-7,1
2023-06-15,"40 - 1320",206,207,206,0,1,1
2023-06-15,"40 - 1114",223,232,222,1,9,0.995515695067265
2023-06-15,"53 - 1103",186,186,186,0,0,1
2023-06-15,"2 - 1066",47,58,47,0,11,1
2023-06-15,"82 - 1163",144,134,143,1,-10,0.993055555555556
2023-06-16,"40 - 1320",206,207,206,0,1,1
2023-06-16,"40 - 1114",224,232,223,1,8,0.995535714285714
2023-06-16,"53 - 1103",186,186,186,0,0,1
2023-06-16,"2 - 1066",49,58,48,1,9,0.979591836734694
2023-06-16,"82 - 1163",145,134,145,0,-11,1
2023-06-17,"40 - 1320",206,207,206,0,1,1
2023-06-17,"40 - 1114",222,232,222,0,10,1
2023-06-17,"53 - 1103",186,186,186,0,0,1
2023-06-17,"2 - 1066",49,58,49,0,9,1
2023-06-17,"82 - 1163",145,134,145,0,-11,1
2023-06-18,"40 - 1320",206,207,206,0,1,1
2023-06-18,"40 - 1114",223,232,223,0,9,1
2023-06-18,"53 - 1103",185,186,185,0,1,1
2023-06-18,"2 - 1066",49,58,49,0,9,1
2023-06-18,"82 - 1163",143,134,143,0,-9,1
2023-06-19,"40 - 1320",206,207,206,0,1,1
2023-06-19,"40 - 1114",224,231,224,0,7,1
2023-06-19,"53 - 1103",186,186,186,0,0,1
2023-06-19,"2 - 1066",49,58,49,0,9,1
2023-06-19,"82 - 1163",144,134,144,0,-10,1
2023-06-20,"40 - 1320",206,207,206,0,1,1
2023-06-20,"40 - 1114",225,232,224,1,7,0.995555555555556
2023-06-20,"53 - 1103",187,186,186,1,-1,0.994652406417112
2023-06-20,"2 - 1066",48,58,48,0,10,1
2023-06-20,"82 - 1163",144,134,144,0,-10,1
2023-06-21,"40 - 1320",206,207,206,0,1,1
2023-06-21,"40 - 1114",225,232,225,0,7,1
2023-06-21,"53 - 1103",187,186,185,2,-1,0.989304812834225
2023-06-21,"2 - 1066",48,58,48,0,10,1
2023-06-21,"82 - 1163",144,134,144,0,-10,1
2023-06-22,"40 - 1320",206,207,206,0,1,1
2023-06-22,"40 - 1114",225,232,225,0,7,1
2023-06-22,"53 - 1103",186,186,184,2,0,0.989247311827957
2023-06-22,"2 - 1066",47,58,47,0,11,1
2023-06-22,"82 - 1163",146,148,146,0,2,1
2023-06-23,"40 - 1320",206,207,206,0,1,1
2023-06-23,"40 - 1114",227,232,227,0,5,1
2023-06-23,"53 - 1103",187,186,184,3,-1,0.983957219251337
2023-06-23,"2 - 1066",47,58,47,0,11,1
2023-06-23,"82 - 1163",148,148,147,1,0,0.993243243243243
2023-06-24,"40 - 1320",205,207,205,0,2,1
2023-06-24,"40 - 1114",227,232,227,0,5,1
2023-06-24,"53 - 1103",186,186,186,0,0,1
2023-06-24,"2 - 1066",46,58,46,0,12,1
2023-06-24,"82 - 1163",148,148,148,0,0,1
2023-06-25,"40 - 1320",204,207,204,0,3,1
2023-06-25,"40 - 1114",227,232,227,0,5,1
2023-06-25,"53 - 1103",186,186,186,0,0,1
2023-06-25,"2 - 1066",46,58,46,0,12,1
2023-06-25,"82 - 1163",148,148,148,0,0,1
2023-06-26,"40 - 1320",205,207,205,0,2,1
2023-06-26,"40 - 1114",227,232,227,0,5,1
2023-06-26,"53 - 1103",187,186,187,0,-1,1
2023-06-26,"2 - 1066",47,58,47,0,11,1
2023-06-26,"82 - 1163",147,148,147,0,1,1
2023-06-27,"40 - 1320",205,207,205,0,2,1
2023-06-27,"40 - 1114",226,232,225,1,6,0.995575221238938
2023-06-27,"53 - 1103",187,186,187,0,-1,1
2023-06-27,"2 - 1066",48,58,47,1,10,0.979166666666667
2023-06-27,"82 - 1163",146,148,146,0,2,1
2023-06-28,"40 - 1320",204,207,204,0,3,1
2023-06-28,"40 - 1114",229,232,228,1,3,0.995633187772926
2023-06-28,"53 - 1103",186,186,186,0,0,1
2023-06-28,"2 - 1066",49,58,47,2,9,0.959183673469388
2023-06-28,"82 - 1163",147,148,147,0,1,1
2023-06-29,"40 - 1320",204,207,204,0,3,1
2023-06-29,"40 - 1114",229,232,229,0,3,1
2023-06-29,"53 - 1103",184,186,182,2,2,0.989130434782609
2023-06-29,"2 - 1066",49,58,49,0,9,1
2023-06-29,"82 - 1163",147,148,147,0,1,1
2023-06-30,"40 - 1320",204,207,204,0,3,1
2023-06-30,"40 - 1114",229,232,229,0,3,1
2023-06-30,"53 - 1103",186,186,184,2,0,0.989247311827957
2023-06-30,"2 - 1066",49,58,49,0,9,1
2023-06-30,"82 - 1163",147,148,147,0,1,1
2023-07-01,"40 - 1320",204,207,204,0,3,1
2023-07-01,"40 - 1114",227,232,227,0,5,1
2023-07-01,"53 - 1103",186,186,184,2,0,0.989247311827957
2023-07-01,"2 - 1066",48,58,48,0,10,1
2023-07-01,"82 - 1163",146,148,146,0,2,1
2023-07-02,"40 - 1320",205,207,205,0,2,1
2023-07-02,"40 - 1114",228,232,228,0,4,1
2023-07-02,"53 - 1103",186,186,184,2,0,0.989247311827957
2023-07-02,"2 - 1066",48,58,48,0,10,1
2023-07-02,"82 - 1163",146,148,145,1,2,0.993150684931507
2023-07-03,"40 - 1320",205,207,205,0,2,1
2023-07-03,"40 - 1114",228,232,228,0,4,1
2023-07-03,"53 - 1103",186,186,184,2,0,0.989247311827957
2023-07-03,"2 - 1066",49,58,49,0,9,1
2023-07-03,"82 - 1163",143,148,143,0,5,1
2023-07-04,"40 - 1320",204,207,204,0,3,1
2023-07-04,"40 - 1114",228,232,228,0,4,1
2023-07-04,"53 - 1103",186,186,185,1,0,0.994623655913978
2023-07-04,"2 - 1066",49,58,49,0,9,1
2023-07-04,"82 - 1163",143,148,143,0,5,1
2023-07-05,"40 - 1320",205,207,205,0,2,1
2023-07-05,"40 - 1114",228,232,228,0,4,1
2023-07-05,"53 - 1103",186,186,185,1,0,0.994623655913978
2023-07-05,"2 - 1066",49,58,49,0,9,1
2023-07-05,"82 - 1163",142,148,142,0,6,1
2023-07-06,"40 - 1320",205,207,205,0,2,1
2023-07-06,"40 - 1114",229,232,229,0,3,1
2023-07-06,"53 - 1103",186,186,185,1,0,0.994623655913978
2023-07-06,"2 - 1066",49,58,49,0,9,1
2023-07-06,"82 - 1163",144,148,144,0,4,1
2023-07-07,"40 - 1320",206,207,206,0,1,1
2023-07-07,"40 - 1114",226,232,226,0,6,1
2023-07-07,"53 - 1103",185,186,185,0,1,1
2023-07-07,"2 - 1066",48,58,48,0,10,1
2023-07-07,"82 - 1163",141,134,141,0,-7,1
2023-07-08,"40 - 1320",207,207,207,0,0,1
2023-07-08,"40 - 1114",226,232,226,0,6,1
2023-07-08,"53 - 1103",184,186,184,0,2,1
2023-07-08,"2 - 1066",48,58,48,0,10,1
2023-07-08,"82 - 1163",141,148,140,1,7,0.99290780141844
2023-07-09,"40 - 1320",207,207,207,0,0,1
2023-07-09,"40 - 1114",226,232,226,0,6,1
2023-07-09,"53 - 1103",186,186,186,0,0,1
2023-07-09,"2 - 1066",48,58,48,0,10,1
2023-07-09,"82 - 1163",140,148,140,0,8,1
2023-07-10,"40 - 1320",207,207,207,0,0,1
2023-07-10,"40 - 1114",226,232,225,1,6,0.995575221238938
2023-07-10,"53 - 1103",187,186,187,0,-1,1
2023-07-10,"2 - 1066",48,58,48,0,10,1
2023-07-10,"82 - 1163",143,148,143,0,5,1
2023-07-11,"40 - 1320",207,207,207,0,0,1
2023-07-11,"40 - 1114",228,232,228,0,4,1
2023-07-11,"53 - 1103",186,186,186,0,0,1
2023-07-11,"2 - 1066",48,58,48,0,10,1
2023-07-11,"82 - 1163",151,148,150,1,-3,0.993377483443709
2023-07-12,"40 - 1320",207,207,206,1,0,0.995169082125604
2023-07-12,"40 - 1114",230,232,229,1,2,0.995652173913044
2023-07-12,"53 - 1103",187,186,187,0,-1,1
2023-07-12,"2 - 1066",48,58,48,0,10,1
2023-07-12,"82 - 1163",150,148,150,0,-2,1
2023-07-13,"40 - 1320",207,207,206,1,0,0.995169082125604
2023-07-13,"40 - 1114",231,232,230,1,1,0.995670995670996
2023-07-13,"53 - 1103",186,186,186,0,0,1
2023-07-13,"2 - 1066",48,58,48,0,10,1
2023-07-13,"82 - 1163",150,148,150,0,-2,1
2023-07-14,"40 - 1320",207,207,206,1,0,0.995169082125604
2023-07-14,"40 - 1114",230,232,229,1,2,0.995652173913044
2023-07-14,"53 - 1103",187,186,187,0,-1,1
2023-07-14,"2 - 1066",48,58,48,0,10,1
2023-07-14,"82 - 1163",151,148,151,0,-3,1
2023-07-15,"40 - 1320",206,207,206,0,1,1
2023-07-15,"40 - 1114",231,232,230,1,1,0.995670995670996
2023-07-15,"53 - 1103",186,186,186,0,0,1
2023-07-15,"2 - 1066",47,58,47,0,11,1
2023-07-15,"82 - 1163",151,148,151,0,-3,1
2023-07-16,"40 - 1320",206,207,206,0,1,1
2023-07-16,"40 - 1114",231,232,230,1,1,0.995670995670996
2023-07-16,"53 - 1103",186,186,186,0,0,1
2023-07-16,"2 - 1066",47,58,47,0,11,1
2023-07-16,"82 - 1163",148,148,148,0,0,1
2023-07-17,"40 - 1320",207,207,206,1,0,0.995169082125604
2023-07-17,"40 - 1114",231,232,231,0,1,1
2023-07-17,"53 - 1103",185,186,185,0,1,1
2023-07-17,"2 - 1066",47,58,47,0,11,1
2023-07-17,"82 - 1163",147,148,147,0,1,1
2023-07-18,"40 - 1320",207,207,206,1,0,0.995169082125604
2023-07-18,"40 - 1114",232,232,232,0,0,1
2023-07-18,"53 - 1103",187,186,187,0,-1,1
2023-07-18,"2 - 1066",47,58,47,0,11,1
2023-07-18,"82 - 1163",146,148,145,1,2,0.993150684931507
2023-07-19,"40 - 1320",207,207,207,0,0,1
2023-07-19,"40 - 1114",232,232,232,0,0,1
2023-07-19,"53 - 1103",187,186,187,0,-1,1
2023-07-19,"2 - 1066",47,58,47,0,11,1
2023-07-19,"82 - 1163",146,148,146,0,2,1
2023-07-20,"40 - 1320",208,207,208,0,-1,1
2023-07-20,"40 - 1114",232,232,231,1,0,0.995689655172414
2023-07-20,"53 - 1103",187,186,187,0,-1,1
2023-07-20,"2 - 1066",47,58,47,0,11,1
2023-07-20,"82 - 1163",147,148,147,0,1,1
2023-07-21,"40 - 1320",207,207,207,0,0,1
2023-07-21,"40 - 1114",230,232,230,0,2,1
2023-07-21,"53 - 1103",187,186,187,0,-1,1
2023-07-21,"2 - 1066",47,58,47,0,11,1
2023-07-21,"82 - 1163",151,148,151,0,-3,1
2023-07-22,"40 - 1320",207,207,207,0,0,1
2023-07-22,"40 - 1114",230,232,230,0,2,1
2023-07-22,"53 - 1103",187,186,187,0,-1,1
2023-07-22,"2 - 1066",47,58,47,0,11,1
2023-07-22,"82 - 1163",151,148,151,0,-3,1
2023-07-23,"40 - 1320",207,207,207,0,0,1
2023-07-23,"40 - 1114",230,232,230,0,2,1
2023-07-23,"53 - 1103",187,186,187,0,-1,1
2023-07-23,"2 - 1066",47,58,47,0,11,1
2023-07-23,"82 - 1163",151,148,151,0,-3,1
2023-07-24,"40 - 1320",208,207,207,1,-1,0.995192307692308
2023-07-24,"40 - 1114",230,232,230,0,2,1
2023-07-24,"53 - 1103",187,186,187,0,-1,1
2023-07-24,"2 - 1066",47,58,47,0,11,1
2023-07-24,"82 - 1163",151,148,151,0,-3,1
2023-07-25,"40 - 1320",208,207,207,1,-1,0.995192307692308
2023-07-25,"40 - 1114",230,232,230,0,2,1
2023-07-25,"53 - 1103",187,186,187,0,-1,1
2023-07-25,"2 - 1066",47,58,47,0,11,1
2023-07-25,"82 - 1163",151,148,151,0,-3,1
2023-07-26,"40 - 1320",208,207,207,1,-1,0.995192307692308
2023-07-26,"40 - 1114",230,232,230,0,2,1
2023-07-26,"53 - 1103",185,186,185,0,1,1
2023-07-26,"2 - 1066",47,58,47,0,11,1
2023-07-26,"82 - 1163",147,148,147,0,1,1
2023-07-27,"40 - 1320",207,207,207,0,0,1
2023-07-27,"40 - 1114",230,232,230,0,2,1
2023-07-27,"53 - 1103",186,186,184,2,0,0.989247311827957
2023-07-27,"2 - 1066",47,58,47,0,11,1
2023-07-27,"82 - 1163",148,148,148,0,0,1
2023-07-28,"40 - 1320",207,207,207,0,0,1
2023-07-28,"40 - 1114",230,232,230,0,2,1
2023-07-28,"53 - 1103",186,186,184,2,0,0.989247311827957
2023-07-28,"2 - 1066",47,58,47,0,11,1
2023-07-28,"82 - 1163",149,148,149,0,-1,1
2023-07-29,"40 - 1320",207,207,207,0,0,1
2023-07-29,"40 - 1114",229,232,229,0,3,1
2023-07-29,"53 - 1103",184,186,184,0,2,1
2023-07-29,"2 - 1066",47,58,47,0,11,1
2023-07-29,"82 - 1163",149,148,149,0,-1,1
2023-07-30,"40 - 1320",207,207,207,0,0,1
2023-07-30,"40 - 1114",229,232,229,0,3,1
2023-07-30,"53 - 1103",183,186,182,1,3,0.994535519125683
2023-07-30,"2 - 1066",48,58,47,1,10,0.979166666666667
2023-07-30,"82 - 1163",147,148,147,0,1,1
2023-07-31,"40 - 1320",208,207,208,0,-1,1
2023-07-31,"40 - 1114",230,232,230,0,2,1
2023-07-31,"53 - 1103",182,186,180,2,4,0.989010989010989
2023-07-31,"2 - 1066",48,58,48,0,10,1
2023-07-31,"82 - 1163",148,148,148,0,0,1
2023-08-01,"40 - 1320",208,207,208,0,-1,1
2023-08-01,"40 - 1114",230,232,229,1,2,0.995652173913044
2023-08-01,"53 - 1103",184,186,183,1,2,0.994565217391304
2023-08-01,"2 - 1066",48,58,48,0,10,1
2023-08-01,"82 - 1163",149,148,149,0,-1,1
2023-08-02,"40 - 1320",208,207,208,0,-1,1
2023-08-02,"40 - 1114",230,232,229,1,2,0.995652173913044
2023-08-02,"53 - 1103",183,186,181,2,3,0.989071038251366
2023-08-02,"2 - 1066",48,58,48,0,10,1
2023-08-02,"82 - 1163",149,148,148,1,-1,0.993288590604027
2023-08-03,"40 - 1320",208,207,208,0,-1,1
2023-08-03,"40 - 1114",230,232,229,1,2,0.995652173913044
2023-08-03,"53 - 1103",186,186,185,1,0,0.994623655913978
2023-08-03,"2 - 1066",47,58,47,0,11,1
2023-08-03,"82 - 1163",148,148,148,0,0,1
2023-08-04,"40 - 1320",208,207,208,0,-1,1
2023-08-04,"40 - 1114",230,232,228,2,2,0.991304347826087
2023-08-04,"53 - 1103",184,186,184,0,2,1
2023-08-04,"2 - 1066",46,58,46,0,12,1
2023-08-04,"82 - 1163",147,148,147,0,1,1
2023-08-05,"40 - 1320",207,207,207,0,0,1
2023-08-05,"40 - 1114",229,232,229,0,3,1
2023-08-05,"53 - 1103",184,186,184,0,2,1
2023-08-05,"2 - 1066",45,58,45,0,13,1
2023-08-05,"82 - 1163",147,148,147,0,1,1
2023-08-06,"40 - 1320",208,207,208,0,-1,1
2023-08-06,"40 - 1114",229,232,228,1,3,0.995633187772926
2023-08-06,"53 - 1103",185,186,185,0,1,1
2023-08-06,"2 - 1066",45,58,45,0,13,1
2023-08-06,"82 - 1163",142,148,142,0,6,1
2023-08-07,"40 - 1320",208,207,208,0,-1,1
2023-08-07,"40 - 1114",229,232,228,1,3,0.995633187772926
2023-08-07,"53 - 1103",185,186,185,0,1,1
2023-08-07,"2 - 1066",44,58,44,0,14,1
2023-08-07,"82 - 1163",143,148,143,0,5,1
2023-08-08,"40 - 1320",208,207,208,0,-1,1
2023-08-08,"40 - 1114",229,232,228,1,3,0.995633187772926
2023-08-08,"53 - 1103",184,186,182,2,2,0.989130434782609
2023-08-08,"2 - 1066",44,58,44,0,14,1
2023-08-08,"82 - 1163",141,148,141,0,7,1
2023-08-09,"40 - 1320",207,207,207,0,0,1
2023-08-09,"40 - 1114",228,232,228,0,4,1
2023-08-09,"53 - 1103",184,186,184,0,2,1
2023-08-09,"2 - 1066",46,58,44,2,12,0.956521739130435
2023-08-09,"82 - 1163",144,148,144,0,4,1
2023-08-10,"40 - 1320",208,207,207,1,-1,0.995192307692308
2023-08-10,"40 - 1114",229,231,229,0,2,1
2023-08-10,"53 - 1103",184,186,184,0,2,1
2023-08-10,"2 - 1066",45,58,43,2,13,0.955555555555556
2023-08-10,"82 - 1163",148,148,148,0,0,1
2023-08-11,"40 - 1320",207,207,207,0,0,1
2023-08-11,"40 - 1114",230,232,228,2,2,0.991304347826087
2023-08-11,"53 - 1103",184,186,183,1,2,0.994565217391304
2023-08-11,"2 - 1066",46,58,44,2,12,0.956521739130435
2023-08-11,"82 - 1163",150,148,150,0,-2,1
2023-08-12,"40 - 1320",208,207,208,0,-1,1
2023-08-12,"40 - 1114",227,232,227,0,5,1
2023-08-12,"53 - 1103",184,186,182,2,2,0.989130434782609
2023-08-12,"2 - 1066",46,58,45,1,12,0.978260869565217
2023-08-12,"82 - 1163",148,148,147,1,0,0.993243243243243
2023-08-13,"40 - 1320",208,207,208,0,-1,1
2023-08-13,"40 - 1114",227,232,227,0,5,1
2023-08-13,"53 - 1103",184,186,182,2,2,0.989130434782609
2023-08-13,"2 - 1066",46,58,45,1,12,0.978260869565217
2023-08-13,"82 - 1163",147,148,147,0,1,1
2023-08-14,"40 - 1320",208,207,208,0,-1,1
2023-08-14,"40 - 1114",227,232,226,1,5,0.995594713656388
2023-08-14,"53 - 1103",184,186,182,2,2,0.989130434782609
2023-08-14,"2 - 1066",46,58,46,0,12,1
2023-08-14,"82 - 1163",148,148,148,0,0,1
2023-08-15,"40 - 1320",208,207,208,0,-1,1
2023-08-15,"40 - 1114",227,232,227,0,5,1
2023-08-15,"53 - 1103",185,186,185,0,1,1
2023-08-15,"2 - 1066",46,58,46,0,12,1
2023-08-15,"82 - 1163",147,148,147,0,1,1
2023-08-16,"40 - 1320",208,207,208,0,-1,1
2023-08-16,"40 - 1114",229,232,229,0,3,1
2023-08-16,"53 - 1103",186,186,186,0,0,1
2023-08-16,"2 - 1066",46,58,46,0,12,1
2023-08-16,"82 - 1163",144,148,144,0,4,1
2023-08-17,"40 - 1320",208,207,208,0,-1,1
2023-08-17,"40 - 1114",229,232,228,1,3,0.995633187772926
2023-08-17,"53 - 1103",186,186,186,0,0,1
2023-08-17,"2 - 1066",46,58,46,0,12,1
2023-08-17,"82 - 1163",144,148,144,0,4,1
2023-08-18,"40 - 1320",208,207,208,0,-1,1
2023-08-18,"40 - 1114",228,232,228,0,4,1
2023-08-18,"53 - 1103",186,186,186,0,0,1
2023-08-18,"2 - 1066",46,58,46,0,12,1
2023-08-18,"82 - 1163",147,148,147,0,1,1
2023-08-19,"40 - 1320",208,207,208,0,-1,1
2023-08-19,"40 - 1114",228,232,228,0,4,1
2023-08-19,"53 - 1103",186,186,186,0,0,1
2023-08-19,"2 - 1066",46,58,46,0,12,1
2023-08-19,"82 - 1163",146,148,145,1,2,0.993150684931507
2023-08-20,"40 - 1320",208,207,208,0,-1,1
2023-08-20,"40 - 1114",228,232,228,0,4,1
2023-08-20,"53 - 1103",186,186,186,0,0,1
2023-08-20,"2 - 1066",45,58,45,0,13,1
2023-08-20,"82 - 1163",145,148,145,0,3,1
2023-08-21,"40 - 1320",208,207,208,0,-1,1
2023-08-21,"40 - 1114",230,232,230,0,2,1
2023-08-21,"53 - 1103",186,186,185,1,0,0.994623655913978
2023-08-21,"2 - 1066",45,58,45,0,13,1
2023-08-21,"82 - 1163",147,148,147,0,1,1
2023-08-22,"40 - 1320",208,207,208,0,-1,1
2023-08-22,"40 - 1114",230,232,230,0,2,1
2023-08-22,"53 - 1103",185,186,184,1,1,0.994594594594595
2023-08-22,"2 - 1066",45,58,45,0,13,1
2023-08-22,"82 - 1163",144,148,144,0,4,1
2023-08-23,"40 - 1320",208,207,208,0,-1,1
2023-08-23,"40 - 1114",230,232,230,0,2,1
2023-08-23,"53 - 1103",185,186,184,1,1,0.994594594594595
2023-08-23,"2 - 1066",44,58,44,0,14,1
2023-08-23,"82 - 1163",145,148,145,0,3,1
2023-08-24,"40 - 1320",208,207,208,0,-1,1
2023-08-24,"40 - 1114",230,232,230,0,2,1
2023-08-24,"53 - 1103",183,186,183,0,3,1
2023-08-24,"2 - 1066",44,58,44,0,14,1
2023-08-24,"82 - 1163",143,148,143,0,5,1
2023-08-25,"40 - 1320",208,207,207,1,-1,0.995192307692308
2023-08-25,"40 - 1114",231,232,230,1,1,0.995670995670996
2023-08-25,"53 - 1103",184,186,184,0,2,1
2023-08-25,"2 - 1066",44,58,44,0,14,1
2023-08-25,"82 - 1163",145,148,145,0,3,1
2023-08-26,"40 - 1320",208,207,207,1,-1,0.995192307692308
2023-08-26,"40 - 1114",231,232,230,1,1,0.995670995670996
2023-08-26,"53 - 1103",184,186,183,1,2,0.994565217391304
2023-08-26,"2 - 1066",44,58,44,0,14,1
2023-08-26,"82 - 1163",146,148,146,0,2,1
2023-08-27,"40 - 1320",208,207,207,1,-1,0.995192307692308
2023-08-27,"40 - 1114",231,232,230,1,1,0.995670995670996
2023-08-27,"53 - 1103",184,186,183,1,2,0.994565217391304
2023-08-27,"2 - 1066",44,58,44,0,14,1
2023-08-27,"82 - 1163",145,148,145,0,3,1
2023-08-28,"40 - 1320",207,207,207,0,0,1
2023-08-28,"40 - 1114",230,232,230,0,2,1
2023-08-28,"53 - 1103",183,186,182,1,3,0.994535519125683
2023-08-28,"2 - 1066",44,58,44,0,14,1
2023-08-28,"82 - 1163",143,148,143,0,5,1
2023-08-29,"40 - 1320",207,207,207,0,0,1
2023-08-29,"40 - 1114",231,232,231,0,1,1
2023-08-29,"53 - 1103",184,186,184,0,2,1
2023-08-29,"2 - 1066",44,58,44,0,14,1
2023-08-29,"82 - 1163",143,148,143,0,5,1
2023-08-30,"40 - 1320",207,207,207,0,0,1
2023-08-30,"40 - 1114",232,232,231,1,0,0.995689655172414
2023-08-30,"53 - 1103",185,186,185,0,1,1
2023-08-30,"2 - 1066",43,58,43,0,15,1
2023-08-30,"82 - 1163",144,148,144,0,4,1
2023-08-31,"40 - 1320",207,207,207,0,0,1
2023-08-31,"40 - 1114",231,232,231,0,1,1
2023-08-31,"53 - 1103",184,186,184,0,2,1
2023-08-31,"2 - 1066",44,58,44,0,14,1
2023-08-31,"82 - 1163",141,148,141,0,7,1
2023-09-01,"40 - 1320",207,207,207,0,0,1
2023-09-01,"40 - 1114",229,232,229,0,3,1
2023-09-01,"53 - 1103",183,186,183,0,3,1
2023-09-01,"2 - 1066",45,58,44,1,13,0.977777777777778
2023-09-01,"82 - 1163",140,148,140,0,8,1
2023-09-02,"40 - 1320",206,207,206,0,1,1
2023-09-02,"40 - 1114",229,232,229,0,3,1
2023-09-02,"53 - 1103",183,186,183,0,3,1
2023-09-02,"2 - 1066",45,58,45,0,13,1
2023-09-02,"82 - 1163",140,148,140,0,8,1
2023-09-03,"40 - 1320",207,207,207,0,0,1
2023-09-03,"40 - 1114",229,232,229,0,3,1
2023-09-03,"53 - 1103",183,186,183,0,3,1
2023-09-03,"2 - 1066",45,58,45,0,13,1
2023-09-03,"82 - 1163",141,148,141,0,7,1
2023-09-04,"40 - 1320",207,207,207,0,0,1
2023-09-04,"40 - 1114",229,232,229,0,3,1
2023-09-04,"53 - 1103",183,186,183,0,3,1
2023-09-04,"2 - 1066",45,58,45,0,13,1
2023-09-04,"82 - 1163",141,148,141,0,7,1
2023-09-05,"40 - 1320",207,207,207,0,0,1
2023-09-05,"40 - 1114",229,232,227,2,3,0.991266375545852
2023-09-05,"53 - 1103",183,186,181,2,3,0.989071038251366
2023-09-05,"2 - 1066",45,58,45,0,13,1
2023-09-05,"82 - 1163",144,148,142,2,4,0.986111111111111
2023-09-06,"40 - 1320",207,207,207,0,0,1
2023-09-06,"40 - 1114",229,232,228,1,3,0.995633187772926
2023-09-06,"53 - 1103",183,186,181,2,3,0.989071038251366
2023-09-06,"2 - 1066",47,58,46,1,11,0.978723404255319
2023-09-06,"82 - 1163",145,148,145,0,3,1
2023-09-07,"40 - 1320",207,207,207,0,0,1
2023-09-07,"40 - 1114",228,232,227,1,4,0.995614035087719
2023-09-07,"53 - 1103",182,186,180,2,4,0.989010989010989
2023-09-07,"2 - 1066",48,58,47,1,10,0.979166666666667
2023-09-07,"82 - 1163",145,148,145,0,3,1
2023-09-08,"40 - 1320",207,207,207,0,0,1
2023-09-08,"40 - 1114",227,232,226,1,5,0.995594713656388
2023-09-08,"53 - 1103",181,186,179,2,5,0.988950276243094
2023-09-08,"2 - 1066",48,58,48,0,10,1
2023-09-08,"82 - 1163",147,148,147,0,1,1
2023-09-09,"40 - 1320",206,207,206,0,1,1
2023-09-09,"40 - 1114",227,232,227,0,5,1
2023-09-09,"53 - 1103",179,186,178,1,7,0.994413407821229
2023-09-09,"2 - 1066",47,58,47,0,11,1
2023-09-09,"82 - 1163",146,148,146,0,2,1
2023-09-10,"40 - 1320",207,207,207,0,0,1
2023-09-10,"40 - 1114",228,232,228,0,4,1
2023-09-10,"53 - 1103",179,186,178,1,7,0.994413407821229
2023-09-10,"2 - 1066",48,58,48,0,10,1
2023-09-10,"82 - 1163",145,148,145,0,3,1
2023-09-11,"40 - 1320",207,207,207,0,0,1
2023-09-11,"40 - 1114",230,231,229,1,1,0.995652173913044
2023-09-11,"53 - 1103",179,186,179,0,7,1
2023-09-11,"2 - 1066",48,58,48,0,10,1
2023-09-11,"82 - 1163",144,148,144,0,4,1
2023-09-12,"40 - 1320",207,207,207,0,0,1
2023-09-12,"40 - 1114",227,231,226,1,4,0.995594713656388
2023-09-12,"53 - 1103",180,186,180,0,6,1
2023-09-12,"2 - 1066",47,58,47,0,11,1
2023-09-12,"82 - 1163",146,148,146,0,2,1
2023-09-13,"40 - 1320",207,207,207,0,0,1
2023-09-13,"40 - 1114",227,231,227,0,4,1
2023-09-13,"53 - 1103",182,186,181,1,4,0.994505494505495
2023-09-13,"2 - 1066",45,58,45,0,13,1
2023-09-13,"82 - 1163",147,148,147,0,1,1
2023-09-14,"40 - 1320",207,207,207,0,0,1
2023-09-14,"40 - 1114",227,231,226,1,4,0.995594713656388
2023-09-14,"53 - 1103",183,186,182,1,3,0.994535519125683
2023-09-14,"2 - 1066",45,58,45,0,13,1
2023-09-14,"82 - 1163",147,148,147,0,1,1
2023-09-15,"40 - 1320",205,207,205,0,2,1
2023-09-15,"40 - 1114",228,231,227,1,3,0.995614035087719
2023-09-15,"53 - 1103",184,186,184,0,2,1
2023-09-15,"2 - 1066",45,58,45,0,13,1
2023-09-15,"82 - 1163",153,148,153,0,-5,1
2023-09-16,"40 - 1320",205,207,205,0,2,1
2023-09-16,"40 - 1114",228,231,227,1,3,0.995614035087719
2023-09-16,"53 - 1103",184,186,184,0,2,1
2023-09-16,"2 - 1066",45,58,45,0,13,1
2023-09-16,"82 - 1163",152,148,152,0,-4,1
2023-09-17,"40 - 1320",206,207,206,0,1,1
2023-09-17,"40 - 1114",226,231,226,0,5,1
2023-09-17,"53 - 1103",184,186,184,0,2,1
2023-09-17,"2 - 1066",48,58,48,0,10,1
2023-09-17,"82 - 1163",149,148,149,0,-1,1
2023-09-18,"40 - 1320",206,207,205,1,1,0.995145631067961
2023-09-18,"40 - 1114",229,232,229,0,3,1
2023-09-18,"53 - 1103",183,186,183,0,3,1
2023-09-18,"2 - 1066",48,58,48,0,10,1
2023-09-18,"82 - 1163",155,148,155,0,-7,1
2023-09-19,"40 - 1320",207,207,206,1,0,0.995169082125604
2023-09-19,"40 - 1114",229,232,229,0,3,1
2023-09-19,"53 - 1103",183,186,182,1,3,0.994535519125683
2023-09-19,"2 - 1066",48,58,48,0,10,1
2023-09-19,"82 - 1163",159,148,159,0,-11,1
2023-09-20,"40 - 1320",207,207,207,0,0,1
2023-09-20,"40 - 1114",229,232,229,0,3,1
2023-09-20,"53 - 1103",183,186,182,1,3,0.994535519125683
2023-09-20,"2 - 1066",47,58,47,0,11,1
2023-09-20,"82 - 1163",163,148,163,0,-15,1
2023-09-21,"40 - 1320",207,207,207,0,0,1
2023-09-21,"40 - 1114",229,232,229,0,3,1
2023-09-21,"53 - 1103",184,186,182,2,2,0.989130434782609
2023-09-21,"2 - 1066",47,58,47,0,11,1
2023-09-21,"82 - 1163",163,148,163,0,-15,1
2023-09-22,"40 - 1320",206,207,206,0,1,1
2023-09-22,"40 - 1114",229,232,228,1,3,0.995633187772926
2023-09-22,"53 - 1103",182,186,182,0,4,1
2023-09-22,"2 - 1066",48,58,48,0,10,1
2023-09-22,"82 - 1163",163,148,163,0,-15,1
2023-09-23,"40 - 1320",206,207,206,0,1,1
2023-09-23,"40 - 1114",228,232,228,0,4,1
2023-09-23,"53 - 1103",182,186,182,0,4,1
2023-09-23,"2 - 1066",48,58,48,0,10,1
2023-09-23,"82 - 1163",160,148,160,0,-12,1
2023-09-24,"40 - 1320",206,207,206,0,1,1
2023-09-24,"40 - 1114",228,232,228,0,4,1
2023-09-24,"53 - 1103",183,186,183,0,3,1
2023-09-24,"2 - 1066",48,58,48,0,10,1
2023-09-24,"82 - 1163",161,148,161,0,-13,1
2023-09-25,"40 - 1320",206,207,206,0,1,1
2023-09-25,"40 - 1114",228,232,228,0,4,1
2023-09-25,"53 - 1103",185,186,184,1,1,0.994594594594595
2023-09-25,"2 - 1066",48,58,48,0,10,1
2023-09-25,"82 - 1163",164,148,164,0,-16,1
2023-09-26,"40 - 1320",207,207,206,1,0,0.995169082125604
2023-09-26,"40 - 1114",228,232,228,0,4,1
2023-09-26,"53 - 1103",185,186,184,1,1,0.994594594594595
2023-09-26,"2 - 1066",48,58,48,0,10,1
2023-09-26,"82 - 1163",164,148,164,0,-16,1
2023-09-27,"40 - 1320",207,207,207,0,0,1
2023-09-27,"40 - 1114",229,232,227,2,3,0.991266375545852
2023-09-27,"53 - 1103",185,186,185,0,1,1
2023-09-27,"2 - 1066",48,58,48,0,10,1
2023-09-27,"82 - 1163",165,148,165,0,-17,1
2023-09-28,"40 - 1320",208,207,207,1,-1,0.995192307692308
2023-09-28,"40 - 1114",227,232,227,0,5,1
2023-09-28,"53 - 1103",185,186,185,0,1,1
2023-09-28,"2 - 1066",48,58,48,0,10,1
2023-09-28,"82 - 1163",162,148,162,0,-14,1
2023-09-29,"40 - 1320",208,207,208,0,-1,1
2023-09-29,"40 - 1114",228,232,228,0,4,1
2023-09-29,"53 - 1103",185,186,185,0,1,1
2023-09-29,"2 - 1066",47,58,47,0,11,1
2023-09-29,"82 - 1163",167,148,167,0,-19,1
2023-09-30,"40 - 1320",207,207,207,0,0,1
2023-09-30,"40 - 1114",228,232,228,0,4,1
2023-09-30,"53 - 1103",185,186,185,0,1,1
2023-09-30,"2 - 1066",47,58,47,0,11,1
2023-09-30,"82 - 1163",166,148,166,0,-18,1
2023-10-01,"40 - 1320",207,207,207,0,0,1
2023-10-01,"40 - 1114",228,232,227,1,4,0.995614035087719
2023-10-01,"53 - 1103",183,186,183,0,3,1
2023-10-01,"2 - 1066",47,58,47,0,11,1
2023-10-01,"82 - 1163",165,148,165,0,-17,1
2023-10-02,"40 - 1320",207,207,207,0,0,1
2023-10-02,"40 - 1114",227,232,225,2,5,0.991189427312775
2023-10-02,"53 - 1103",184,186,184,0,2,1
2023-10-02,"2 - 1066",46,40,46,0,-6,1
2023-10-02,"82 - 1163",164,148,164,0,-16,1
2023-10-03,"40 - 1320",208,207,208,0,-1,1
2023-10-03,"40 - 1114",222,232,222,0,10,1
2023-10-03,"53 - 1103",183,186,183,0,3,1
2023-10-03,"2 - 1066",46,40,46,0,-6,1
2023-10-03,"82 - 1163",162,148,162,0,-14,1
2023-10-04,"40 - 1320",208,207,208,0,-1,1
2023-10-04,"40 - 1114",222,232,222,0,10,1
2023-10-04,"53 - 1103",186,186,185,1,0,0.994623655913978
2023-10-04,"2 - 1066",46,40,46,0,-6,1
2023-10-04,"82 - 1163",162,148,162,0,-14,1
2023-10-05,"40 - 1320",207,207,207,0,0,1
2023-10-05,"40 - 1114",223,232,222,1,9,0.995515695067265
2023-10-05,"53 - 1103",185,186,185,0,1,1
2023-10-05,"2 - 1066",46,40,46,0,-6,1
2023-10-05,"82 - 1163",162,148,162,0,-14,1
2023-10-06,"40 - 1320",207,207,207,0,0,1
2023-10-06,"40 - 1114",223,232,220,3,9,0.986547085201794
2023-10-06,"53 - 1103",185,186,185,0,1,1
2023-10-06,"2 - 1066",45,40,45,0,-5,1
2023-10-06,"82 - 1163",162,148,162,0,-14,1
2023-10-07,"40 - 1320",205,207,205,0,2,1
2023-10-07,"40 - 1114",218,232,218,0,14,1
2023-10-07,"53 - 1103",185,186,185,0,1,1
2023-10-07,"2 - 1066",45,40,45,0,-5,1
2023-10-07,"82 - 1163",162,148,161,1,-14,0.993827160493827
2023-10-08,"40 - 1320",206,207,206,0,1,1
2023-10-08,"40 - 1114",219,232,219,0,13,1
2023-10-08,"53 - 1103",185,186,185,0,1,1
2023-10-08,"2 - 1066",44,40,44,0,-4,1
2023-10-08,"82 - 1163",162,148,162,0,-14,1
2023-10-09,"40 - 1320",207,207,207,0,0,1
2023-10-09,"40 - 1114",220,232,220,0,12,1
2023-10-09,"53 - 1103",185,186,185,0,1,1
2023-10-09,"2 - 1066",44,40,44,0,-4,1
2023-10-09,"82 - 1163",160,148,160,0,-12,1
2023-10-10,"40 - 1320",207,207,207,0,0,1
2023-10-10,"40 - 1114",220,232,220,0,12,1
2023-10-10,"53 - 1103",184,186,184,0,2,1
2023-10-10,"2 - 1066",44,40,44,0,-4,1
2023-10-10,"82 - 1163",159,148,159,0,-11,1
2023-10-11,"40 - 1320",206,207,206,0,1,1
2023-10-11,"40 - 1114",222,232,222,0,10,1
2023-10-11,"53 - 1103",184,186,184,0,2,1
2023-10-11,"2 - 1066",45,40,45,0,-5,1
2023-10-11,"82 - 1163",160,148,160,0,-12,1
2023-10-12,"40 - 1320",205,207,203,2,2,0.990243902439024
2023-10-12,"40 - 1114",221,232,221,0,11,1
2023-10-12,"53 - 1103",185,186,184,1,1,0.994594594594595
2023-10-12,"2 - 1066",44,40,44,0,-4,1
2023-10-12,"82 - 1163",159,148,159,0,-11,1
2023-10-13,"40 - 1320",204,207,202,2,3,0.990196078431373
2023-10-13,"40 - 1114",222,232,219,3,10,0.986486486486487
2023-10-13,"53 - 1103",185,186,183,2,1,0.989189189189189
2023-10-13,"2 - 1066",44,40,44,0,-4,1
2023-10-13,"82 - 1163",160,148,160,0,-12,1
2023-10-14,"40 - 1320",200,207,200,0,7,1
2023-10-14,"40 - 1114",221,232,221,0,11,1
2023-10-14,"53 - 1103",185,186,183,2,1,0.989189189189189
2023-10-14,"2 - 1066",43,40,43,0,-3,1
2023-10-14,"82 - 1163",162,148,161,1,-14,0.993827160493827
2023-10-15,"40 - 1320",203,207,203,0,4,1
2023-10-15,"40 - 1114",222,232,222,0,10,1
2023-10-15,"53 - 1103",185,186,183,2,1,0.989189189189189
2023-10-15,"2 - 1066",43,40,43,0,-3,1
2023-10-15,"82 - 1163",160,148,160,0,-12,1
2023-10-16,"40 - 1320",205,207,205,0,2,1
2023-10-16,"40 - 1114",222,232,221,1,10,0.995495495495496
2023-10-16,"53 - 1103",185,186,184,1,1,0.994594594594595
2023-10-16,"2 - 1066",44,40,44,0,-4,1
2023-10-16,"82 - 1163",160,148,160,0,-12,1
2023-10-17,"40 - 1320",205,207,205,0,2,1
2023-10-17,"40 - 1114",223,232,223,0,9,1
2023-10-17,"53 - 1103",184,186,184,0,2,1
2023-10-17,"2 - 1066",44,40,44,0,-4,1
2023-10-17,"82 - 1163",161,148,160,1,-13,0.993788819875776
2023-10-18,"40 - 1320",207,207,205,2,0,0.990338164251208
2023-10-18,"40 - 1114",225,232,225,0,7,1
2023-10-18,"53 - 1103",184,186,184,0,2,1
2023-10-18,"2 - 1066",44,40,44,0,-4,1
2023-10-18,"82 - 1163",162,148,162,0,-14,1
2023-10-19,"40 - 1320",208,207,208,0,-1,1
2023-10-19,"40 - 1114",225,232,225,0,7,1
2023-10-19,"53 - 1103",184,186,184,0,2,1
2023-10-19,"2 - 1066",44,40,44,0,-4,1
2023-10-19,"82 - 1163",161,148,161,0,-13,1
2023-10-20,"40 - 1320",208,207,207,1,-1,0.995192307692308
2023-10-20,"40 - 1114",222,232,221,1,10,0.995495495495496
2023-10-20,"53 - 1103",184,186,184,0,2,1
2023-10-20,"2 - 1066",44,40,44,0,-4,1
2023-10-20,"82 - 1163",160,148,159,1,-12,0.99375
2023-10-21,"40 - 1320",207,207,207,0,0,1
2023-10-21,"40 - 1114",219,232,219,0,13,1
2023-10-21,"53 - 1103",186,186,186,0,0,1
2023-10-21,"2 - 1066",44,40,44,0,-4,1
2023-10-21,"82 - 1163",156,148,156,0,-8,1
2023-10-22,"40 - 1320",207,207,207,0,0,1
2023-10-22,"40 - 1114",220,232,220,0,12,1
2023-10-22,"53 - 1103",186,186,186,0,0,1
2023-10-22,"2 - 1066",44,40,44,0,-4,1
2023-10-22,"82 - 1163",156,148,156,0,-8,1
2023-10-23,"40 - 1320",207,207,207,0,0,1
2023-10-23,"40 - 1114",220,232,220,0,12,1
2023-10-23,"53 - 1103",186,186,186,0,0,1
2023-10-23,"2 - 1066",44,40,44,0,-4,1
2023-10-23,"82 - 1163",155,148,155,0,-7,1
2023-10-24,"40 - 1320",207,207,207,0,0,1
2023-10-24,"40 - 1114",221,232,221,0,11,1
2023-10-24,"53 - 1103",185,186,185,0,1,1
2023-10-24,"2 - 1066",44,40,44,0,-4,1
2023-10-24,"82 - 1163",157,148,157,0,-9,1
2023-10-25,"40 - 1320",207,207,207,0,0,1
2023-10-25,"40 - 1114",222,232,222,0,10,1
2023-10-25,"53 - 1103",185,186,185,0,1,1
2023-10-25,"2 - 1066",44,40,44,0,-4,1
2023-10-25,"82 - 1163",154,148,154,0,-6,1
2023-10-26,"40 - 1320",207,207,207,0,0,1
2023-10-26,"40 - 1114",222,232,222,0,10,1
2023-10-26,"53 - 1103",187,186,186,1,-1,0.994652406417112
2023-10-26,"2 - 1066",44,40,44,0,-4,1
2023-10-26,"82 - 1163",153,148,153,0,-5,1
2023-10-27,"40 - 1320",207,207,206,1,0,0.995169082125604
2023-10-27,"40 - 1114",221,232,221,0,11,1
2023-10-27,"53 - 1103",187,186,186,1,-1,0.994652406417112
2023-10-27,"2 - 1066",45,40,43,2,-5,0.955555555555556
2023-10-27,"82 - 1163",154,148,154,0,-6,1
2023-10-28,"40 - 1320",206,207,206,0,1,1
2023-10-28,"40 - 1114",221,232,221,0,11,1
2023-10-28,"53 - 1103",186,186,186,0,0,1
2023-10-28,"2 - 1066",44,40,42,2,-4,0.954545454545455
2023-10-28,"82 - 1163",156,148,155,1,-8,0.993589743589744
2023-10-29,"40 - 1320",206,207,206,0,1,1
2023-10-29,"40 - 1114",221,232,221,0,11,1
2023-10-29,"53 - 1103",186,186,186,0,0,1
2023-10-29,"2 - 1066",44,40,43,1,-4,0.977272727272727
2023-10-29,"82 - 1163",154,148,154,0,-6,1
2023-10-30,"40 - 1320",207,207,207,0,0,1
2023-10-30,"40 - 1114",221,232,221,0,11,1
2023-10-30,"53 - 1103",186,186,185,1,0,0.994623655913978
2023-10-30,"2 - 1066",44,40,44,0,-4,1
2023-10-30,"82 - 1163",155,148,154,1,-7,0.993548387096774
2023-10-31,"40 - 1320",207,207,207,0,0,1
2023-10-31,"40 - 1114",221,232,219,2,11,0.990950226244344
2023-10-31,"53 - 1103",187,186,187,0,-1,1
2023-10-31,"2 - 1066",44,40,44,0,-4,1
2023-10-31,"82 - 1163",157,148,157,0,-9,1
2023-11-01,"40 - 1320",208,207,206,2,-1,0.990384615384615
2023-11-01,"40 - 1114",219,232,218,1,13,0.995433789954338
2023-11-01,"53 - 1103",185,186,185,0,1,1
2023-11-01,"2 - 1066",42,40,41,1,-2,0.976190476190476
2023-11-01,"82 - 1163",155,148,155,0,-7,1
2023-11-02,"40 - 1320",207,207,206,1,0,0.995169082125604
2023-11-02,"40 - 1114",217,232,217,0,15,1
2023-11-02,"53 - 1103",187,186,187,0,-1,1
2023-11-02,"2 - 1066",42,40,41,1,-2,0.976190476190476
2023-11-02,"82 - 1163",155,148,155,0,-7,1
2023-11-03,"40 - 1320",207,207,206,1,0,0.995169082125604
2023-11-03,"40 - 1114",215,232,215,0,17,1
2023-11-03,"53 - 1103",187,186,186,1,-1,0.994652406417112
2023-11-03,"2 - 1066",43,40,40,3,-3,0.930232558139535
2023-11-03,"82 - 1163",156,148,156,0,-8,1
2023-11-04,"40 - 1320",206,207,206,0,1,1
2023-11-04,"40 - 1114",214,232,214,0,18,1
2023-11-04,"53 - 1103",187,186,187,0,-1,1
2023-11-04,"2 - 1066",41,40,41,0,-1,1
2023-11-04,"82 - 1163",157,148,156,1,-9,0.993630573248408
2023-11-05,"40 - 1320",208,207,207,1,-1,0.995192307692308
2023-11-05,"40 - 1114",214,232,214,0,18,1
2023-11-05,"53 - 1103",186,186,186,0,0,1
2023-11-05,"2 - 1066",41,40,41,0,-1,1
2023-11-05,"82 - 1163",153,148,153,0,-5,1
2023-11-06,"40 - 1320",208,207,206,2,-1,0.990384615384615
2023-11-06,"40 - 1114",214,232,212,2,18,0.990654205607477
2023-11-06,"53 - 1103",185,186,185,0,1,1
2023-11-06,"2 - 1066",40,40,40,0,0,1
2023-11-06,"82 - 1163",149,148,149,0,-1,1
2023-11-07,"40 - 1320",207,207,205,2,0,0.990338164251208
2023-11-07,"40 - 1114",213,232,213,0,19,1
2023-11-07,"53 - 1103",185,186,185,0,1,1
2023-11-07,"2 - 1066",40,40,40,0,0,1
2023-11-07,"82 - 1163",151,148,151,0,-3,1
2023-11-08,"40 - 1320",207,207,203,4,0,0.980676328502415
2023-11-08,"40 - 1114",215,232,211,4,17,0.981395348837209
2023-11-08,"53 - 1103",184,186,184,0,2,1
2023-11-08,"2 - 1066",42,40,41,1,-2,0.976190476190476
2023-11-08,"82 - 1163",150,148,150,0,-2,1
2023-11-09,"40 - 1320",205,207,205,0,2,1
2023-11-09,"40 - 1114",217,232,215,2,15,0.990783410138249
2023-11-09,"53 - 1103",185,186,185,0,1,1
2023-11-09,"2 - 1066",42,40,42,0,-2,1
2023-11-09,"82 - 1163",150,148,150,0,-2,1
2023-11-10,"40 - 1320",207,207,205,2,0,0.990338164251208
2023-11-10,"40 - 1114",220,232,220,0,12,1
2023-11-10,"53 - 1103",185,186,185,0,1,1
2023-11-10,"2 - 1066",43,40,43,0,-3,1
2023-11-10,"82 - 1163",149,148,149,0,-1,1
2023-11-11,"40 - 1320",207,207,207,0,0,1
2023-11-11,"40 - 1114",223,232,223,0,9,1
2023-11-11,"53 - 1103",185,186,185,0,1,1
2023-11-11,"2 - 1066",43,40,43,0,-3,1
2023-11-11,"82 - 1163",150,148,150,0,-2,1
2023-11-12,"40 - 1320",207,207,207,0,0,1
2023-11-12,"40 - 1114",226,232,226,0,6,1
2023-11-12,"53 - 1103",184,186,184,0,2,1
2023-11-12,"2 - 1066",42,40,42,0,-2,1
2023-11-12,"82 - 1163",151,148,151,0,-3,1
2023-11-13,"40 - 1320",207,207,207,0,0,1
2023-11-13,"40 - 1114",224,232,224,0,8,1
2023-11-13,"53 - 1103",184,186,184,0,2,1
2023-11-13,"2 - 1066",43,40,42,1,-3,0.976744186046512
2023-11-13,"82 - 1163",154,148,154,0,-6,1
2023-11-14,"40 - 1320",208,207,207,1,-1,0.995192307692308
2023-11-14,"40 - 1114",226,232,226,0,6,1
2023-11-14,"53 - 1103",185,186,183,2,1,0.989189189189189
2023-11-14,"2 - 1066",43,40,42,1,-3,0.976744186046512
2023-11-14,"82 - 1163",154,148,154,0,-6,1
2023-11-15,"40 - 1320",208,207,208,0,-1,1
2023-11-15,"40 - 1114",224,232,223,1,8,0.995535714285714
2023-11-15,"53 - 1103",184,186,184,0,2,1
2023-11-15,"2 - 1066",43,40,43,0,-3,1
2023-11-15,"82 - 1163",155,148,155,0,-7,1
2023-11-16,"40 - 1320",208,207,208,0,-1,1
2023-11-16,"40 - 1114",226,232,225,1,6,0.995575221238938
2023-11-16,"53 - 1103",184,186,184,0,2,1
2023-11-16,"2 - 1066",45,40,44,1,-5,0.977777777777778
2023-11-16,"82 - 1163",159,148,159,0,-11,1
2023-11-17,"40 - 1320",208,207,206,2,-1,0.990384615384615
2023-11-17,"40 - 1114",227,232,227,0,5,1
2023-11-17,"53 - 1103",186,186,184,2,0,0.989247311827957
2023-11-17,"2 - 1066",45,40,45,0,-5,1
2023-11-17,"82 - 1163",158,148,158,0,-10,1
2023-11-18,"40 - 1320",207,207,207,0,0,1
2023-11-18,"40 - 1114",227,232,227,0,5,1
2023-11-18,"53 - 1103",186,186,185,1,0,0.994623655913978
2023-11-18,"2 - 1066",47,40,47,0,-7,1
2023-11-18,"82 - 1163",157,148,157,0,-9,1
2023-11-19,"40 - 1320",207,207,207,0,0,1
2023-11-19,"40 - 1114",228,232,228,0,4,1
2023-11-19,"53 - 1103",187,186,186,1,-1,0.994652406417112
2023-11-19,"2 - 1066",47,40,47,0,-7,1
2023-11-19,"82 - 1163",156,148,156,0,-8,1
2023-11-20,"40 - 1320",208,207,207,1,-1,0.995192307692308
2023-11-20,"40 - 1114",231,232,230,1,1,0.995670995670996
2023-11-20,"53 - 1103",185,186,185,0,1,1
2023-11-20,"2 - 1066",47,40,47,0,-7,1
2023-11-20,"82 - 1163",159,148,159,0,-11,1
2023-11-21,"40 - 1320",208,207,207,1,-1,0.995192307692308
2023-11-21,"40 - 1114",230,232,230,0,2,1
2023-11-21,"53 - 1103",185,186,185,0,1,1
2023-11-21,"2 - 1066",47,40,47,0,-7,1
2023-11-21,"82 - 1163",157,148,157,0,-9,1
2023-11-22,"40 - 1320",208,207,207,1,-1,0.995192307692308
2023-11-22,"40 - 1114",230,232,230,0,2,1
2023-11-22,"53 - 1103",185,186,183,2,1,0.989189189189189
2023-11-22,"2 - 1066",47,40,46,1,-7,0.978723404255319
2023-11-22,"82 - 1163",158,148,158,0,-10,1
2023-11-23,"40 - 1320",208,207,208,0,-1,1
2023-11-23,"40 - 1114",229,232,229,0,3,1
2023-11-23,"53 - 1103",185,186,183,2,1,0.989189189189189
2023-11-23,"2 - 1066",47,40,46,1,-7,0.978723404255319
2023-11-23,"82 - 1163",158,148,158,0,-10,1
2023-11-24,"40 - 1320",208,207,208,0,-1,1
2023-11-24,"40 - 1114",229,232,229,0,3,1
2023-11-24,"53 - 1103",183,186,183,0,3,1
2023-11-24,"2 - 1066",46,40,45,1,-6,0.978260869565217
2023-11-24,"82 - 1163",161,148,161,0,-13,1
2023-11-25,"40 - 1320",208,207,206,2,-1,0.990384615384615
2023-11-25,"40 - 1114",230,232,230,0,2,1
2023-11-25,"53 - 1103",184,186,184,0,2,1
2023-11-25,"2 - 1066",47,40,47,0,-7,1
2023-11-25,"82 - 1163",167,148,167,0,-19,1
2023-11-26,"40 - 1320",206,207,206,0,1,1
2023-11-26,"40 - 1114",230,232,230,0,2,1
2023-11-26,"53 - 1103",184,186,184,0,2,1
2023-11-26,"2 - 1066",46,40,46,0,-6,1
2023-11-26,"82 - 1163",163,148,163,0,-15,1
2023-11-27,"40 - 1320",206,207,206,0,1,1
2023-11-27,"40 - 1114",230,232,230,0,2,1
2023-11-27,"53 - 1103",184,186,181,3,2,0.983695652173913
2023-11-27,"2 - 1066",46,40,46,0,-6,1
2023-11-27,"82 - 1163",165,148,165,0,-17,1
2023-11-28,"40 - 1320",208,207,207,1,-1,0.995192307692308
2023-11-28,"40 - 1114",230,232,230,0,2,1
2023-11-28,"53 - 1103",182,186,182,0,4,1
2023-11-28,"2 - 1066",46,40,46,0,-6,1
2023-11-28,"82 - 1163",163,148,163,0,-15,1
2023-11-29,"40 - 1320",208,207,208,0,-1,1
2023-11-29,"40 - 1114",230,232,230,0,2,1
2023-11-29,"53 - 1103",182,186,182,0,4,1
2023-11-29,"2 - 1066",47,40,46,1,-7,0.978723404255319
2023-11-29,"82 - 1163",166,148,166,0,-18,1
2023-11-30,"40 - 1320",208,207,208,0,-1,1
2023-11-30,"40 - 1114",231,232,231,0,1,1
2023-11-30,"53 - 1103",183,186,183,0,3,1
2023-11-30,"2 - 1066",47,40,47,0,-7,1
2023-11-30,"82 - 1163",163,148,163,0,-15,1
2023-12-01,"40 - 1320",207,207,207,0,0,1
2023-12-01,"40 - 1114",230,232,229,1,2,0.995652173913044
2023-12-01,"53 - 1103",183,186,183,0,3,1
2023-12-01,"2 - 1066",45,40,45,0,-5,1
2023-12-01,"82 - 1163",159,148,159,0,-11,1
2023-12-02,"40 - 1320",208,207,208,0,-1,1
2023-12-02,"40 - 1114",229,232,229,0,3,1
2023-12-02,"53 - 1103",183,186,183,0,3,1
2023-12-02,"2 - 1066",44,40,44,0,-4,1
2023-12-02,"82 - 1163",159,148,159,0,-11,1
2023-12-03,"40 - 1320",208,207,208,0,-1,1
2023-12-03,"40 - 1114",229,232,229,0,3,1
2023-12-03,"53 - 1103",183,186,183,0,3,1
2023-12-03,"2 - 1066",44,40,44,0,-4,1
2023-12-03,"82 - 1163",159,148,159,0,-11,1
2023-12-04,"40 - 1320",208,207,207,1,-1,0.995192307692308
2023-12-04,"40 - 1114",229,232,229,0,3,1
2023-12-04,"53 - 1103",184,186,184,0,2,1
2023-12-04,"2 - 1066",44,40,44,0,-4,1
2023-12-04,"82 - 1163",156,148,156,0,-8,1
2023-12-05,"40 - 1320",207,207,206,1,0,0.995169082125604
2023-12-05,"40 - 1114",230,231,230,0,1,1
2023-12-05,"53 - 1103",183,186,183,0,3,1
2023-12-05,"2 - 1066",44,40,44,0,-4,1
2023-12-05,"82 - 1163",155,148,155,0,-7,1
2023-12-06,"40 - 1320",208,207,208,0,-1,1
2023-12-06,"40 - 1114",230,231,230,0,1,1
2023-12-06,"53 - 1103",184,186,182,2,2,0.989130434782609
2023-12-06,"2 - 1066",43,40,43,0,-3,1
2023-12-06,"82 - 1163",153,148,153,0,-5,1
2023-12-07,"40 - 1320",207,207,207,0,0,1
2023-12-07,"40 - 1114",231,231,231,0,0,1
2023-12-07,"53 - 1103",184,186,183,1,2,0.994565217391304
2023-12-07,"2 - 1066",43,40,43,0,-3,1
2023-12-07,"82 - 1163",153,148,153,0,-5,1
2023-12-08,"40 - 1320",206,207,206,0,1,1
2023-12-08,"40 - 1114",229,231,229,0,2,1
2023-12-08,"53 - 1103",183,186,183,0,3,1
2023-12-08,"2 - 1066",43,40,43,0,-3,1
2023-12-08,"82 - 1163",151,148,151,0,-3,1
2023-12-09,"40 - 1320",206,207,206,0,1,1
2023-12-09,"40 - 1114",226,231,226,0,5,1
2023-12-09,"53 - 1103",183,186,183,0,3,1
2023-12-09,"2 - 1066",45,40,45,0,-5,1
2023-12-09,"82 - 1163",148,148,148,0,0,1
2023-12-10,"40 - 1320",207,207,207,0,0,1
2023-12-10,"40 - 1114",226,231,226,0,5,1
2023-12-10,"53 - 1103",183,186,183,0,3,1
2023-12-10,"2 - 1066",45,40,45,0,-5,1
2023-12-10,"82 - 1163",147,148,147,0,1,1
2023-12-11,"40 - 1320",205,207,205,0,2,1
2023-12-11,"40 - 1114",225,231,225,0,6,1
2023-12-11,"53 - 1103",183,186,183,0,3,1
2023-12-11,"2 - 1066",46,40,46,0,-6,1
2023-12-11,"82 - 1163",150,148,150,0,-2,1
2023-12-12,"40 - 1320",206,207,206,0,1,1
2023-12-12,"40 - 1114",227,231,227,0,4,1
2023-12-12,"53 - 1103",182,186,182,0,4,1
2023-12-12,"2 - 1066",47,40,46,1,-7,0.978723404255319
2023-12-12,"82 - 1163",153,148,153,0,-5,1
2023-12-13,"40 - 1320",204,207,204,0,3,1
2023-12-13,"40 - 1114",228,231,228,0,3,1
2023-12-13,"53 - 1103",183,186,183,0,3,1
2023-12-13,"2 - 1066",47,40,47,0,-7,1
2023-12-13,"82 - 1163",157,148,157,0,-9,1
2023-12-14,"40 - 1320",205,207,203,2,2,0.990243902439024
2023-12-14,"40 - 1114",230,231,228,2,1,0.991304347826087
2023-12-14,"53 - 1103",184,186,183,1,2,0.994565217391304
2023-12-14,"2 - 1066",47,40,47,0,-7,1
2023-12-14,"82 - 1163",155,148,154,1,-7,0.993548387096774
2023-12-15,"40 - 1320",205,207,202,3,2,0.985365853658537
2023-12-15,"40 - 1114",228,231,228,0,3,1
2023-12-15,"53 - 1103",183,186,183,0,3,1
2023-12-15,"2 - 1066",46,40,46,0,-6,1
2023-12-15,"82 - 1163",154,148,154,0,-6,1
2023-12-16,"40 - 1320",203,207,202,1,4,0.995073891625616
2023-12-16,"40 - 1114",227,231,227,0,4,1
2023-12-16,"53 - 1103",184,186,182,2,2,0.989130434782609
2023-12-16,"2 - 1066",47,40,47,0,-7,1
2023-12-16,"82 - 1163",153,148,152,1,-5,0.993464052287582
2023-12-17,"40 - 1320",204,207,204,0,3,1
2023-12-17,"40 - 1114",227,231,227,0,4,1
2023-12-17,"53 - 1103",182,186,182,0,4,1
2023-12-17,"2 - 1066",47,40,47,0,-7,1
2023-12-17,"82 - 1163",154,148,154,0,-6,1
2023-12-18,"40 - 1320",206,207,206,0,1,1
2023-12-18,"40 - 1114",228,231,228,0,3,1
2023-12-18,"53 - 1103",183,186,183,0,3,1
2023-12-18,"2 - 1066",47,40,47,0,-7,1
2023-12-18,"82 - 1163",154,148,154,0,-6,1
2023-12-19,"40 - 1320",207,207,206,1,0,0.995169082125604
2023-12-19,"40 - 1114",229,231,229,0,2,1
2023-12-19,"53 - 1103",185,186,185,0,1,1
2023-12-19,"2 - 1066",47,40,47,0,-7,1
2023-12-19,"82 - 1163",153,148,153,0,-5,1
2023-12-20,"40 - 1320",207,207,207,0,0,1
2023-12-20,"40 - 1114",228,231,228,0,3,1
2023-12-20,"53 - 1103",185,186,184,1,1,0.994594594594595
2023-12-20,"2 - 1066",48,40,48,0,-8,1
2023-12-20,"82 - 1163",157,148,157,0,-9,1
2023-12-21,"40 - 1320",207,207,207,0,0,1
2023-12-21,"40 - 1114",229,231,229,0,2,1
2023-12-21,"53 - 1103",183,186,182,1,3,0.994535519125683
2023-12-21,"2 - 1066",47,40,47,0,-7,1
2023-12-21,"82 - 1163",151,148,151,0,-3,1
2023-12-22,"40 - 1320",207,207,206,1,0,0.995169082125604
2023-12-22,"40 - 1114",227,231,226,1,4,0.995594713656388
2023-12-22,"53 - 1103",184,186,184,0,2,1
2023-12-22,"2 - 1066",46,40,46,0,-6,1
2023-12-22,"82 - 1163",154,148,154,0,-6,1
2023-12-23,"40 - 1320",207,207,205,2,0,0.990338164251208
2023-12-23,"40 - 1114",227,231,227,0,4,1
2023-12-23,"53 - 1103",184,186,184,0,2,1
2023-12-23,"2 - 1066",49,40,46,3,-9,0.938775510204082
2023-12-23,"82 - 1163",152,148,152,0,-4,1
2023-12-24,"40 - 1320",205,207,205,0,2,1
2023-12-24,"40 - 1114",227,231,227,0,4,1
2023-12-24,"53 - 1103",184,186,184,0,2,1
2023-12-24,"2 - 1066",49,40,46,3,-9,0.938775510204082
2023-12-24,"82 - 1163",152,148,152,0,-4,1
2023-12-25,"40 - 1320",207,207,207,0,0,1
2023-12-25,"40 - 1114",227,231,227,0,4,1
2023-12-25,"53 - 1103",184,186,183,1,2,0.994565217391304
2023-12-25,"2 - 1066",49,40,48,1,-9,0.979591836734694
2023-12-25,"82 - 1163",152,148,152,0,-4,1
2023-12-26,"40 - 1320",207,207,207,0,0,1
2023-12-26,"40 - 1114",227,231,227,0,4,1
2023-12-26,"53 - 1103",183,186,183,0,3,1
2023-12-26,"2 - 1066",49,40,48,1,-9,0.979591836734694
2023-12-26,"82 - 1163",153,148,153,0,-5,1
2023-12-27,"40 - 1320",207,207,207,0,0,1
2023-12-27,"40 - 1114",227,231,227,0,4,1
2023-12-27,"53 - 1103",184,186,182,2,2,0.989130434782609
2023-12-27,"2 - 1066",48,40,48,0,-8,1
2023-12-27,"82 - 1163",151,148,151,0,-3,1
2023-12-28,"40 - 1320",207,207,207,0,0,1
2023-12-28,"40 - 1114",227,231,227,0,4,1
2023-12-28,"53 - 1103",184,186,182,2,2,0.989130434782609
2023-12-28,"2 - 1066",48,40,48,0,-8,1
2023-12-28,"82 - 1163",151,148,151,0,-3,1
2023-12-29,"40 - 1320",206,207,206,0,1,1
2023-12-29,"40 - 1114",228,231,228,0,3,1
2023-12-29,"53 - 1103",184,186,182,2,2,0.989130434782609
2023-12-29,"2 - 1066",48,40,48,0,-8,1
2023-12-29,"82 - 1163",153,148,153,0,-5,1
2023-12-30,"40 - 1320",207,207,207,0,0,1
2023-12-30,"40 - 1114",228,231,228,0,3,1
2023-12-30,"53 - 1103",183,186,182,1,3,0.994535519125683
2023-12-30,"2 - 1066",48,40,48,0,-8,1
2023-12-30,"82 - 1163",153,148,149,4,-5,0.973856209150327
2023-12-31,"40 - 1320",205,207,204,1,2,0.995121951219512
2023-12-31,"40 - 1114",228,231,228,0,3,1
2023-12-31,"53 - 1103",183,186,182,1,3,0.994535519125683
2023-12-31,"2 - 1066",48,40,48,0,-8,1
2023-12-31,"82 - 1163",148,148,148,0,0,1
2024-01-01,"40 - 1320",206,207,206,0,1,1
2024-01-01,"40 - 1114",228,231,228,0,3,1
2024-01-01,"2 - 1066",49,40,49,0,-9,1
2024-01-01,"82 - 1163",146,148,145,1,2,0.993150684931507
2024-01-02,"40 - 1320",206,207,206,0,1,1
2024-01-02,"40 - 1114",228,231,227,1,3,0.995614035087719
2024-01-02,"2 - 1066",49,40,49,0,-9,1
2024-01-02,"82 - 1163",147,148,147,0,1,1
2024-01-03,"40 - 1320",207,207,206,1,0,0.995169082125604
2024-01-03,"40 - 1114",228,231,228,0,3,1
2024-01-03,"2 - 1066",48,40,48,0,-8,1
2024-01-03,"82 - 1163",147,148,147,0,1,1
2024-01-04,"40 - 1320",207,207,207,0,0,1
2024-01-04,"40 - 1114",228,231,228,0,3,1
2024-01-04,"2 - 1066",48,40,48,0,-8,1
2024-01-04,"82 - 1163",148,148,148,0,0,1
2024-01-05,"40 - 1320",206,207,206,0,1,1
2024-01-05,"40 - 1114",230,231,230,0,1,1
2024-01-05,"2 - 1066",48,40,48,0,-8,1
2024-01-05,"82 - 1163",147,148,147,0,1,1
2024-01-06,"40 - 1320",206,207,206,0,1,1
2024-01-06,"40 - 1114",230,231,230,0,1,1
2024-01-06,"2 - 1066",47,40,46,1,-7,0.978723404255319
2024-01-06,"82 - 1163",149,148,149,0,-1,1
2024-01-07,"40 - 1320",207,207,207,0,0,1
2024-01-07,"40 - 1114",230,231,230,0,1,1
2024-01-07,"2 - 1066",47,40,47,0,-7,1
2024-01-07,"82 - 1163",148,148,148,0,0,1
2024-01-08,"40 - 1320",207,207,206,1,0,0.995169082125604
2024-01-08,"40 - 1114",229,231,229,0,2,1
2024-01-08,"2 - 1066",46,40,46,0,-6,1
2024-01-08,"82 - 1163",146,148,146,0,2,1
2024-01-09,"40 - 1320",207,207,207,0,0,1
2024-01-09,"40 - 1114",229,231,228,1,2,0.995633187772926
2024-01-09,"2 - 1066",46,40,46,0,-6,1
2024-01-09,"82 - 1163",146,148,146,0,2,1
2024-01-10,"40 - 1320",207,207,207,0,0,1
2024-01-10,"40 - 1114",229,231,229,0,2,1
2024-01-10,"2 - 1066",46,40,46,0,-6,1
2024-01-10,"82 - 1163",146,148,146,0,2,1
2024-01-11,"40 - 1320",207,207,207,0,0,1
2024-01-11,"40 - 1114",229,231,229,0,2,1
2024-01-11,"2 - 1066",45,40,45,0,-5,1
2024-01-11,"82 - 1163",152,148,152,0,-4,1
2024-01-12,"40 - 1320",207,207,207,0,0,1
2024-01-12,"40 - 1114",229,231,229,0,2,1
2024-01-12,"2 - 1066",46,40,46,0,-6,1
2024-01-12,"82 - 1163",157,148,157,0,-9,1
2024-01-13,"40 - 1320",207,207,207,0,0,1
2024-01-13,"40 - 1114",227,231,227,0,4,1
2024-01-13,"2 - 1066",48,40,48,0,-8,1
2024-01-13,"82 - 1163",156,148,156,0,-8,1
2024-01-14,"40 - 1320",207,207,206,1,0,0.995169082125604
2024-01-14,"40 - 1114",227,231,227,0,4,1
2024-01-14,"2 - 1066",48,40,48,0,-8,1
2024-01-14,"82 - 1163",155,148,155,0,-7,1
2024-01-15,"40 - 1320",207,207,206,1,0,0.995169082125604
2024-01-15,"40 - 1114",227,231,227,0,4,1
2024-01-15,"2 - 1066",48,40,48,0,-8,1
2024-01-15,"82 - 1163",151,148,151,0,-3,1
2024-01-16,"40 - 1320",205,207,204,1,2,0.995121951219512
2024-01-16,"40 - 1114",227,231,227,0,4,1
2024-01-16,"2 - 1066",47,40,47,0,-7,1
2024-01-16,"82 - 1163",149,148,149,0,-1,1
2024-01-17,"40 - 1320",206,207,205,1,1,0.995145631067961
2024-01-17,"40 - 1114",228,231,228,0,3,1
2024-01-17,"2 - 1066",47,40,47,0,-7,1
2024-01-17,"82 - 1163",147,148,147,0,1,1
2024-01-18,"40 - 1320",205,207,205,0,2,1
2024-01-18,"40 - 1114",228,231,228,0,3,1
2024-01-18,"2 - 1066",48,40,48,0,-8,1
2024-01-18,"82 - 1163",149,148,149,0,-1,1
2024-01-19,"40 - 1320",206,207,204,2,1,0.990291262135922
2024-01-19,"40 - 1114",230,231,230,0,1,1
2024-01-19,"2 - 1066",48,40,48,0,-8,1
2024-01-19,"82 - 1163",151,148,151,0,-3,1
2024-01-20,"40 - 1320",206,207,204,2,1,0.990291262135922
2024-01-20,"40 - 1114",228,231,228,0,3,1
2024-01-20,"2 - 1066",49,40,49,0,-9,1
2024-01-20,"82 - 1163",152,148,152,0,-4,1
2024-01-21,"40 - 1320",204,207,204,0,3,1
2024-01-21,"40 - 1114",226,231,226,0,5,1
2024-01-21,"2 - 1066",49,40,49,0,-9,1
2024-01-21,"82 - 1163",150,148,150,0,-2,1
2024-01-22,"40 - 1320",205,207,204,1,2,0.995121951219512
2024-01-22,"40 - 1114",226,231,226,0,5,1
2024-01-22,"2 - 1066",49,40,49,0,-9,1
2024-01-22,"82 - 1163",149,148,149,0,-1,1
2024-01-23,"40 - 1320",205,207,205,0,2,1
2024-01-23,"40 - 1114",227,231,227,0,4,1
2024-01-23,"2 - 1066",50,40,50,0,-10,1
2024-01-23,"82 - 1163",148,148,148,0,0,1
2024-01-24,"40 - 1320",206,207,206,0,1,1
2024-01-24,"40 - 1114",228,231,228,0,3,1
2024-01-24,"2 - 1066",51,40,50,1,-11,0.980392156862745
2024-01-24,"82 - 1163",148,148,148,0,0,1
2024-01-25,"40 - 1320",206,207,206,0,1,1
2024-01-25,"40 - 1114",228,231,228,0,3,1
2024-01-25,"2 - 1066",49,40,49,0,-9,1
2024-01-25,"82 - 1163",149,148,148,1,-1,0.993288590604027
2024-01-26,"40 - 1320",206,207,206,0,1,1
2024-01-26,"40 - 1114",227,231,227,0,4,1
2024-01-26,"2 - 1066",49,40,49,0,-9,1
2024-01-26,"82 - 1163",151,148,151,0,-3,1
2024-01-27,"40 - 1320",207,207,206,1,0,0.995169082125604
2024-01-27,"40 - 1114",228,231,228,0,3,1
2024-01-27,"2 - 1066",49,40,49,0,-9,1
2024-01-27,"82 - 1163",151,148,151,0,-3,1
2024-01-28,"40 - 1320",207,207,207,0,0,1
2024-01-28,"40 - 1114",228,231,228,0,3,1
2024-01-28,"2 - 1066",49,40,48,1,-9,0.979591836734694
2024-01-28,"82 - 1163",151,148,151,0,-3,1
2024-01-29,"40 - 1320",207,207,206,1,0,0.995169082125604
2024-01-29,"40 - 1114",229,231,229,0,2,1
2024-01-29,"2 - 1066",49,40,49,0,-9,1
2024-01-29,"82 - 1163",149,148,149,0,-1,1
2024-01-30,"40 - 1320",207,207,206,1,0,0.995169082125604
2024-01-30,"40 - 1114",229,231,229,0,2,1
2024-01-30,"2 - 1066",49,40,49,0,-9,1
2024-01-30,"82 - 1163",149,148,149,0,-1,1
2024-01-31,"40 - 1320",207,207,206,1,0,0.995169082125604
2024-01-31,"40 - 1114",230,231,230,0,1,1
2024-01-31,"2 - 1066",49,40,49,0,-9,1
2024-01-31,"82 - 1163",149,148,149,0,-1,1
2024-02-01,"40 - 1320",205,207,204,1,2,0.995121951219512
2024-02-01,"40 - 1114",228,231,228,0,3,1
2024-02-01,"2 - 1066",46,40,46,0,-6,1
2024-02-01,"82 - 1163",149,148,149,0,-1,1
2024-02-02,"40 - 1320",203,207,203,0,4,1
2024-02-02,"40 - 1114",228,231,228,0,3,1
2024-02-02,"2 - 1066",50,40,46,4,-10,0.92
2024-02-02,"82 - 1163",149,148,149,0,-1,1
2024-02-03,"40 - 1320",205,207,205,0,2,1
2024-02-03,"40 - 1114",226,231,226,0,5,1
2024-02-03,"2 - 1066",45,40,45,0,-5,1
2024-02-03,"82 - 1163",148,148,147,1,0,0.993243243243243
2024-02-04,"40 - 1320",207,207,207,0,0,1
2024-02-04,"40 - 1114",226,231,226,0,5,1
2024-02-04,"2 - 1066",45,40,45,0,-5,1
2024-02-04,"82 - 1163",148,148,148,0,0,1
2024-02-05,"40 - 1320",207,207,207,0,0,1
2024-02-05,"40 - 1114",226,231,226,0,5,1
2024-02-05,"2 - 1066",45,40,45,0,-5,1
2024-02-05,"82 - 1163",146,148,146,0,2,1
2024-02-06,"40 - 1320",206,207,206,0,1,1
2024-02-06,"40 - 1114",227,231,227,0,4,1
2024-02-06,"2 - 1066",44,40,44,0,-4,1
2024-02-06,"82 - 1163",146,148,145,1,2,0.993150684931507
2024-02-07,"40 - 1320",206,207,205,1,1,0.995145631067961
2024-02-07,"40 - 1114",226,231,226,0,5,1
2024-02-07,"2 - 1066",45,40,45,0,-5,1
2024-02-07,"82 - 1163",147,148,147,0,1,1
2024-02-08,"40 - 1320",205,207,205,0,2,1
2024-02-08,"40 - 1114",225,231,225,0,6,1
2024-02-08,"2 - 1066",47,40,47,0,-7,1
2024-02-08,"82 - 1163",146,148,146,0,2,1
2024-02-09,"40 - 1320",206,207,206,0,1,1
2024-02-09,"40 - 1114",223,231,223,0,8,1
2024-02-09,"2 - 1066",46,40,46,0,-6,1
2024-02-09,"82 - 1163",147,148,147,0,1,1
2024-02-10,"40 - 1320",206,207,206,0,1,1
2024-02-10,"40 - 1114",225,231,224,1,6,0.995555555555556
2024-02-10,"2 - 1066",46,40,46,0,-6,1
2024-02-10,"82 - 1163",146,148,146,0,2,1
2024-02-11,"40 - 1320",206,207,206,0,1,1
2024-02-11,"40 - 1114",227,231,226,1,4,0.995594713656388
2024-02-11,"2 - 1066",50,40,49,1,-10,0.98
2024-02-11,"82 - 1163",147,148,147,0,1,1
2024-02-12,"40 - 1320",206,207,205,1,1,0.995145631067961
2024-02-12,"40 - 1114",226,231,226,0,5,1
2024-02-12,"2 - 1066",50,40,50,0,-10,1
2024-02-12,"82 - 1163",147,148,147,0,1,1
2024-02-13,"40 - 1320",205,207,204,1,2,0.995121951219512
2024-02-13,"40 - 1114",224,231,224,0,7,1
2024-02-13,"2 - 1066",50,40,50,0,-10,1
2024-02-13,"82 - 1163",152,148,152,0,-4,1
2024-02-14,"40 - 1320",204,207,204,0,3,1
2024-02-14,"40 - 1114",225,231,225,0,6,1
2024-02-14,"2 - 1066",51,40,50,1,-11,0.980392156862745
2024-02-14,"82 - 1163",151,148,151,0,-3,1
2024-02-15,"40 - 1320",206,207,205,1,1,0.995145631067961
2024-02-15,"40 - 1114",226,231,226,0,5,1
2024-02-15,"2 - 1066",51,40,50,1,-11,0.980392156862745
2024-02-15,"82 - 1163",152,148,152,0,-4,1
2024-02-16,"40 - 1320",205,207,205,0,2,1
2024-02-16,"40 - 1114",226,231,226,0,5,1
2024-02-16,"2 - 1066",51,40,51,0,-11,1
2024-02-16,"82 - 1163",155,148,155,0,-7,1
2024-02-17,"40 - 1320",206,207,206,0,1,1
2024-02-17,"40 - 1114",226,231,226,0,5,1
2024-02-17,"2 - 1066",51,40,51,0,-11,1
2024-02-17,"82 - 1163",154,148,154,0,-6,1
2024-02-18,"40 - 1320",207,207,207,0,0,1
2024-02-18,"40 - 1114",226,231,226,0,5,1
2024-02-18,"2 - 1066",51,40,51,0,-11,1
2024-02-18,"82 - 1163",155,148,155,0,-7,1
2024-02-19,"40 - 1320",207,207,207,0,0,1
2024-02-19,"40 - 1114",226,231,226,0,5,1
2024-02-19,"2 - 1066",51,40,51,0,-11,1
2024-02-19,"82 - 1163",156,148,156,0,-8,1
2024-02-20,"40 - 1320",207,207,207,0,0,1
2024-02-20,"40 - 1114",226,231,226,0,5,1
2024-02-20,"2 - 1066",51,40,51,0,-11,1
2024-02-20,"82 - 1163",155,148,155,0,-7,1
2024-02-21,"40 - 1320",207,207,207,0,0,1
2024-02-21,"40 - 1114",227,231,227,0,4,1
2024-02-21,"2 - 1066",51,40,51,0,-11,1
2024-02-21,"82 - 1163",155,148,155,0,-7,1
2024-02-22,"40 - 1320",207,207,207,0,0,1
2024-02-22,"40 - 1114",228,231,228,0,3,1
2024-02-22,"2 - 1066",51,40,51,0,-11,1
2024-02-22,"82 - 1163",156,148,156,0,-8,1
2024-02-23,"40 - 1320",207,207,207,0,0,1
2024-02-23,"40 - 1114",227,231,227,0,4,1
2024-02-23,"2 - 1066",51,40,51,0,-11,1
2024-02-23,"82 - 1163",157,148,154,3,-9,0.980891719745223
2024-02-24,"40 - 1320",207,207,207,0,0,1
2024-02-24,"40 - 1114",227,231,227,0,4,1
2024-02-24,"2 - 1066",51,40,51,0,-11,1
2024-02-24,"82 - 1163",153,148,150,3,-5,0.980392156862745
2024-02-25,"40 - 1320",207,207,207,0,0,1
2024-02-25,"40 - 1114",227,231,227,0,4,1
2024-02-25,"2 - 1066",51,40,51,0,-11,1
2024-02-25,"82 - 1163",150,148,150,0,-2,1
2024-02-26,"40 - 1320",207,207,207,0,0,1
2024-02-26,"40 - 1114",226,231,226,0,5,1
2024-02-26,"2 - 1066",50,40,50,0,-10,1
2024-02-26,"82 - 1163",147,148,147,0,1,1
2024-02-27,"40 - 1320",207,207,207,0,0,1
2024-02-27,"40 - 1114",225,231,225,0,6,1
2024-02-27,"2 - 1066",49,40,49,0,-9,1
2024-02-27,"82 - 1163",146,148,146,0,2,1
2024-02-28,"40 - 1320",207,207,207,0,0,1
2024-02-28,"40 - 1114",225,231,225,0,6,1
2024-02-28,"2 - 1066",49,40,49,0,-9,1
2024-02-28,"82 - 1163",143,148,143,0,5,1
2024-02-29,"40 - 1320",207,207,207,0,0,1
2024-02-29,"40 - 1114",224,231,224,0,7,1
2024-02-29,"2 - 1066",49,40,49,0,-9,1
2024-02-29,"82 - 1163",143,148,143,0,5,1
2024-03-01,"40 - 1320",205,207,203,2,2,0.990243902439024
2024-03-01,"40 - 1114",222,231,222,0,9,1
2024-03-01,"2 - 1066",46,40,46,0,-6,1
2024-03-01,"82 - 1163",143,148,143,0,5,1
2024-03-02,"40 - 1320",202,207,202,0,5,1
2024-03-02,"40 - 1114",222,231,222,0,9,1
2024-03-02,"2 - 1066",49,40,46,3,-9,0.938775510204082
2024-03-02,"82 - 1163",143,148,143,0,5,1
2024-03-03,"40 - 1320",203,207,202,1,4,0.995073891625616
2024-03-03,"40 - 1114",224,231,224,0,7,1
2024-03-03,"2 - 1066",46,40,45,1,-6,0.978260869565217
2024-03-03,"82 - 1163",144,148,144,0,4,1
2024-03-04,"40 - 1320",204,207,203,1,3,0.995098039215686
2024-03-04,"40 - 1114",224,231,224,0,7,1
2024-03-04,"2 - 1066",47,40,47,0,-7,1
2024-03-04,"82 - 1163",145,148,145,0,3,1
2024-03-05,"40 - 1320",202,207,202,0,5,1
2024-03-05,"40 - 1114",225,232,225,0,7,1
2024-03-05,"2 - 1066",45,40,45,0,-5,1
2024-03-05,"82 - 1163",146,148,146,0,2,1
2024-03-06,"40 - 1320",205,207,204,1,2,0.995121951219512
2024-03-06,"40 - 1114",227,232,227,0,5,1
2024-03-06,"2 - 1066",47,40,45,2,-7,0.957446808510638
2024-03-06,"82 - 1163",148,148,147,1,0,0.993243243243243
2024-03-07,"40 - 1320",207,207,206,1,0,0.995169082125604
2024-03-07,"40 - 1114",228,232,228,0,4,1
2024-03-07,"2 - 1066",47,40,47,0,-7,1
2024-03-07,"82 - 1163",149,148,149,0,-1,1
2024-03-08,"40 - 1320",204,207,204,0,3,1
2024-03-08,"40 - 1114",226,232,226,0,6,1
2024-03-08,"2 - 1066",47,40,47,0,-7,1
2024-03-08,"82 - 1163",151,148,151,0,-3,1
2024-03-09,"40 - 1320",205,207,205,0,2,1
2024-03-09,"40 - 1114",226,232,226,0,6,1
2024-03-09,"2 - 1066",46,40,46,0,-6,1
2024-03-09,"82 - 1163",150,148,150,0,-2,1
2024-03-10,"40 - 1320",206,207,206,0,1,1
2024-03-10,"40 - 1114",226,232,226,0,6,1
2024-03-10,"2 - 1066",46,40,46,0,-6,1
2024-03-10,"82 - 1163",150,148,150,0,-2,1
2024-03-11,"40 - 1320",206,207,206,0,1,1
2024-03-11,"40 - 1114",225,232,225,0,7,1
2024-03-11,"2 - 1066",46,40,46,0,-6,1
2024-03-11,"82 - 1163",148,148,148,0,0,1
2024-03-12,"40 - 1320",207,207,207,0,0,1
2024-03-12,"40 - 1114",224,232,224,0,8,1
2024-03-12,"2 - 1066",47,40,47,0,-7,1
2024-03-12,"82 - 1163",146,148,146,0,2,1
2024-03-13,"40 - 1320",207,207,207,0,0,1
2024-03-13,"40 - 1114",227,232,227,0,5,1
2024-03-13,"2 - 1066",49,40,48,1,-9,0.979591836734694
2024-03-13,"82 - 1163",144,148,144,0,4,1
2024-03-14,"40 - 1320",207,207,207,0,0,1
2024-03-14,"40 - 1114",229,232,228,1,3,0.995633187772926
2024-03-14,"2 - 1066",49,40,49,0,-9,1
2024-03-14,"82 - 1163",144,148,144,0,4,1
2024-03-15,"40 - 1320",206,207,205,1,1,0.995145631067961
2024-03-15,"40 - 1114",229,232,229,0,3,1
2024-03-15,"2 - 1066",49,40,49,0,-9,1
2024-03-15,"82 - 1163",145,148,145,0,3,1
2024-03-16,"40 - 1320",204,207,203,1,3,0.995098039215686
2024-03-16,"40 - 1114",228,232,228,0,4,1
2024-03-16,"2 - 1066",49,40,49,0,-9,1
2024-03-16,"82 - 1163",144,148,144,0,4,1
2024-03-17,"40 - 1320",203,207,203,0,4,1
2024-03-17,"40 - 1114",228,232,228,0,4,1
2024-03-17,"2 - 1066",49,40,49,0,-9,1
2024-03-17,"82 - 1163",152,148,151,1,-4,0.993421052631579
2024-03-18,"40 - 1320",204,207,204,0,3,1
2024-03-18,"40 - 1114",227,232,227,0,5,1
2024-03-18,"2 - 1066",48,40,48,0,-8,1
2024-03-18,"82 - 1163",151,148,151,0,-3,1
2024-03-19,"40 - 1320",205,207,205,0,2,1
2024-03-19,"40 - 1114",227,232,227,0,5,1
2024-03-19,"2 - 1066",49,40,49,0,-9,1
2024-03-19,"82 - 1163",149,148,149,0,-1,1
2024-03-20,"40 - 1320",205,207,204,1,2,0.995121951219512
2024-03-20,"40 - 1114",229,232,228,1,3,0.995633187772926
2024-03-20,"2 - 1066",50,40,50,0,-10,1
2024-03-20,"82 - 1163",150,148,150,0,-2,1
2024-03-21,"40 - 1320",206,207,205,1,1,0.995145631067961
2024-03-21,"40 - 1114",229,232,229,0,3,1
2024-03-21,"2 - 1066",50,40,50,0,-10,1
2024-03-21,"82 - 1163",153,148,153,0,-5,1
2024-03-22,"40 - 1320",207,207,206,1,0,0.995169082125604
2024-03-22,"40 - 1114",229,232,229,0,3,1
2024-03-22,"2 - 1066",50,40,50,0,-10,1
2024-03-22,"82 - 1163",153,148,153,0,-5,1
2024-03-23,"40 - 1320",207,207,207,0,0,1
2024-03-23,"40 - 1114",229,232,229,0,3,1
2024-03-23,"2 - 1066",51,40,51,0,-11,1
2024-03-23,"82 - 1163",153,148,153,0,-5,1
2024-03-24,"40 - 1320",207,207,207,0,0,1
2024-03-24,"40 - 1114",229,231,229,0,2,1
2024-03-24,"2 - 1066",51,40,51,0,-11,1
2024-03-24,"82 - 1163",154,148,154,0,-6,1
2024-03-25,"40 - 1320",207,207,207,0,0,1
2024-03-25,"40 - 1114",229,231,229,0,2,1
2024-03-25,"2 - 1066",51,40,51,0,-11,1
2024-03-25,"82 - 1163",153,148,153,0,-5,1
2024-03-26,"40 - 1320",207,207,207,0,0,1
2024-03-26,"40 - 1114",229,231,229,0,2,1
2024-03-26,"2 - 1066",50,40,50,0,-10,1
2024-03-26,"82 - 1163",158,148,158,0,-10,1
2024-03-27,"40 - 1320",206,207,206,0,1,1
2024-03-27,"40 - 1114",228,231,228,0,3,1
2024-03-27,"2 - 1066",50,40,50,0,-10,1
2024-03-27,"82 - 1163",157,148,157,0,-9,1
2024-03-28,"40 - 1320",207,207,207,0,0,1
2024-03-28,"40 - 1114",226,231,226,0,5,1
2024-03-28,"2 - 1066",50,40,50,0,-10,1
2024-03-28,"82 - 1163",157,148,157,0,-9,1
2024-03-29,"40 - 1320",206,207,206,0,1,1
2024-03-29,"40 - 1114",228,231,227,1,3,0.995614035087719
2024-03-29,"2 - 1066",50,40,50,0,-10,1
2024-03-29,"82 - 1163",162,148,161,1,-14,0.993827160493827
2024-03-30,"40 - 1320",206,207,206,0,1,1
2024-03-30,"40 - 1114",227,231,227,0,4,1
2024-03-30,"2 - 1066",50,40,50,0,-10,1
2024-03-30,"82 - 1163",162,148,162,0,-14,1
2024-03-31,"40 - 1320",206,207,206,0,1,1
2024-03-31,"40 - 1114",227,231,227,0,4,1
2024-03-31,"2 - 1066",50,40,50,0,-10,1
2024-03-31,"82 - 1163",162,148,162,0,-14,1
2024-04-01,"40 - 1320",204,207,204,0,3,1
2024-04-01,"40 - 1114",226,231,226,0,5,1
2024-04-01,"2 - 1066",50,40,50,0,-10,1
2024-04-01,"82 - 1163",162,148,162,0,-14,1
2024-04-02,"40 - 1320",204,207,204,0,3,1
2024-04-02,"40 - 1114",226,231,226,0,5,1
2024-04-02,"2 - 1066",50,40,50,0,-10,1
2024-04-02,"82 - 1163",161,148,161,0,-13,1
2024-04-03,"40 - 1320",205,207,204,1,2,0.995121951219512
2024-04-03,"40 - 1114",227,231,227,0,4,1
2024-04-03,"2 - 1066",50,40,50,0,-10,1
2024-04-03,"82 - 1163",161,148,161,0,-13,1
2024-04-04,"40 - 1320",204,207,204,0,3,1
2024-04-04,"40 - 1114",226,231,226,0,5,1
2024-04-04,"2 - 1066",50,40,50,0,-10,1
2024-04-04,"82 - 1163",160,148,160,0,-12,1
2024-04-05,"40 - 1320",204,207,204,0,3,1
2024-04-05,"40 - 1114",226,231,226,0,5,1
2024-04-05,"2 - 1066",50,40,50,0,-10,1
2024-04-05,"82 - 1163",162,148,162,0,-14,1
2024-04-06,"40 - 1320",206,207,204,2,1,0.990291262135922
2024-04-06,"40 - 1114",226,231,226,0,5,1
2024-04-06,"2 - 1066",50,40,50,0,-10,1
2024-04-06,"82 - 1163",162,148,162,0,-14,1
2024-04-07,"40 - 1320",206,207,206,0,1,1
2024-04-07,"40 - 1114",226,231,226,0,5,1
2024-04-07,"2 - 1066",50,40,50,0,-10,1
2024-04-07,"82 - 1163",160,148,160,0,-12,1
2024-04-08,"40 - 1320",206,207,206,0,1,1
2024-04-08,"40 - 1114",228,231,228,0,3,1
2024-04-08,"2 - 1066",49,40,49,0,-9,1
2024-04-08,"82 - 1163",163,148,163,0,-15,1
2024-04-09,"40 - 1320",206,207,206,0,1,1
2024-04-09,"40 - 1114",228,231,228,0,3,1
2024-04-09,"2 - 1066",49,40,49,0,-9,1
2024-04-09,"82 - 1163",163,148,163,0,-15,1
2024-04-10,"40 - 1320",207,207,206,1,0,0.995169082125604
2024-04-10,"40 - 1114",228,231,228,0,3,1
2024-04-10,"2 - 1066",50,40,50,0,-10,1
2024-04-10,"82 - 1163",164,148,164,0,-16,1
2024-04-11,"40 - 1320",207,207,207,0,0,1
2024-04-11,"40 - 1114",229,231,229,0,2,1
2024-04-11,"2 - 1066",50,40,50,0,-10,1
2024-04-11,"82 - 1163",167,148,167,0,-19,1
2024-04-12,"40 - 1320",207,207,207,0,0,1
2024-04-12,"40 - 1114",229,231,228,1,2,0.995633187772926
2024-04-12,"2 - 1066",50,40,50,0,-10,1
2024-04-12,"82 - 1163",166,148,163,3,-18,0.981927710843373
2024-04-13,"40 - 1320",207,207,207,0,0,1
2024-04-13,"40 - 1114",227,231,226,1,4,0.995594713656388
2024-04-13,"2 - 1066",49,40,49,0,-9,1
2024-04-13,"82 - 1163",163,148,163,0,-15,1
2024-04-14,"40 - 1320",207,207,207,0,0,1
2024-04-14,"40 - 1114",227,231,226,1,4,0.995594713656388
2024-04-14,"2 - 1066",48,40,48,0,-8,1
2024-04-14,"82 - 1163",163,148,163,0,-15,1
2024-04-15,"40 - 1320",206,207,206,0,1,1
2024-04-15,"40 - 1114",226,231,226,0,5,1
2024-04-15,"2 - 1066",48,40,48,0,-8,1
2024-04-15,"82 - 1163",163,148,163,0,-15,1
2024-04-16,"40 - 1320",206,207,206,0,1,1
2024-04-16,"40 - 1114",225,231,225,0,6,1
2024-04-16,"2 - 1066",48,40,48,0,-8,1
2024-04-16,"82 - 1163",163,148,163,0,-15,1
2024-04-17,"40 - 1320",206,207,206,0,1,1
2024-04-17,"40 - 1114",225,231,225,0,6,1
2024-04-17,"2 - 1066",48,40,48,0,-8,1
2024-04-17,"82 - 1163",161,148,161,0,-13,1
2024-04-18,"40 - 1320",206,207,206,0,1,1
2024-04-18,"40 - 1114",226,231,226,0,5,1
2024-04-18,"2 - 1066",49,40,49,0,-9,1
2024-04-18,"82 - 1163",160,148,160,0,-12,1
2024-04-19,"40 - 1320",206,207,205,1,1,0.995145631067961
2024-04-19,"40 - 1114",228,231,227,1,3,0.995614035087719
2024-04-19,"2 - 1066",49,40,49,0,-9,1
2024-04-19,"82 - 1163",160,148,160,0,-12,1
2024-04-20,"40 - 1320",205,207,205,0,2,1
2024-04-20,"40 - 1114",228,231,228,0,3,1
2024-04-20,"2 - 1066",48,40,48,0,-8,1
2024-04-20,"82 - 1163",161,148,161,0,-13,1
2024-04-21,"40 - 1320",206,207,206,0,1,1
2024-04-21,"40 - 1114",228,231,228,0,3,1
2024-04-21,"2 - 1066",48,40,48,0,-8,1
2024-04-21,"82 - 1163",160,148,160,0,-12,1
2024-04-22,"40 - 1320",206,207,206,0,1,1
2024-04-22,"40 - 1114",228,231,228,0,3,1
2024-04-22,"2 - 1066",48,40,48,0,-8,1
2024-04-22,"82 - 1163",160,148,160,0,-12,1
2024-04-23,"40 - 1320",207,207,207,0,0,1
2024-04-23,"40 - 1114",228,231,228,0,3,1
2024-04-23,"2 - 1066",49,40,49,0,-9,1
2024-04-23,"82 - 1163",159,148,159,0,-11,1
2024-04-24,"40 - 1320",207,207,207,0,0,1
2024-04-24,"40 - 1114",229,231,228,1,2,0.995633187772926
2024-04-24,"2 - 1066",49,40,49,0,-9,1
2024-04-24,"82 - 1163",160,148,160,0,-12,1
2024-04-25,"40 - 1320",207,207,207,0,0,1
2024-04-25,"40 - 1114",228,231,228,0,3,1
2024-04-25,"2 - 1066",49,40,49,0,-9,1
2024-04-25,"82 - 1163",162,148,162,0,-14,1
2024-04-26,"40 - 1320",207,207,207,0,0,1
2024-04-26,"40 - 1114",228,231,228,0,3,1
2024-04-26,"2 - 1066",49,40,49,0,-9,1
2024-04-26,"82 - 1163",163,148,163,0,-15,1
2024-04-27,"40 - 1320",207,207,207,0,0,1
2024-04-27,"40 - 1114",228,231,228,0,3,1
2024-04-27,"2 - 1066",49,40,49,0,-9,1
2024-04-27,"82 - 1163",162,148,162,0,-14,1
2024-04-28,"40 - 1320",207,207,207,0,0,1
2024-04-28,"40 - 1114",228,231,228,0,3,1
2024-04-28,"2 - 1066",49,40,49,0,-9,1
2024-04-28,"82 - 1163",162,148,162,0,-14,1
2024-04-29,"40 - 1320",207,207,207,0,0,1
2024-04-29,"40 - 1114",228,231,228,0,3,1
2024-04-29,"2 - 1066",49,40,49,0,-9,1
2024-04-29,"82 - 1163",166,148,166,0,-18,1
2024-04-30,"40 - 1320",207,207,207,0,0,1
2024-04-30,"40 - 1114",229,231,229,0,2,1
2024-04-30,"2 - 1066",49,40,49,0,-9,1
2024-04-30,"82 - 1163",164,148,164,0,-16,1
2024-05-01,"40 - 1320",207,207,207,0,0,1
2024-05-01,"40 - 1114",229,231,229,0,2,1
2024-05-01,"2 - 1066",49,40,49,0,-9,1
2024-05-01,"82 - 1163",168,148,168,0,-20,1
2024-05-02,"40 - 1320",207,207,207,0,0,1
2024-05-02,"40 - 1114",229,231,229,0,2,1
2024-05-02,"2 - 1066",50,40,50,0,-10,1
2024-05-02,"82 - 1163",171,148,171,0,-23,1
2024-05-03,"40 - 1320",207,207,207,0,0,1
2024-05-03,"40 - 1114",229,231,229,0,2,1
2024-05-03,"2 - 1066",50,40,50,0,-10,1
2024-05-03,"82 - 1163",165,148,161,4,-17,0.975757575757576
2024-05-04,"40 - 1320",207,207,207,0,0,1
2024-05-04,"40 - 1114",229,231,229,0,2,1
2024-05-04,"2 - 1066",50,40,50,0,-10,1
2024-05-04,"82 - 1163",162,148,162,0,-14,1
2024-05-05,"40 - 1320",207,207,207,0,0,1
2024-05-05,"40 - 1114",229,231,229,0,2,1
2024-05-05,"2 - 1066",50,40,50,0,-10,1
2024-05-05,"82 - 1163",161,148,161,0,-13,1
2024-05-06,"40 - 1320",207,207,207,0,0,1
2024-05-06,"40 - 1114",230,231,230,0,1,1
2024-05-06,"2 - 1066",50,40,50,0,-10,1
2024-05-06,"82 - 1163",162,148,162,0,-14,1
2024-05-07,"40 - 1320",207,207,207,0,0,1
2024-05-07,"40 - 1114",230,231,230,0,1,1
2024-05-07,"2 - 1066",50,40,50,0,-10,1
2024-05-07,"82 - 1163",162,148,162,0,-14,1
2024-05-08,"40 - 1320",207,207,207,0,0,1
2024-05-08,"40 - 1114",229,231,229,0,2,1
2024-05-08,"2 - 1066",50,40,50,0,-10,1
2024-05-08,"82 - 1163",163,148,163,0,-15,1
2024-05-09,"40 - 1320",207,207,207,0,0,1
2024-05-09,"40 - 1114",227,231,227,0,4,1
2024-05-09,"2 - 1066",50,40,50,0,-10,1
2024-05-09,"82 - 1163",162,148,162,0,-14,1
2024-05-10,"40 - 1320",207,207,207,0,0,1
2024-05-10,"40 - 1114",228,231,227,1,3,0.995614035087719
2024-05-10,"2 - 1066",50,40,50,0,-10,1
2024-05-10,"82 - 1163",163,148,163,0,-15,1
2024-05-11,"40 - 1320",207,207,207,0,0,1
2024-05-11,"40 - 1114",226,231,226,0,5,1
2024-05-11,"2 - 1066",50,40,50,0,-10,1
2024-05-11,"82 - 1163",163,148,163,0,-15,1
2024-05-12,"40 - 1320",207,207,207,0,0,1
2024-05-12,"40 - 1114",226,231,226,0,5,1
2024-05-12,"2 - 1066",50,40,50,0,-10,1
2024-05-12,"82 - 1163",161,148,161,0,-13,1
2024-05-13,"40 - 1320",207,207,207,0,0,1
2024-05-13,"40 - 1114",228,231,228,0,3,1
2024-05-13,"2 - 1066",50,40,50,0,-10,1
2024-05-13,"82 - 1163",164,148,164,0,-16,1
2024-05-14,"40 - 1320",207,207,206,1,0,0.995169082125604
2024-05-14,"40 - 1114",229,231,229,0,2,1
2024-05-14,"2 - 1066",50,40,50,0,-10,1
2024-05-14,"82 - 1163",160,148,160,0,-12,1
2024-05-15,"40 - 1320",207,207,206,1,0,0.995169082125604
2024-05-15,"40 - 1114",229,231,229,0,2,1
2024-05-15,"2 - 1066",50,40,50,0,-10,1
2024-05-15,"82 - 1163",160,148,160,0,-12,1
2024-05-16,"40 - 1320",207,207,207,0,0,1
2024-05-16,"40 - 1114",229,231,229,0,2,1
2024-05-16,"2 - 1066",50,40,50,0,-10,1
2024-05-16,"82 - 1163",158,148,158,0,-10,1
2024-05-17,"40 - 1320",207,207,207,0,0,1
2024-05-17,"40 - 1114",229,231,229,0,2,1
2024-05-17,"2 - 1066",50,40,50,0,-10,1
2024-05-17,"82 - 1163",162,148,162,0,-14,1
2024-05-18,"40 - 1320",207,207,207,0,0,1
2024-05-18,"40 - 1114",229,231,229,0,2,1
2024-05-18,"2 - 1066",50,40,50,0,-10,1
2024-05-18,"82 - 1163",162,148,162,0,-14,1
2024-05-19,"40 - 1320",207,207,207,0,0,1
2024-05-19,"40 - 1114",229,231,229,0,2,1
2024-05-19,"2 - 1066",50,40,50,0,-10,1
2024-05-19,"82 - 1163",164,148,164,0,-16,1
2024-05-20,"40 - 1320",207,207,207,0,0,1
2024-05-20,"40 - 1114",229,231,229,0,2,1
2024-05-20,"2 - 1066",50,40,50,0,-10,1
2024-05-20,"82 - 1163",162,148,162,0,-14,1
2024-05-21,"40 - 1320",207,207,207,0,0,1
2024-05-21,"40 - 1114",229,231,229,0,2,1
2024-05-21,"2 - 1066",50,40,50,0,-10,1
2024-05-21,"82 - 1163",162,148,162,0,-14,1
2024-05-22,"40 - 1320",207,207,207,0,0,1
2024-05-22,"40 - 1114",229,231,229,0,2,1
2024-05-22,"2 - 1066",50,40,50,0,-10,1
2024-05-22,"82 - 1163",162,148,162,0,-14,1
2024-05-23,"40 - 1320",207,207,207,0,0,1
2024-05-23,"40 - 1114",229,231,229,0,2,1
2024-05-23,"2 - 1066",50,40,50,0,-10,1
2024-05-23,"82 - 1163",163,148,163,0,-15,1
2024-05-24,"40 - 1320",207,207,207,0,0,1
2024-05-24,"40 - 1114",228,231,228,0,3,1
2024-05-24,"2 - 1066",50,40,50,0,-10,1
2024-05-24,"82 - 1163",164,148,164,0,-16,1
2024-05-25,"40 - 1320",207,207,207,0,0,1
2024-05-25,"40 - 1114",229,231,229,0,2,1
2024-05-25,"2 - 1066",50,40,50,0,-10,1
2024-05-25,"82 - 1163",163,148,163,0,-15,1
2024-05-26,"40 - 1320",207,207,207,0,0,1
2024-05-26,"40 - 1114",229,231,229,0,2,1
2024-05-26,"2 - 1066",50,40,50,0,-10,1
2024-05-26,"82 - 1163",162,148,162,0,-14,1
2024-05-27,"40 - 1320",207,207,207,0,0,1
2024-05-27,"40 - 1114",230,231,230,0,1,1
2024-05-27,"2 - 1066",50,40,50,0,-10,1
2024-05-27,"82 - 1163",160,148,160,0,-12,1
2024-05-28,"40 - 1320",207,207,207,0,0,1
2024-05-28,"40 - 1114",230,231,230,0,1,1
2024-05-28,"2 - 1066",50,40,50,0,-10,1
2024-05-28,"82 - 1163",160,148,160,0,-12,1
2024-05-29,"40 - 1320",207,207,207,0,0,1
2024-05-29,"40 - 1114",230,231,230,0,1,1
2024-05-29,"2 - 1066",50,40,50,0,-10,1
2024-05-29,"82 - 1163",160,148,160,0,-12,1
2024-05-30,"40 - 1320",207,207,207,0,0,1
2024-05-30,"40 - 1114",230,231,230,0,1,1
2024-05-30,"2 - 1066",50,40,50,0,-10,1
2024-05-30,"82 - 1163",159,148,159,0,-11,1
2024-05-31,"40 - 1320",207,207,207,0,0,1
2024-05-31,"40 - 1114",230,231,230,0,1,1
2024-05-31,"2 - 1066",50,40,50,0,-10,1
2024-05-31,"82 - 1163",157,148,157,0,-9,1
2024-06-01,"40 - 1320",206,207,206,0,1,1
2024-06-01,"40 - 1114",229,231,229,0,2,1
2024-06-01,"2 - 1066",49,40,49,0,-9,1
2024-06-01,"82 - 1163",156,134,156,0,-22,1
2024-06-02,"40 - 1320",207,207,207,0,0,1
2024-06-02,"40 - 1114",229,231,229,0,2,1
2024-06-02,"2 - 1066",49,40,49,0,-9,1
2024-06-02,"82 - 1163",157,148,157,0,-9,1
2024-06-03,"40 - 1320",207,207,206,1,0,0.995169082125604
2024-06-03,"40 - 1114",228,231,228,0,3,1
2024-06-03,"2 - 1066",49,40,49,0,-9,1
2024-06-03,"82 - 1163",158,148,158,0,-10,1
2024-06-04,"40 - 1320",207,207,206,1,0,0.995169082125604
2024-06-04,"40 - 1114",228,231,228,0,3,1
2024-06-04,"2 - 1066",48,40,48,0,-8,1
2024-06-04,"82 - 1163",157,148,157,0,-9,1
2024-06-05,"40 - 1320",207,207,207,0,0,1
2024-06-05,"40 - 1114",228,231,228,0,3,1
2024-06-05,"2 - 1066",48,40,48,0,-8,1
2024-06-05,"82 - 1163",158,148,158,0,-10,1
2024-06-06,"40 - 1320",207,207,207,0,0,1
2024-06-06,"40 - 1114",228,231,228,0,3,1
2024-06-06,"2 - 1066",48,40,48,0,-8,1
2024-06-06,"82 - 1163",158,148,158,0,-10,1
2024-06-07,"40 - 1320",207,207,207,0,0,1
2024-06-07,"40 - 1114",228,231,228,0,3,1
2024-06-07,"2 - 1066",48,40,48,0,-8,1
2024-06-07,"82 - 1163",159,148,159,0,-11,1
2024-06-08,"40 - 1320",207,207,207,0,0,1
2024-06-08,"40 - 1114",227,231,227,0,4,1
2024-06-08,"2 - 1066",47,40,47,0,-7,1
2024-06-08,"82 - 1163",158,148,158,0,-10,1
2024-06-09,"40 - 1320",207,207,207,0,0,1
2024-06-09,"40 - 1114",227,231,227,0,4,1
2024-06-09,"2 - 1066",47,40,47,0,-7,1
2024-06-09,"82 - 1163",158,148,158,0,-10,1
2024-06-10,"40 - 1320",207,207,207,0,0,1
2024-06-10,"40 - 1114",228,231,228,0,3,1
2024-06-10,"2 - 1066",47,40,47,0,-7,1
2024-06-10,"82 - 1163",160,148,160,0,-12,1
2024-06-11,"40 - 1320",207,207,207,0,0,1
2024-06-11,"40 - 1114",227,231,226,1,4,0.995594713656388
2024-06-11,"2 - 1066",47,40,47,0,-7,1
2024-06-11,"82 - 1163",160,148,160,0,-12,1
2024-06-12,"40 - 1320",207,207,207,0,0,1
2024-06-12,"40 - 1114",229,231,228,1,2,0.995633187772926
2024-06-12,"2 - 1066",48,40,48,0,-8,1
2024-06-12,"82 - 1163",157,148,157,0,-9,1
2024-06-13,"40 - 1320",207,207,207,0,0,1
2024-06-13,"40 - 1114",229,231,228,1,2,0.995633187772926
2024-06-13,"2 - 1066",48,40,48,0,-8,1
2024-06-13,"82 - 1163",159,148,158,1,-11,0.993710691823899
2024-06-14,"40 - 1320",207,207,207,0,0,1
2024-06-14,"40 - 1114",229,231,229,0,2,1
2024-06-14,"2 - 1066",48,40,48,0,-8,1
2024-06-14,"82 - 1163",161,148,161,0,-13,1
2024-06-15,"40 - 1320",207,207,207,0,0,1
2024-06-15,"40 - 1114",229,231,229,0,2,1
2024-06-15,"2 - 1066",48,40,48,0,-8,1
2024-06-15,"82 - 1163",161,148,161,0,-13,1
2024-06-16,"40 - 1320",207,207,207,0,0,1
2024-06-16,"40 - 1114",229,231,229,0,2,1
2024-06-16,"2 - 1066",48,40,48,0,-8,1
2024-06-16,"82 - 1163",163,148,162,1,-15,0.993865030674847
2024-06-17,"40 - 1320",206,207,206,0,1,1
2024-06-17,"40 - 1114",230,231,230,0,1,1
2024-06-17,"2 - 1066",48,40,48,0,-8,1
2024-06-17,"82 - 1163",167,148,167,0,-19,1
2024-06-18,"40 - 1320",207,207,207,0,0,1
2024-06-18,"40 - 1114",231,231,231,0,0,1
2024-06-18,"2 - 1066",48,40,48,0,-8,1
2024-06-18,"82 - 1163",168,148,168,0,-20,1
2024-06-19,"40 - 1320",207,207,207,0,0,1
2024-06-19,"40 - 1114",231,231,231,0,0,1
2024-06-19,"2 - 1066",48,40,48,0,-8,1
2024-06-19,"82 - 1163",170,148,170,0,-22,1
2024-06-20,"40 - 1320",207,207,207,0,0,1
2024-06-20,"40 - 1114",231,231,231,0,0,1
2024-06-20,"2 - 1066",48,40,48,0,-8,1
2024-06-20,"82 - 1163",172,148,172,0,-24,1
2024-06-21,"40 - 1320",207,207,207,0,0,1
2024-06-21,"40 - 1114",231,231,231,0,0,1
2024-06-21,"2 - 1066",48,40,48,0,-8,1
2024-06-21,"82 - 1163",171,148,171,0,-23,1
2024-06-22,"40 - 1320",207,207,207,0,0,1
2024-06-22,"40 - 1114",231,231,231,0,0,1
2024-06-22,"2 - 1066",48,40,48,0,-8,1
2024-06-22,"82 - 1163",171,148,171,0,-23,1
2024-06-23,"40 - 1320",207,207,207,0,0,1
2024-06-23,"40 - 1114",231,231,231,0,0,1
2024-06-23,"2 - 1066",48,40,48,0,-8,1
2024-06-23,"82 - 1163",171,148,171,0,-23,1
2024-06-24,"40 - 1320",207,207,207,0,0,1
2024-06-24,"40 - 1114",231,231,231,0,0,1
2024-06-24,"2 - 1066",48,40,48,0,-8,1
2024-06-24,"82 - 1163",167,148,167,0,-19,1
2024-06-25,"40 - 1320",207,207,207,0,0,1
2024-06-25,"40 - 1114",231,231,231,0,0,1
2024-06-25,"2 - 1066",48,40,48,0,-8,1
2024-06-25,"82 - 1163",170,148,169,1,-22,0.994117647058824
2024-06-26,"40 - 1320",207,207,207,0,0,1
2024-06-26,"40 - 1114",231,231,231,0,0,1
2024-06-26,"2 - 1066",47,40,47,0,-7,1
2024-06-26,"82 - 1163",168,148,168,0,-20,1
2024-06-27,"40 - 1320",207,207,207,0,0,1
2024-06-27,"40 - 1114",231,231,231,0,0,1
2024-06-27,"2 - 1066",47,40,47,0,-7,1
2024-06-27,"82 - 1163",165,148,163,2,-17,0.987878787878788
2024-06-28,"40 - 1320",207,207,207,0,0,1
2024-06-28,"40 - 1114",230,231,230,0,1,1
2024-06-28,"2 - 1066",47,40,47,0,-7,1
2024-06-28,"82 - 1163",161,148,161,0,-13,1
2024-06-29,"40 - 1320",207,207,207,0,0,1
2024-06-29,"40 - 1114",230,231,230,0,1,1
2024-06-29,"2 - 1066",47,40,47,0,-7,1
2024-06-29,"82 - 1163",163,148,163,0,-15,1
2024-06-30,"40 - 1320",207,207,207,0,0,1
2024-06-30,"40 - 1114",229,231,229,0,2,1
2024-06-30,"2 - 1066",47,40,47,0,-7,1
2024-06-30,"82 - 1163",163,148,163,0,-15,1
2024-07-01,"40 - 1320",207,207,207,0,0,1
2024-07-01,"40 - 1114",228,231,228,0,3,1
2024-07-01,"2 - 1066",47,40,47,0,-7,1
2024-07-01,"82 - 1163",163,148,163,0,-15,1
2024-07-02,"40 - 1320",206,207,206,0,1,1
2024-07-02,"40 - 1114",228,231,228,0,3,1
2024-07-02,"2 - 1066",47,40,47,0,-7,1
2024-07-02,"82 - 1163",162,148,162,0,-14,1
2024-07-03,"40 - 1320",207,207,207,0,0,1
2024-07-03,"40 - 1114",228,231,228,0,3,1
2024-07-03,"2 - 1066",47,40,47,0,-7,1
2024-07-03,"82 - 1163",161,148,161,0,-13,1
2024-07-04,"40 - 1320",207,207,207,0,0,1
2024-07-04,"40 - 1114",228,231,228,0,3,1
2024-07-04,"2 - 1066",47,40,47,0,-7,1
2024-07-04,"82 - 1163",162,148,162,0,-14,1
2024-07-05,"40 - 1320",207,207,207,0,0,1
2024-07-05,"40 - 1114",230,231,230,0,1,1
2024-07-05,"2 - 1066",47,40,47,0,-7,1
2024-07-05,"82 - 1163",164,148,164,0,-16,1
2024-07-06,"40 - 1320",207,207,207,0,0,1
2024-07-06,"40 - 1114",230,231,230,0,1,1
2024-07-06,"2 - 1066",47,40,47,0,-7,1
2024-07-06,"82 - 1163",164,148,164,0,-16,1
2024-07-07,"40 - 1320",207,207,207,0,0,1
2024-07-07,"40 - 1114",230,231,230,0,1,1
2024-07-07,"2 - 1066",47,40,47,0,-7,1
2024-07-07,"82 - 1163",164,148,164,0,-16,1
2024-07-08,"40 - 1320",207,207,207,0,0,1
2024-07-08,"40 - 1114",231,231,230,1,0,0.995670995670996
2024-07-08,"2 - 1066",47,40,47,0,-7,1
2024-07-08,"82 - 1163",163,148,163,0,-15,1
2024-07-09,"40 - 1320",207,207,206,1,0,0.995169082125604
2024-07-09,"40 - 1114",229,231,229,0,2,1
2024-07-09,"2 - 1066",47,40,47,0,-7,1
2024-07-09,"82 - 1163",161,148,161,0,-13,1
2024-07-10,"40 - 1320",206,207,206,0,1,1
2024-07-10,"40 - 1114",229,231,229,0,2,1
2024-07-10,"2 - 1066",47,40,47,0,-7,1
2024-07-10,"82 - 1163",160,148,160,0,-12,1
2024-07-11,"40 - 1320",207,207,207,0,0,1
2024-07-11,"40 - 1114",229,231,229,0,2,1
2024-07-11,"2 - 1066",47,40,47,0,-7,1
2024-07-11,"82 - 1163",161,148,161,0,-13,1
2024-07-12,"40 - 1320",207,207,207,0,0,1
2024-07-12,"40 - 1114",229,231,228,1,2,0.995633187772926
2024-07-12,"2 - 1066",47,40,47,0,-7,1
2024-07-12,"82 - 1163",161,148,161,0,-13,1
2024-07-13,"40 - 1320",207,207,207,0,0,1
2024-07-13,"40 - 1114",229,231,228,1,2,0.995633187772926
2024-07-13,"2 - 1066",47,40,47,0,-7,1
2024-07-13,"82 - 1163",160,148,160,0,-12,1
2024-07-14,"40 - 1320",207,207,207,0,0,1
2024-07-14,"40 - 1114",229,231,228,1,2,0.995633187772926
2024-07-14,"2 - 1066",47,40,47,0,-7,1
2024-07-14,"82 - 1163",164,148,163,1,-16,0.99390243902439
2024-07-15,"40 - 1320",207,207,207,0,0,1
2024-07-15,"40 - 1114",227,231,227,0,4,1
2024-07-15,"2 - 1066",47,40,47,0,-7,1
2024-07-15,"82 - 1163",161,148,161,0,-13,1
2024-07-16,"40 - 1320",207,207,207,0,0,1
2024-07-16,"40 - 1114",227,231,227,0,4,1
2024-07-16,"2 - 1066",47,40,47,0,-7,1
2024-07-16,"82 - 1163",162,148,161,1,-14,0.993827160493827
2024-07-17,"40 - 1320",207,207,207,0,0,1
2024-07-17,"40 - 1114",227,231,227,0,4,1
2024-07-17,"2 - 1066",47,40,47,0,-7,1
2024-07-17,"82 - 1163",162,148,162,0,-14,1
2024-07-18,"40 - 1320",207,207,207,0,0,1
2024-07-18,"40 - 1114",228,231,228,0,3,1
2024-07-18,"2 - 1066",47,40,47,0,-7,1
2024-07-18,"82 - 1163",163,148,163,0,-15,1
2024-07-19,"40 - 1320",207,207,207,0,0,1
2024-07-19,"40 - 1114",228,231,228,0,3,1
2024-07-19,"2 - 1066",47,40,47,0,-7,1
2024-07-19,"82 - 1163",163,148,163,0,-15,1
2024-07-20,"40 - 1320",207,207,207,0,0,1
2024-07-20,"40 - 1114",228,231,228,0,3,1
2024-07-20,"2 - 1066",47,40,47,0,-7,1
2024-07-20,"82 - 1163",162,148,162,0,-14,1
2024-07-21,"40 - 1320",207,207,207,0,0,1
2024-07-21,"40 - 1114",228,231,228,0,3,1
2024-07-21,"2 - 1066",47,40,47,0,-7,1
2024-07-21,"82 - 1163",161,148,161,0,-13,1
2024-07-22,"40 - 1320",207,207,207,0,0,1
2024-07-22,"40 - 1114",229,231,229,0,2,1
2024-07-22,"2 - 1066",47,40,47,0,-7,1
2024-07-22,"82 - 1163",161,148,161,0,-13,1
2024-07-23,"40 - 1320",207,207,207,0,0,1
2024-07-23,"40 - 1114",229,231,229,0,2,1
2024-07-23,"2 - 1066",47,40,47,0,-7,1
2024-07-23,"82 - 1163",162,148,162,0,-14,1
2024-07-24,"40 - 1320",207,207,207,0,0,1
2024-07-24,"40 - 1114",229,231,229,0,2,1
2024-07-24,"2 - 1066",47,40,47,0,-7,1
2024-07-24,"82 - 1163",163,148,162,1,-15,0.993865030674847
2024-07-25,"40 - 1320",207,207,207,0,0,1
2024-07-25,"40 - 1114",229,231,229,0,2,1
2024-07-25,"2 - 1066",46,40,46,0,-6,1
2024-07-25,"82 - 1163",163,148,162,1,-15,0.993865030674847
2024-07-26,"40 - 1320",207,207,205,2,0,0.990338164251208
2024-07-26,"40 - 1114",229,231,229,0,2,1
2024-07-26,"2 - 1066",46,40,46,0,-6,1
2024-07-26,"82 - 1163",172,148,172,0,-24,1
2024-07-27,"40 - 1320",206,207,206,0,1,1
2024-07-27,"40 - 1114",229,231,229,0,2,1
2024-07-27,"2 - 1066",46,40,46,0,-6,1
2024-07-27,"82 - 1163",172,148,172,0,-24,1
2024-07-28,"40 - 1320",206,207,206,0,1,1
2024-07-28,"40 - 1114",229,231,229,0,2,1
2024-07-28,"2 - 1066",46,40,46,0,-6,1
2024-07-28,"82 - 1163",170,134,170,0,-36,1
2024-07-29,"40 - 1320",207,207,207,0,0,1
2024-07-29,"40 - 1114",229,231,229,0,2,1
2024-07-29,"2 - 1066",45,40,45,0,-5,1
2024-07-29,"82 - 1163",171,148,171,0,-23,1
2024-07-30,"40 - 1320",207,207,207,0,0,1
2024-07-30,"40 - 1114",230,231,230,0,1,1
2024-07-30,"2 - 1066",45,40,45,0,-5,1
2024-07-30,"82 - 1163",171,148,171,0,-23,1
2024-07-31,"40 - 1320",207,207,207,0,0,1
2024-07-31,"40 - 1114",228,231,228,0,3,1
2024-07-31,"2 - 1066",45,40,45,0,-5,1
2024-07-31,"82 - 1163",171,148,171,0,-23,1
2024-08-01,"40 - 1320",207,207,207,0,0,1
2024-08-01,"40 - 1114",227,231,226,1,4,0.995594713656388
2024-08-01,"2 - 1066",45,40,45,0,-5,1
2024-08-01,"82 - 1163",169,148,169,0,-21,1
2024-08-02,"40 - 1320",207,207,207,0,0,1
2024-08-02,"40 - 1114",227,231,227,0,4,1
2024-08-02,"2 - 1066",45,40,45,0,-5,1
2024-08-02,"82 - 1163",169,148,169,0,-21,1
2024-08-03,"40 - 1320",207,207,207,0,0,1
2024-08-03,"40 - 1114",227,231,227,0,4,1
2024-08-03,"2 - 1066",45,40,45,0,-5,1
2024-08-03,"82 - 1163",168,148,168,0,-20,1
2024-08-04,"40 - 1320",206,207,206,0,1,1
2024-08-04,"40 - 1114",227,231,227,0,4,1
2024-08-04,"2 - 1066",45,40,45,0,-5,1
2024-08-04,"82 - 1163",168,148,168,0,-20,1
2024-08-05,"40 - 1320",207,207,207,0,0,1
2024-08-05,"40 - 1114",229,231,228,1,2,0.995633187772926
2024-08-05,"2 - 1066",45,40,45,0,-5,1
2024-08-05,"82 - 1163",167,148,167,0,-19,1
2024-08-06,"40 - 1320",206,207,206,0,1,1
2024-08-06,"40 - 1114",228,231,228,0,3,1
2024-08-06,"2 - 1066",45,40,45,0,-5,1
2024-08-06,"82 - 1163",167,148,167,0,-19,1
2024-08-07,"40 - 1320",207,207,207,0,0,1
2024-08-07,"40 - 1114",227,231,227,0,4,1
2024-08-07,"2 - 1066",45,40,45,0,-5,1
2024-08-07,"82 - 1163",167,148,167,0,-19,1
2024-08-08,"40 - 1320",207,207,207,0,0,1
2024-08-08,"40 - 1114",226,231,226,0,5,1
2024-08-08,"2 - 1066",45,40,45,0,-5,1
2024-08-08,"82 - 1163",166,148,166,0,-18,1
2024-08-09,"40 - 1320",207,207,207,0,0,1
2024-08-09,"40 - 1114",226,231,225,1,5,0.995575221238938
2024-08-09,"2 - 1066",45,40,45,0,-5,1
2024-08-09,"82 - 1163",166,148,166,0,-18,1
2024-08-10,"40 - 1320",207,207,207,0,0,1
2024-08-10,"40 - 1114",226,231,226,0,5,1
2024-08-10,"2 - 1066",44,40,44,0,-4,1
2024-08-10,"82 - 1163",165,148,165,0,-17,1
2024-08-11,"40 - 1320",207,207,207,0,0,1
2024-08-11,"40 - 1114",226,231,226,0,5,1
2024-08-11,"2 - 1066",44,40,44,0,-4,1
2024-08-11,"82 - 1163",164,148,164,0,-16,1
2024-08-12,"40 - 1320",206,207,206,0,1,1
2024-08-12,"40 - 1114",226,231,226,0,5,1
2024-08-12,"2 - 1066",44,40,44,0,-4,1
2024-08-12,"82 - 1163",164,148,164,0,-16,1
2024-08-13,"40 - 1320",206,207,205,1,1,0.995145631067961
2024-08-13,"40 - 1114",228,231,227,1,3,0.995614035087719
2024-08-13,"2 - 1066",44,40,44,0,-4,1
2024-08-13,"82 - 1163",164,148,164,0,-16,1
2024-08-14,"40 - 1320",206,207,206,0,1,1
2024-08-14,"40 - 1114",227,231,227,0,4,1
2024-08-14,"2 - 1066",42,40,42,0,-2,1
2024-08-14,"82 - 1163",165,148,165,0,-17,1
2024-08-15,"40 - 1320",207,207,206,1,0,0.995169082125604
2024-08-15,"40 - 1114",225,231,225,0,6,1
2024-08-15,"2 - 1066",42,40,42,0,-2,1
2024-08-15,"82 - 1163",166,148,166,0,-18,1
2024-08-16,"40 - 1320",207,207,207,0,0,1
2024-08-16,"40 - 1114",225,231,225,0,6,1
2024-08-16,"2 - 1066",42,40,42,0,-2,1
2024-08-16,"82 - 1163",168,148,168,0,-20,1
2024-08-17,"40 - 1320",207,207,207,0,0,1
2024-08-17,"40 - 1114",226,231,226,0,5,1
2024-08-17,"2 - 1066",42,40,42,0,-2,1
2024-08-17,"82 - 1163",166,148,166,0,-18,1
2024-08-18,"40 - 1320",207,207,207,0,0,1
2024-08-18,"40 - 1114",227,231,227,0,4,1
2024-08-18,"2 - 1066",42,40,42,0,-2,1
2024-08-18,"82 - 1163",167,148,167,0,-19,1
2024-08-19,"40 - 1320",207,207,207,0,0,1
2024-08-19,"40 - 1114",225,231,225,0,6,1
2024-08-19,"2 - 1066",42,40,42,0,-2,1
2024-08-19,"82 - 1163",167,148,167,0,-19,1
2024-08-20,"40 - 1320",207,207,207,0,0,1
2024-08-20,"40 - 1114",224,231,222,2,7,0.991071428571429
2024-08-20,"2 - 1066",42,40,42,0,-2,1
2024-08-20,"82 - 1163",167,148,167,0,-19,1
2024-08-21,"40 - 1320",207,207,207,0,0,1
2024-08-21,"40 - 1114",223,231,221,2,8,0.991031390134529
2024-08-21,"2 - 1066",44,40,44,0,-4,1
2024-08-21,"82 - 1163",168,148,168,0,-20,1
2024-08-22,"40 - 1320",207,207,207,0,0,1
2024-08-22,"40 - 1114",223,232,223,0,9,1
2024-08-22,"2 - 1066",44,40,44,0,-4,1
2024-08-22,"82 - 1163",167,148,167,0,-19,1
2024-08-23,"40 - 1320",207,207,207,0,0,1
2024-08-23,"40 - 1114",224,232,224,0,8,1
2024-08-23,"2 - 1066",44,40,44,0,-4,1
2024-08-23,"82 - 1163",166,148,166,0,-18,1
2024-08-24,"40 - 1320",207,207,207,0,0,1
2024-08-24,"40 - 1114",223,232,223,0,9,1
2024-08-24,"2 - 1066",43,40,43,0,-3,1
2024-08-24,"82 - 1163",161,148,161,0,-13,1
2024-08-25,"40 - 1320",207,207,207,0,0,1
2024-08-25,"40 - 1114",223,232,223,0,9,1
2024-08-25,"2 - 1066",43,40,43,0,-3,1
2024-08-25,"82 - 1163",162,148,162,0,-14,1
2024-08-26,"40 - 1320",207,207,206,1,0,0.995169082125604
2024-08-26,"40 - 1114",223,232,223,0,9,1
2024-08-26,"2 - 1066",43,40,43,0,-3,1
2024-08-26,"82 - 1163",161,148,161,0,-13,1
2024-08-27,"40 - 1320",207,207,206,1,0,0.995169082125604
2024-08-27,"40 - 1114",224,232,224,0,8,1
2024-08-27,"2 - 1066",44,40,44,0,-4,1
2024-08-27,"82 - 1163",161,148,161,0,-13,1
2024-08-28,"40 - 1320",207,207,206,1,0,0.995169082125604
2024-08-28,"40 - 1114",223,232,223,0,9,1
2024-08-28,"2 - 1066",44,40,44,0,-4,1
2024-08-28,"82 - 1163",161,148,161,0,-13,1
2024-08-29,"40 - 1320",207,207,207,0,0,1
2024-08-29,"40 - 1114",224,232,224,0,8,1
2024-08-29,"2 - 1066",44,40,44,0,-4,1
2024-08-29,"82 - 1163",162,148,162,0,-14,1
2024-08-30,"40 - 1320",206,207,206,0,1,1
2024-08-30,"40 - 1114",226,232,226,0,6,1
2024-08-30,"2 - 1066",44,40,44,0,-4,1
2024-08-30,"82 - 1163",160,148,160,0,-12,1
2024-08-31,"40 - 1320",203,207,203,0,4,1
2024-08-31,"40 - 1114",225,232,225,0,7,1
2024-08-31,"2 - 1066",44,40,44,0,-4,1
2024-08-31,"82 - 1163",159,134,159,0,-25,1
2024-09-01,"40 - 1320",203,207,203,0,4,1
2024-09-01,"40 - 1114",222,232,222,0,10,1
2024-09-01,"2 - 1066",44,40,44,0,-4,1
2024-09-01,"82 - 1163",160,134,160,0,-26,1
2024-09-02,"40 - 1320",205,207,204,1,2,0.995121951219512
2024-09-02,"40 - 1114",221,232,221,0,11,1
2024-09-02,"2 - 1066",44,40,44,0,-4,1
2024-09-02,"82 - 1163",160,134,160,0,-26,1
2024-09-03,"40 - 1320",204,207,203,1,3,0.995098039215686
2024-09-03,"40 - 1114",220,232,220,0,12,1
2024-09-03,"2 - 1066",44,40,44,0,-4,1
2024-09-03,"82 - 1163",161,148,161,0,-13,1
2024-09-04,"40 - 1320",203,207,203,0,4,1
2024-09-04,"40 - 1114",221,232,221,0,11,1
2024-09-04,"2 - 1066",44,40,44,0,-4,1
2024-09-04,"82 - 1163",160,148,160,0,-12,1
2024-09-05,"40 - 1320",204,207,203,1,3,0.995098039215686
2024-09-05,"40 - 1114",222,232,220,2,10,0.990990990990991
2024-09-05,"2 - 1066",44,40,44,0,-4,1
2024-09-05,"82 - 1163",160,148,160,0,-12,1
2024-09-06,"40 - 1320",204,207,204,0,3,1
2024-09-06,"40 - 1114",218,232,218,0,14,1
2024-09-06,"2 - 1066",44,40,44,0,-4,1
2024-09-06,"82 - 1163",162,148,162,0,-14,1
2024-09-07,"40 - 1320",204,207,204,0,3,1
2024-09-07,"40 - 1114",220,232,220,0,12,1
2024-09-07,"2 - 1066",44,40,44,0,-4,1
2024-09-07,"82 - 1163",162,148,162,0,-14,1
2024-09-08,"40 - 1320",204,207,204,0,3,1
2024-09-08,"40 - 1114",222,232,222,0,10,1
2024-09-08,"2 - 1066",44,40,44,0,-4,1
2024-09-08,"82 - 1163",162,148,162,0,-14,1
2024-09-09,"40 - 1320",205,207,204,1,2,0.995121951219512
2024-09-09,"40 - 1114",222,232,222,0,10,1
2024-09-09,"2 - 1066",45,40,45,0,-5,1
2024-09-09,"82 - 1163",163,148,163,0,-15,1
2024-09-10,"40 - 1320",205,207,205,0,2,1
2024-09-10,"40 - 1114",221,232,221,0,11,1
2024-09-10,"2 - 1066",45,40,45,0,-5,1
2024-09-10,"82 - 1163",163,148,163,0,-15,1
2024-09-11,"40 - 1320",205,207,205,0,2,1
2024-09-11,"40 - 1114",223,232,223,0,9,1
2024-09-11,"2 - 1066",45,40,45,0,-5,1
2024-09-11,"82 - 1163",163,148,163,0,-15,1
2024-09-12,"40 - 1320",205,207,205,0,2,1
2024-09-12,"40 - 1114",226,232,223,3,6,0.986725663716814
2024-09-12,"2 - 1066",45,40,45,0,-5,1
2024-09-12,"82 - 1163",167,148,167,0,-19,1
2024-09-13,"40 - 1320",205,207,205,0,2,1
2024-09-13,"40 - 1114",225,232,225,0,7,1
2024-09-13,"2 - 1066",45,40,45,0,-5,1
2024-09-13,"82 - 1163",165,148,165,0,-17,1
2024-09-14,"40 - 1320",205,207,204,1,2,0.995121951219512
2024-09-14,"40 - 1114",226,232,226,0,6,1
2024-09-14,"2 - 1066",45,40,45,0,-5,1
2024-09-14,"82 - 1163",165,148,165,0,-17,1
2024-09-15,"40 - 1320",204,207,204,0,3,1
2024-09-15,"40 - 1114",226,232,226,0,6,1
2024-09-15,"2 - 1066",45,40,45,0,-5,1
2024-09-15,"82 - 1163",166,148,166,0,-18,1
2024-09-16,"40 - 1320",206,207,205,1,1,0.995145631067961
2024-09-16,"40 - 1114",227,232,227,0,5,1
2024-09-16,"2 - 1066",45,40,45,0,-5,1
2024-09-16,"82 - 1163",166,148,166,0,-18,1
2024-09-17,"40 - 1320",206,207,205,1,1,0.995145631067961
2024-09-17,"40 - 1114",228,232,228,0,4,1
2024-09-17,"2 - 1066",45,40,45,0,-5,1
2024-09-17,"82 - 1163",165,148,165,0,-17,1
2024-09-18,"40 - 1320",206,207,206,0,1,1
2024-09-18,"40 - 1114",227,232,227,0,5,1
2024-09-18,"2 - 1066",45,40,45,0,-5,1
2024-09-18,"82 - 1163",166,148,166,0,-18,1
2024-09-19,"40 - 1320",206,207,206,0,1,1
2024-09-19,"40 - 1114",229,232,229,0,3,1
2024-09-19,"2 - 1066",45,40,45,0,-5,1
2024-09-19,"82 - 1163",164,148,164,0,-16,1
2024-09-20,"40 - 1320",206,207,206,0,1,1
2024-09-20,"40 - 1114",229,232,229,0,3,1
2024-09-20,"2 - 1066",45,40,45,0,-5,1
2024-09-20,"82 - 1163",163,148,163,0,-15,1
2024-09-21,"40 - 1320",206,207,206,0,1,1
2024-09-21,"40 - 1114",228,232,228,0,4,1
2024-09-21,"2 - 1066",45,40,45,0,-5,1
2024-09-21,"82 - 1163",163,148,163,0,-15,1
2024-09-22,"40 - 1320",207,207,207,0,0,1
2024-09-22,"40 - 1114",228,232,228,0,4,1
2024-09-22,"2 - 1066",45,40,45,0,-5,1
2024-09-22,"82 - 1163",163,148,163,0,-15,1
2024-09-23,"40 - 1320",207,207,207,0,0,1
2024-09-23,"40 - 1114",228,232,228,0,4,1
2024-09-23,"2 - 1066",45,40,45,0,-5,1
2024-09-23,"82 - 1163",163,148,163,0,-15,1
2024-09-24,"40 - 1320",207,207,207,0,0,1
2024-09-24,"40 - 1114",228,232,228,0,4,1
2024-09-24,"2 - 1066",45,40,45,0,-5,1
2024-09-24,"82 - 1163",164,148,164,0,-16,1
2024-09-25,"40 - 1320",207,207,207,0,0,1
2024-09-25,"40 - 1114",229,232,228,1,3,0.995633187772926
2024-09-25,"2 - 1066",45,40,45,0,-5,1
2024-09-25,"82 - 1163",164,148,164,0,-16,1
2024-09-26,"40 - 1320",207,207,207,0,0,1
2024-09-26,"40 - 1114",229,232,228,1,3,0.995633187772926
2024-09-26,"2 - 1066",45,40,45,0,-5,1
2024-09-26,"82 - 1163",162,148,162,0,-14,1
2024-09-27,"40 - 1320",207,207,207,0,0,1
2024-09-27,"40 - 1114",229,232,229,0,3,1
2024-09-27,"2 - 1066",45,40,45,0,-5,1
2024-09-27,"82 - 1163",162,148,162,0,-14,1
2024-09-28,"40 - 1320",207,207,207,0,0,1
2024-09-28,"40 - 1114",229,232,229,0,3,1
2024-09-28,"2 - 1066",45,40,45,0,-5,1
2024-09-28,"82 - 1163",162,148,162,0,-14,1
2024-09-29,"40 - 1320",206,207,206,0,1,1
2024-09-29,"40 - 1114",229,232,229,0,3,1
2024-09-29,"2 - 1066",45,40,45,0,-5,1
2024-09-29,"82 - 1163",161,148,161,0,-13,1
2024-09-30,"40 - 1320",207,207,206,1,0,0.995169082125604
2024-09-30,"40 - 1114",228,232,228,0,4,1
2024-09-30,"2 - 1066",45,40,45,0,-5,1
2024-09-30,"82 - 1163",161,148,161,0,-13,1
2024-10-01,"40 - 1320",207,207,203,4,0,0.980676328502415
2024-10-01,"40 - 1114",227,232,227,0,5,1
2024-10-01,"2 - 1066",45,40,45,0,-5,1
2024-10-01,"82 - 1163",163,148,163,0,-15,1
2024-10-02,"40 - 1320",203,207,203,0,4,1
2024-10-02,"40 - 1114",226,232,226,0,6,1
2024-10-02,"2 - 1066",45,40,45,0,-5,1
2024-10-02,"82 - 1163",162,148,162,0,-14,1
2024-10-03,"40 - 1320",203,207,202,1,4,0.995073891625616
2024-10-03,"40 - 1114",226,232,226,0,6,1
2024-10-03,"2 - 1066",45,40,45,0,-5,1
2024-10-03,"82 - 1163",162,134,162,0,-28,1
2024-10-04,"40 - 1320",205,207,202,3,2,0.985365853658537
2024-10-04,"40 - 1114",227,232,226,1,5,0.995594713656388
2024-10-04,"2 - 1066",45,40,45,0,-5,1
2024-10-04,"82 - 1163",162,134,162,0,-28,1
2024-10-05,"40 - 1320",204,207,204,0,3,1
2024-10-05,"40 - 1114",225,232,225,0,7,1
2024-10-05,"2 - 1066",45,40,45,0,-5,1
2024-10-05,"82 - 1163",163,134,160,3,-29,0.98159509202454
2024-10-06,"40 - 1320",206,207,206,0,1,1
2024-10-06,"40 - 1114",226,232,226,0,6,1
2024-10-06,"2 - 1066",45,40,45,0,-5,1
2024-10-06,"82 - 1163",160,134,160,0,-26,1
2024-10-07,"40 - 1320",206,207,206,0,1,1
2024-10-07,"40 - 1114",226,232,226,0,6,1
2024-10-07,"2 - 1066",45,40,45,0,-5,1
2024-10-07,"82 - 1163",160,134,160,0,-26,1
2024-10-08,"40 - 1320",206,207,206,0,1,1
2024-10-08,"40 - 1114",228,232,228,0,4,1
2024-10-08,"2 - 1066",47,40,45,2,-7,0.957446808510638
2024-10-08,"82 - 1163",162,148,162,0,-14,1
2024-10-09,"40 - 1320",207,207,206,1,0,0.995169082125604
2024-10-09,"40 - 1114",228,232,228,0,4,1
2024-10-09,"2 - 1066",45,40,45,0,-5,1
2024-10-09,"82 - 1163",162,148,162,0,-14,1
2024-10-10,"40 - 1320",206,207,206,0,1,1
2024-10-10,"40 - 1114",229,232,229,0,3,1
2024-10-10,"2 - 1066",45,40,45,0,-5,1
2024-10-10,"82 - 1163",164,148,164,0,-16,1
2024-10-11,"40 - 1320",206,207,206,0,1,1
2024-10-11,"40 - 1114",230,232,230,0,2,1
2024-10-11,"2 - 1066",45,40,45,0,-5,1
2024-10-11,"82 - 1163",166,148,166,0,-18,1
2024-10-12,"40 - 1320",206,207,206,0,1,1
2024-10-12,"40 - 1114",230,232,230,0,2,1
2024-10-12,"2 - 1066",45,40,45,0,-5,1
2024-10-12,"82 - 1163",166,148,166,0,-18,1
2024-10-13,"40 - 1320",206,207,206,0,1,1
2024-10-13,"40 - 1114",230,232,230,0,2,1
2024-10-13,"2 - 1066",45,40,45,0,-5,1
2024-10-13,"82 - 1163",165,148,165,0,-17,1
2024-10-14,"40 - 1320",206,207,206,0,1,1
2024-10-14,"40 - 1114",230,232,230,0,2,1
2024-10-14,"2 - 1066",45,40,45,0,-5,1
2024-10-14,"82 - 1163",166,148,166,0,-18,1
2024-10-15,"40 - 1320",206,207,206,0,1,1
2024-10-15,"40 - 1114",230,232,230,0,2,1
2024-10-15,"2 - 1066",45,40,45,0,-5,1
2024-10-15,"82 - 1163",167,148,166,1,-19,0.994011976047904
2024-10-16,"40 - 1320",207,207,206,1,0,0.995169082125604
2024-10-16,"40 - 1114",230,232,230,0,2,1
2024-10-16,"2 - 1066",45,40,45,0,-5,1
2024-10-16,"82 - 1163",163,148,163,0,-15,1
2024-10-17,"40 - 1320",207,207,207,0,0,1
2024-10-17,"40 - 1114",230,232,230,0,2,1
2024-10-17,"2 - 1066",45,40,45,0,-5,1
2024-10-17,"82 - 1163",163,148,163,0,-15,1
2024-10-18,"40 - 1320",207,207,207,0,0,1
2024-10-18,"40 - 1114",230,232,230,0,2,1
2024-10-18,"2 - 1066",45,40,45,0,-5,1
2024-10-18,"82 - 1163",164,148,164,0,-16,1
2024-10-19,"40 - 1320",207,207,207,0,0,1
2024-10-19,"40 - 1114",230,232,230,0,2,1
2024-10-19,"2 - 1066",45,40,45,0,-5,1
2024-10-19,"82 - 1163",165,148,165,0,-17,1
2024-10-20,"40 - 1320",207,207,207,0,0,1
2024-10-20,"40 - 1114",230,232,230,0,2,1
2024-10-20,"2 - 1066",45,40,45,0,-5,1
2024-10-20,"82 - 1163",163,134,163,0,-29,1
2024-10-21,"40 - 1320",207,207,207,0,0,1
2024-10-21,"40 - 1114",231,232,231,0,1,1
2024-10-21,"2 - 1066",45,40,45,0,-5,1
2024-10-21,"82 - 1163",163,134,163,0,-29,1
2024-10-22,"40 - 1320",207,207,207,0,0,1
2024-10-22,"40 - 1114",231,232,231,0,1,1
2024-10-22,"2 - 1066",45,40,45,0,-5,1
2024-10-22,"82 - 1163",162,134,162,0,-28,1
2024-10-23,"40 - 1320",207,207,207,0,0,1
2024-10-23,"40 - 1114",231,232,231,0,1,1
2024-10-23,"2 - 1066",45,40,45,0,-5,1
2024-10-23,"82 - 1163",162,134,162,0,-28,1
2024-10-24,"40 - 1320",207,207,207,0,0,1
2024-10-24,"40 - 1114",231,232,231,0,1,1
2024-10-24,"2 - 1066",45,40,45,0,-5,1
2024-10-24,"82 - 1163",161,134,161,0,-27,1
2024-10-25,"40 - 1320",207,207,207,0,0,1
2024-10-25,"40 - 1114",231,232,230,1,1,0.995670995670996
2024-10-25,"2 - 1066",45,40,45,0,-5,1
2024-10-25,"82 - 1163",165,134,165,0,-31,1
2024-10-26,"40 - 1320",206,207,206,0,1,1
2024-10-26,"40 - 1114",230,232,230,0,2,1
2024-10-26,"2 - 1066",45,40,45,0,-5,1
2024-10-26,"82 - 1163",165,134,165,0,-31,1
2024-10-27,"40 - 1320",207,207,207,0,0,1
2024-10-27,"40 - 1114",230,232,230,0,2,1
2024-10-27,"2 - 1066",45,40,45,0,-5,1
2024-10-27,"82 - 1163",165,134,165,0,-31,1
2024-10-28,"40 - 1320",207,207,207,0,0,1
2024-10-28,"40 - 1114",230,232,230,0,2,1
2024-10-28,"2 - 1066",45,40,45,0,-5,1
2024-10-28,"82 - 1163",164,134,164,0,-30,1
2024-10-29,"40 - 1320",207,207,207,0,0,1
2024-10-29,"40 - 1114",229,232,229,0,3,1
2024-10-29,"2 - 1066",45,40,45,0,-5,1
2024-10-29,"82 - 1163",164,134,164,0,-30,1
2024-10-30,"40 - 1320",207,207,207,0,0,1
2024-10-30,"40 - 1114",229,232,229,0,3,1
2024-10-30,"2 - 1066",45,40,45,0,-5,1
2024-10-30,"82 - 1163",164,134,164,0,-30,1
2024-10-31,"40 - 1320",207,207,207,0,0,1
2024-10-31,"40 - 1114",228,232,228,0,4,1
2024-10-31,"2 - 1066",43,40,43,0,-3,1
2024-10-31,"82 - 1163",163,134,163,0,-29,1
2024-11-01,"40 - 1320",206,207,206,0,1,1
2024-11-01,"40 - 1114",225,232,225,0,7,1
2024-11-01,"2 - 1066",42,40,42,0,-2,1
2024-11-01,"82 - 1163",162,134,162,0,-28,1
2024-11-02,"40 - 1320",203,207,203,0,4,1
2024-11-02,"40 - 1114",224,232,224,0,8,1
2024-11-02,"2 - 1066",42,40,42,0,-2,1
2024-11-02,"82 - 1163",162,134,162,0,-28,1
2024-11-03,"40 - 1320",205,207,204,1,2,0.995121951219512
2024-11-03,"40 - 1114",222,232,222,0,10,1
2024-11-03,"2 - 1066",42,40,42,0,-2,1
2024-11-03,"82 - 1163",161,134,161,0,-27,1
2024-11-04,"40 - 1320",203,207,203,0,4,1
2024-11-04,"40 - 1114",223,232,222,1,9,0.995515695067265
2024-11-04,"2 - 1066",41,40,41,0,-1,1
2024-11-04,"82 - 1163",162,134,162,0,-28,1
2024-11-05,"40 - 1320",205,207,205,0,2,1
2024-11-05,"40 - 1114",225,232,225,0,7,1
2024-11-05,"2 - 1066",42,40,42,0,-2,1
2024-11-05,"82 - 1163",162,134,162,0,-28,1
2024-11-06,"40 - 1320",206,207,206,0,1,1
2024-11-06,"40 - 1114",228,232,227,1,4,0.995614035087719
2024-11-06,"2 - 1066",42,40,42,0,-2,1
2024-11-06,"82 - 1163",163,134,163,0,-29,1
2024-11-07,"40 - 1320",206,207,206,0,1,1
2024-11-07,"40 - 1114",228,232,227,1,4,0.995614035087719
2024-11-07,"2 - 1066",43,40,43,0,-3,1
2024-11-07,"82 - 1163",163,134,163,0,-29,1
2024-11-08,"40 - 1320",206,207,206,0,1,1
2024-11-08,"40 - 1114",230,232,230,0,2,1
2024-11-08,"2 - 1066",43,40,43,0,-3,1
2024-11-08,"82 - 1163",165,148,165,0,-17,1
2024-11-09,"40 - 1320",206,207,206,0,1,1
2024-11-09,"40 - 1114",230,232,230,0,2,1
2024-11-09,"2 - 1066",43,40,43,0,-3,1
2024-11-09,"82 - 1163",165,148,165,0,-17,1
2024-11-10,"40 - 1320",206,207,206,0,1,1
2024-11-10,"40 - 1114",230,232,229,1,2,0.995652173913044
2024-11-10,"2 - 1066",43,40,43,0,-3,1
2024-11-10,"82 - 1163",165,148,165,0,-17,1
2024-11-11,"40 - 1320",206,207,206,0,1,1
2024-11-11,"40 - 1114",228,232,228,0,4,1
2024-11-11,"2 - 1066",44,40,44,0,-4,1
2024-11-11,"82 - 1163",165,148,165,0,-17,1
2024-11-12,"40 - 1320",206,207,206,0,1,1
2024-11-12,"40 - 1114",228,232,228,0,4,1
2024-11-12,"2 - 1066",44,40,44,0,-4,1
2024-11-12,"82 - 1163",166,148,166,0,-18,1
2024-11-13,"40 - 1320",207,207,206,1,0,0.995169082125604
2024-11-13,"40 - 1114",228,232,228,0,4,1
2024-11-13,"2 - 1066",44,40,44,0,-4,1
2024-11-13,"82 - 1163",165,148,165,0,-17,1
2024-11-14,"40 - 1320",206,207,206,0,1,1
2024-11-14,"40 - 1114",226,232,226,0,6,1
2024-11-14,"2 - 1066",44,40,44,0,-4,1
2024-11-14,"82 - 1163",165,148,165,0,-17,1
2024-11-15,"40 - 1320",206,207,205,1,1,0.995145631067961
2024-11-15,"40 - 1114",224,232,224,0,8,1
2024-11-15,"2 - 1066",44,40,44,0,-4,1
2024-11-15,"82 - 1163",166,148,166,0,-18,1
2024-11-16,"40 - 1320",206,207,206,0,1,1
2024-11-16,"40 - 1114",223,232,223,0,9,1
2024-11-16,"2 - 1066",45,40,45,0,-5,1
2024-11-16,"82 - 1163",166,148,166,0,-18,1
2024-11-17,"40 - 1320",206,207,206,0,1,1
2024-11-17,"40 - 1114",222,232,222,0,10,1
2024-11-17,"2 - 1066",45,40,45,0,-5,1
2024-11-17,"82 - 1163",166,148,166,0,-18,1
2024-11-18,"40 - 1320",205,207,205,0,2,1
2024-11-18,"40 - 1114",222,231,222,0,9,1
2024-11-18,"2 - 1066",45,40,45,0,-5,1
2024-11-18,"82 - 1163",165,134,165,0,-31,1
2024-11-19,"40 - 1320",205,207,205,0,2,1
2024-11-19,"40 - 1114",222,231,222,0,9,1
2024-11-19,"2 - 1066",45,40,45,0,-5,1
2024-11-19,"82 - 1163",165,134,165,0,-31,1
2024-11-20,"40 - 1320",205,207,204,1,2,0.995121951219512
2024-11-20,"40 - 1114",222,231,222,0,9,1
2024-11-20,"2 - 1066",45,40,45,0,-5,1
2024-11-20,"82 - 1163",165,148,165,0,-17,1
2024-11-21,"40 - 1320",204,207,204,0,3,1
2024-11-21,"40 - 1114",225,231,224,1,6,0.995555555555556
2024-11-21,"2 - 1066",45,40,45,0,-5,1
2024-11-21,"82 - 1163",165,148,165,0,-17,1
2024-11-22,"40 - 1320",205,207,205,0,2,1
2024-11-22,"40 - 1114",227,231,227,0,4,1
2024-11-22,"2 - 1066",45,40,45,0,-5,1
2024-11-22,"82 - 1163",162,148,162,0,-14,1
2024-11-23,"40 - 1320",206,207,206,0,1,1
2024-11-23,"40 - 1114",227,231,227,0,4,1
2024-11-23,"2 - 1066",45,40,45,0,-5,1
2024-11-23,"82 - 1163",162,148,162,0,-14,1
2024-11-24,"40 - 1320",206,207,206,0,1,1
2024-11-24,"40 - 1114",226,231,226,0,5,1
2024-11-24,"2 - 1066",45,40,45,0,-5,1
2024-11-24,"82 - 1163",164,148,164,0,-16,1
2024-11-25,"40 - 1320",206,207,206,0,1,1
2024-11-25,"40 - 1114",227,231,227,0,4,1
2024-11-25,"2 - 1066",46,40,45,1,-6,0.978260869565217
2024-11-25,"82 - 1163",164,148,164,0,-16,1
2024-11-26,"40 - 1320",207,207,206,1,0,0.995169082125604
2024-11-26,"40 - 1114",227,231,227,0,4,1
2024-11-26,"2 - 1066",46,40,46,0,-6,1
2024-11-26,"82 - 1163",164,148,164,0,-16,1
2024-11-27,"40 - 1320",207,207,207,0,0,1
2024-11-27,"40 - 1114",226,231,226,0,5,1
2024-11-27,"2 - 1066",46,40,46,0,-6,1
2024-11-27,"82 - 1163",164,148,164,0,-16,1
2024-11-28,"40 - 1320",207,207,207,0,0,1
2024-11-28,"40 - 1114",226,231,226,0,5,1
2024-11-28,"2 - 1066",46,40,46,0,-6,1
2024-11-28,"82 - 1163",162,148,162,0,-14,1
2024-11-29,"40 - 1320",207,207,207,0,0,1
2024-11-29,"40 - 1114",226,231,226,0,5,1
2024-11-29,"2 - 1066",46,40,46,0,-6,1
2024-11-29,"82 - 1163",160,148,159,1,-12,0.99375
2024-11-30,"40 - 1320",207,207,207,0,0,1
2024-11-30,"40 - 1114",224,231,224,0,7,1
2024-11-30,"2 - 1066",46,40,46,0,-6,1
2024-11-30,"82 - 1163",157,134,157,0,-23,1
2024-12-01,"40 - 1320",205,207,205,0,2,1
2024-12-01,"40 - 1114",225,231,225,0,6,1
2024-12-01,"2 - 1066",46,40,46,0,-6,1
2024-12-01,"82 - 1163",157,134,157,0,-23,1
2024-12-02,"40 - 1320",204,207,203,1,3,0.995098039215686
2024-12-02,"40 - 1114",225,231,223,2,6,0.991111111111111
2024-12-02,"2 - 1066",46,40,46,0,-6,1
2024-12-02,"82 - 1163",157,134,157,0,-23,1
2024-12-03,"40 - 1320",204,207,204,0,3,1
2024-12-03,"40 - 1114",222,231,222,0,9,1
2024-12-03,"2 - 1066",46,40,46,0,-6,1
2024-12-03,"82 - 1163",157,134,157,0,-23,1
2024-12-04,"40 - 1320",205,207,203,2,2,0.990243902439024
2024-12-04,"40 - 1114",221,231,221,0,10,1
2024-12-04,"2 - 1066",46,40,46,0,-6,1
2024-12-04,"82 - 1163",158,148,158,0,-10,1
2024-12-05,"40 - 1320",205,207,204,1,2,0.995121951219512
2024-12-05,"40 - 1114",224,231,224,0,7,1
2024-12-05,"2 - 1066",46,40,45,1,-6,0.978260869565217
2024-12-05,"82 - 1163",156,148,155,1,-8,0.993589743589744
2024-12-06,"40 - 1320",205,207,204,1,2,0.995121951219512
2024-12-06,"40 - 1114",226,231,226,0,5,1
2024-12-06,"2 - 1066",46,40,45,1,-6,0.978260869565217
2024-12-06,"82 - 1163",156,148,154,2,-8,0.987179487179487
2024-12-07,"40 - 1320",206,207,206,0,1,1
2024-12-07,"40 - 1114",228,231,228,0,3,1
2024-12-07,"2 - 1066",46,40,45,1,-6,0.978260869565217
2024-12-07,"82 - 1163",154,148,154,0,-6,1
2024-12-08,"40 - 1320",206,207,206,0,1,1
2024-12-08,"40 - 1114",228,231,228,0,3,1
2024-12-08,"2 - 1066",46,40,45,1,-6,0.978260869565217
2024-12-08,"82 - 1163",154,148,154,0,-6,1
2024-12-09,"40 - 1320",206,207,206,0,1,1
2024-12-09,"40 - 1114",229,231,229,0,2,1
2024-12-09,"2 - 1066",46,40,45,1,-6,0.978260869565217
2024-12-09,"82 - 1163",157,148,156,1,-9,0.993630573248408
2024-12-10,"40 - 1320",206,207,205,1,1,0.995145631067961
2024-12-10,"40 - 1114",229,231,228,1,2,0.995633187772926
2024-12-10,"2 - 1066",47,40,45,2,-7,0.957446808510638
2024-12-10,"82 - 1163",156,148,156,0,-8,1
2024-12-11,"40 - 1320",206,207,206,0,1,1
2024-12-11,"40 - 1114",227,231,227,0,4,1
2024-12-11,"2 - 1066",46,40,45,1,-6,0.978260869565217
2024-12-11,"82 - 1163",156,148,155,1,-8,0.993589743589744
2024-12-12,"40 - 1320",207,207,207,0,0,1
2024-12-12,"40 - 1114",228,231,228,0,3,1
2024-12-12,"2 - 1066",46,40,45,1,-6,0.978260869565217
2024-12-12,"82 - 1163",155,148,155,0,-7,1
2024-12-13,"40 - 1320",207,207,207,0,0,1
2024-12-13,"40 - 1114",229,231,229,0,2,1
2024-12-13,"2 - 1066",46,40,45,1,-6,0.978260869565217
2024-12-13,"82 - 1163",161,148,159,2,-13,0.987577639751553
2024-12-14,"40 - 1320",207,207,207,0,0,1
2024-12-14,"40 - 1114",229,231,228,1,2,0.995633187772926
2024-12-14,"2 - 1066",45,40,45,0,-5,1
2024-12-14,"82 - 1163",159,148,157,2,-11,0.987421383647799
2024-12-15,"40 - 1320",205,207,205,0,2,1
2024-12-15,"40 - 1114",228,231,228,0,3,1
2024-12-15,"2 - 1066",45,40,45,0,-5,1
2024-12-15,"82 - 1163",157,148,157,0,-9,1
2024-12-16,"40 - 1320",205,207,205,0,2,1
2024-12-16,"40 - 1114",230,231,230,0,1,1
2024-12-16,"2 - 1066",45,40,45,0,-5,1
2024-12-16,"82 - 1163",156,148,156,0,-8,1
2024-12-17,"40 - 1320",205,207,205,0,2,1
2024-12-17,"40 - 1114",227,231,227,0,4,1
2024-12-17,"2 - 1066",45,40,45,0,-5,1
2024-12-17,"82 - 1163",155,148,155,0,-7,1
2024-12-18,"40 - 1320",206,207,206,0,1,1
2024-12-18,"40 - 1114",227,231,226,1,4,0.995594713656388
2024-12-18,"2 - 1066",45,40,45,0,-5,1
2024-12-18,"82 - 1163",155,148,155,0,-7,1
2024-12-19,"40 - 1320",207,207,207,0,0,1
2024-12-19,"40 - 1114",226,231,226,0,5,1
2024-12-19,"2 - 1066",45,40,45,0,-5,1
2024-12-19,"82 - 1163",155,148,154,1,-7,0.993548387096774
2024-12-20,"40 - 1320",207,207,207,0,0,1
2024-12-20,"40 - 1114",225,231,225,0,6,1
2024-12-20,"2 - 1066",45,40,45,0,-5,1
2024-12-20,"82 - 1163",154,148,154,0,-6,1
2024-12-21,"40 - 1320",207,207,207,0,0,1
2024-12-21,"40 - 1114",224,231,224,0,7,1
2024-12-21,"2 - 1066",45,40,45,0,-5,1
2024-12-21,"82 - 1163",154,148,154,0,-6,1
2024-12-22,"40 - 1320",207,207,207,0,0,1
2024-12-22,"40 - 1114",224,231,224,0,7,1
2024-12-22,"2 - 1066",45,40,45,0,-5,1
2024-12-22,"82 - 1163",154,148,154,0,-6,1
2024-12-23,"40 - 1320",207,207,207,0,0,1
2024-12-23,"40 - 1114",227,231,227,0,4,1
2024-12-23,"2 - 1066",45,40,45,0,-5,1
2024-12-23,"82 - 1163",155,148,154,1,-7,0.993548387096774
2024-12-24,"40 - 1320",207,207,207,0,0,1
2024-12-24,"40 - 1114",227,231,227,0,4,1
2024-12-24,"2 - 1066",45,40,45,0,-5,1
2024-12-24,"82 - 1163",156,148,155,1,-8,0.993589743589744
2024-12-25,"40 - 1320",207,207,207,0,0,1
2024-12-25,"40 - 1114",227,231,227,0,4,1
2024-12-25,"2 - 1066",45,40,45,0,-5,1
2024-12-25,"82 - 1163",155,148,155,0,-7,1
2024-12-26,"40 - 1320",207,207,207,0,0,1
2024-12-26,"40 - 1114",227,231,227,0,4,1
2024-12-26,"2 - 1066",46,40,46,0,-6,1
2024-12-26,"82 - 1163",154,148,152,2,-6,0.987012987012987
2024-12-27,"40 - 1320",207,207,207,0,0,1
2024-12-27,"40 - 1114",229,231,228,1,2,0.995633187772926
2024-12-27,"2 - 1066",46,40,46,0,-6,1
2024-12-27,"82 - 1163",152,148,152,0,-4,1
2024-12-28,"40 - 1320",207,207,207,0,0,1
2024-12-28,"40 - 1114",228,231,228,0,3,1
2024-12-28,"2 - 1066",46,40,46,0,-6,1
2024-12-28,"82 - 1163",152,148,152,0,-4,1
2024-12-29,"40 - 1320",207,207,207,0,0,1
2024-12-29,"40 - 1114",228,231,228,0,3,1
2024-12-29,"2 - 1066",46,40,46,0,-6,1
2024-12-29,"82 - 1163",151,148,151,0,-3,1
2024-12-30,"40 - 1320",207,207,207,0,0,1
2024-12-30,"40 - 1114",229,231,229,0,2,1
2024-12-30,"2 - 1066",46,40,46,0,-6,1
2024-12-30,"82 - 1163",152,148,150,2,-4,0.986842105263158
2024-12-31,"40 - 1320",207,207,206,1,0,0.995169082125604
2024-12-31,"40 - 1114",230,231,229,1,1,0.995652173913044
2024-12-31,"2 - 1066",46,40,46,0,-6,1
2024-12-31,"82 - 1163",152,148,152,0,-4,1
