"","OCCUPANCY_DATE","shelter_location_pair","capacity_actual_sum","capacity_funding_sum","occupied_sum","unoccupied_sum","unavailable_sum","occupancy_rate"
"1",21-01-01,"40 - 1114",92,125,88,4,33,0.956521739130435
"2",21-01-01,"53 - 1103",40,44,38,2,4,0.95
"3",21-01-01,"2 - 1066",24,73,24,0,49,1
"4",21-01-01,"82 - 1163",140,0,54,86,-140,0.385714285714286
"5",21-01-02,"40 - 1114",92,125,88,4,33,0.956521739130435
"6",21-01-02,"53 - 1103",39,44,37,2,5,0.948717948717949
"7",21-01-02,"2 - 1066",23,73,23,0,50,1
"8",21-01-02,"82 - 1163",140,0,51,89,-140,0.364285714285714
"9",21-01-03,"40 - 1114",93,125,89,4,32,0.956989247311828
"10",21-01-03,"53 - 1103",39,44,37,2,5,0.948717948717949
"11",21-01-03,"2 - 1066",22,73,22,0,51,1
"12",21-01-03,"82 - 1163",140,0,52,88,-140,0.371428571428571
"13",21-01-04,"40 - 1114",92,125,89,3,33,0.967391304347826
"14",21-01-04,"53 - 1103",38,44,36,2,6,0.947368421052632
"15",21-01-04,"2 - 1066",22,73,22,0,51,1
"16",21-01-04,"82 - 1163",140,0,49,91,-140,0.35
"17",21-01-05,"40 - 1114",94,125,87,7,31,0.925531914893617
"18",21-01-05,"53 - 1103",36,44,36,0,8,1
"19",21-01-05,"2 - 1066",22,73,22,0,51,1
"20",21-01-05,"82 - 1163",141,0,53,88,-141,0.375886524822695
"21",21-01-06,"40 - 1114",92,125,88,4,33,0.956521739130435
"22",21-01-06,"53 - 1103",36,44,36,0,8,1
"23",21-01-06,"2 - 1066",23,73,23,0,50,1
"24",21-01-06,"82 - 1163",141,0,71,70,-141,0.50354609929078
"25",21-01-07,"40 - 1114",92,125,87,5,33,0.945652173913043
"26",21-01-07,"53 - 1103",36,44,36,0,8,1
"27",21-01-07,"2 - 1066",23,73,23,0,50,1
"28",21-01-07,"82 - 1163",142,0,75,67,-142,0.528169014084507
"29",21-01-08,"40 - 1114",91,125,85,6,34,0.934065934065934
"30",21-01-08,"53 - 1103",36,44,36,0,8,1
"31",21-01-08,"2 - 1066",23,73,23,0,50,1
"32",21-01-08,"82 - 1163",142,0,85,57,-142,0.598591549295775
"33",21-01-09,"40 - 1114",91,125,85,6,34,0.934065934065934
"34",21-01-09,"53 - 1103",38,44,36,2,6,0.947368421052632
"35",21-01-09,"2 - 1066",23,73,23,0,50,1
"36",21-01-09,"82 - 1163",143,0,87,56,-143,0.608391608391608
"37",21-01-10,"40 - 1114",91,125,85,6,34,0.934065934065934
"38",21-01-10,"53 - 1103",36,44,36,0,8,1
"39",21-01-10,"2 - 1066",23,73,23,0,50,1
"40",21-01-10,"82 - 1163",143,0,85,58,-143,0.594405594405594
"41",21-01-11,"40 - 1114",88,125,83,5,37,0.943181818181818
"42",21-01-11,"53 - 1103",36,44,36,0,8,1
"43",21-01-11,"2 - 1066",23,73,23,0,50,1
"44",21-01-11,"82 - 1163",143,0,87,56,-143,0.608391608391608
"45",21-01-12,"40 - 1114",88,125,83,5,37,0.943181818181818
"46",21-01-12,"53 - 1103",39,44,39,0,5,1
"47",21-01-12,"2 - 1066",24,73,24,0,49,1
"48",21-01-12,"82 - 1163",144,0,90,54,-144,0.625
"49",21-01-13,"40 - 1114",88,125,84,4,37,0.954545454545455
"50",21-01-13,"53 - 1103",40,44,40,0,4,1
"51",21-01-13,"2 - 1066",24,73,24,0,49,1
"52",21-01-13,"82 - 1163",147,0,95,52,-147,0.646258503401361
"53",21-01-14,"40 - 1114",84,125,84,0,41,1
"54",21-01-14,"53 - 1103",40,44,40,0,4,1
"55",21-01-14,"2 - 1066",24,73,24,0,49,1
"56",21-01-14,"82 - 1163",147,0,92,55,-147,0.625850340136054
"57",21-01-15,"40 - 1114",84,125,83,1,41,0.988095238095238
"58",21-01-15,"53 - 1103",43,44,43,0,1,1
"59",21-01-15,"2 - 1066",23,73,23,0,50,1
"60",21-01-15,"82 - 1163",147,0,101,46,-147,0.687074829931973
"61",21-01-16,"40 - 1114",84,125,82,2,41,0.976190476190476
"62",21-01-16,"53 - 1103",44,44,44,0,0,1
"63",21-01-16,"2 - 1066",24,73,24,0,49,1
"64",21-01-16,"82 - 1163",147,0,80,67,-147,0.54421768707483
"65",21-01-17,"40 - 1114",88,125,83,5,37,0.943181818181818
"66",21-01-17,"53 - 1103",44,44,44,0,0,1
"67",21-01-17,"2 - 1066",24,73,24,0,49,1
"68",21-01-17,"82 - 1163",147,0,77,70,-147,0.523809523809524
"69",21-01-18,"40 - 1114",88,125,82,6,37,0.931818181818182
"70",21-01-18,"53 - 1103",43,44,43,0,1,1
"71",21-01-18,"2 - 1066",25,73,25,0,48,1
"72",21-01-18,"82 - 1163",147,0,78,69,-147,0.530612244897959
"73",21-01-19,"40 - 1114",84,125,80,4,41,0.952380952380952
"74",21-01-19,"53 - 1103",42,44,42,0,2,1
"75",21-01-19,"2 - 1066",25,73,25,0,48,1
"76",21-01-19,"82 - 1163",148,0,100,48,-148,0.675675675675676
"77",21-01-20,"40 - 1114",81,125,81,0,44,1
"78",21-01-20,"53 - 1103",42,44,42,0,2,1
"79",21-01-20,"2 - 1066",22,73,22,0,51,1
"80",21-01-20,"82 - 1163",148,0,102,46,-148,0.689189189189189
"81",21-01-21,"40 - 1114",80,125,80,0,45,1
"82",21-01-21,"53 - 1103",44,64,44,0,20,1
"83",21-01-21,"2 - 1066",21,73,21,0,52,1
"84",21-01-21,"82 - 1163",148,0,95,53,-148,0.641891891891892
"85",21-01-22,"40 - 1114",79,125,79,0,46,1
"86",21-01-22,"53 - 1103",44,61,42,2,17,0.954545454545455
"87",21-01-22,"2 - 1066",21,73,21,0,52,1
"88",21-01-22,"82 - 1163",149,0,97,52,-149,0.651006711409396
"89",21-01-23,"40 - 1114",79,125,78,1,46,0.987341772151899
"90",21-01-23,"53 - 1103",44,61,42,2,17,0.954545454545455
"91",21-01-23,"2 - 1066",21,73,21,0,52,1
"92",21-01-23,"82 - 1163",149,0,88,61,-149,0.590604026845638
"93",21-01-24,"40 - 1114",79,125,78,1,46,0.987341772151899
"94",21-01-24,"53 - 1103",44,61,42,2,17,0.954545454545455
"95",21-01-24,"2 - 1066",21,73,21,0,52,1
"96",21-01-24,"82 - 1163",149,0,91,58,-149,0.610738255033557
"97",21-01-25,"40 - 1114",81,125,80,1,44,0.987654320987654
"98",21-01-25,"53 - 1103",45,61,44,1,16,0.977777777777778
"99",21-01-25,"2 - 1066",21,73,21,0,52,1
"100",21-01-25,"82 - 1163",149,0,82,67,-149,0.550335570469799
"101",21-01-26,"40 - 1114",80,125,79,1,45,0.9875
"102",21-01-26,"53 - 1103",44,61,41,3,17,0.931818181818182
"103",21-01-26,"2 - 1066",21,73,21,0,52,1
"104",21-01-26,"82 - 1163",149,0,81,68,-149,0.543624161073825
"105",21-01-27,"40 - 1114",80,125,79,1,45,0.9875
"106",21-01-27,"53 - 1103",38,61,37,1,23,0.973684210526316
"107",21-01-27,"2 - 1066",21,73,21,0,52,1
"108",21-01-27,"82 - 1163",149,0,83,66,-149,0.557046979865772
"109",21-01-28,"40 - 1114",79,125,79,0,46,1
"110",21-01-28,"53 - 1103",40,61,35,5,21,0.875
"111",21-01-28,"2 - 1066",22,73,22,0,51,1
"112",21-01-28,"82 - 1163",149,0,92,57,-149,0.61744966442953
"113",21-01-29,"40 - 1114",79,125,78,1,46,0.987341772151899
"114",21-01-29,"53 - 1103",38,34,36,2,-4,0.947368421052632
"115",21-01-29,"2 - 1066",22,73,22,0,51,1
"116",21-01-29,"82 - 1163",149,0,78,71,-149,0.523489932885906
"117",21-01-30,"40 - 1114",78,125,78,0,47,1
"118",21-01-30,"53 - 1103",37,34,37,0,-3,1
"119",21-01-30,"2 - 1066",22,73,22,0,51,1
"120",21-01-30,"82 - 1163",149,0,77,72,-149,0.516778523489933
"121",21-01-31,"40 - 1114",78,125,77,1,47,0.987179487179487
"122",21-01-31,"53 - 1103",39,34,39,0,-5,1
"123",21-01-31,"2 - 1066",22,73,22,0,51,1
"124",21-01-31,"82 - 1163",149,0,71,78,-149,0.476510067114094
"125",21-02-01,"40 - 1114",76,125,75,1,49,0.986842105263158
"126",21-02-01,"53 - 1103",41,78,41,0,37,1
"127",21-02-01,"2 - 1066",22,73,22,0,51,1
"128",21-02-01,"82 - 1163",149,0,68,81,-149,0.456375838926175
"129",21-02-02,"40 - 1114",76,125,74,2,49,0.973684210526316
"130",21-02-02,"53 - 1103",43,78,43,0,35,1
"131",21-02-02,"2 - 1066",25,73,25,0,48,1
"132",21-02-02,"82 - 1163",149,0,77,72,-149,0.516778523489933
"133",21-02-03,"40 - 1114",74,125,74,0,51,1
"134",21-02-03,"53 - 1103",44,78,42,2,34,0.954545454545455
"135",21-02-03,"2 - 1066",25,73,25,0,48,1
"136",21-02-03,"82 - 1163",149,0,77,72,-149,0.516778523489933
"137",21-02-04,"40 - 1114",74,125,74,0,51,1
"138",21-02-04,"53 - 1103",42,67,42,0,25,1
"139",21-02-04,"2 - 1066",25,73,25,0,48,1
"140",21-02-04,"82 - 1163",149,0,82,67,-149,0.550335570469799
"141",21-02-05,"40 - 1114",81,125,77,4,44,0.950617283950617
"142",21-02-05,"53 - 1103",46,67,43,3,21,0.934782608695652
"143",21-02-05,"2 - 1066",24,73,24,0,49,1
"144",21-02-05,"82 - 1163",149,0,86,63,-149,0.577181208053691
"145",21-02-06,"40 - 1114",81,125,76,5,44,0.938271604938272
"146",21-02-06,"53 - 1103",49,67,48,1,18,0.979591836734694
"147",21-02-06,"2 - 1066",24,73,24,0,49,1
"148",21-02-06,"82 - 1163",149,0,83,66,-149,0.557046979865772
"149",21-02-07,"40 - 1114",81,125,77,4,44,0.950617283950617
"150",21-02-07,"53 - 1103",51,67,50,1,16,0.980392156862745
"151",21-02-07,"2 - 1066",23,73,23,0,50,1
"152",21-02-07,"82 - 1163",149,0,78,71,-149,0.523489932885906
"153",21-02-08,"40 - 1114",86,125,84,2,39,0.976744186046512
"154",21-02-08,"53 - 1103",53,67,52,1,14,0.981132075471698
"155",21-02-08,"2 - 1066",24,73,24,0,49,1
"156",21-02-08,"82 - 1163",149,0,77,72,-149,0.516778523489933
"157",21-02-09,"40 - 1114",93,125,88,5,32,0.946236559139785
"158",21-02-09,"53 - 1103",56,67,55,1,11,0.982142857142857
"159",21-02-09,"2 - 1066",24,73,24,0,49,1
"160",21-02-09,"82 - 1163",149,0,88,61,-149,0.590604026845638
"161",21-02-10,"40 - 1114",96,125,94,2,29,0.979166666666667
"162",21-02-10,"53 - 1103",58,67,57,1,9,0.982758620689655
"163",21-02-10,"2 - 1066",24,73,24,0,49,1
"164",21-02-10,"82 - 1163",149,0,86,63,-149,0.577181208053691
"165",21-02-11,"40 - 1114",101,125,101,0,24,1
"166",21-02-11,"53 - 1103",56,67,55,1,11,0.982142857142857
"167",21-02-11,"2 - 1066",24,73,24,0,49,1
"168",21-02-11,"82 - 1163",149,0,92,57,-149,0.61744966442953
"169",21-02-12,"40 - 1114",101,125,99,2,24,0.98019801980198
"170",21-02-12,"53 - 1103",60,71,59,1,11,0.983333333333333
"171",21-02-12,"2 - 1066",24,73,24,0,49,1
"172",21-02-12,"82 - 1163",149,0,81,68,-149,0.543624161073825
"173",21-02-13,"40 - 1114",102,125,97,5,23,0.950980392156863
"174",21-02-13,"53 - 1103",60,71,59,1,11,0.983333333333333
"175",21-02-13,"2 - 1066",24,73,24,0,49,1
"176",21-02-13,"82 - 1163",149,0,72,77,-149,0.483221476510067
"177",21-02-14,"40 - 1114",102,125,97,5,23,0.950980392156863
"178",21-02-14,"53 - 1103",57,71,56,1,14,0.982456140350877
"179",21-02-14,"2 - 1066",24,73,24,0,49,1
"180",21-02-14,"82 - 1163",149,0,73,76,-149,0.48993288590604
"181",21-02-15,"40 - 1114",102,125,97,5,23,0.950980392156863
"182",21-02-15,"53 - 1103",60,71,59,1,11,0.983333333333333
"183",21-02-15,"2 - 1066",24,73,24,0,49,1
"184",21-02-15,"82 - 1163",149,0,71,78,-149,0.476510067114094
"185",21-02-16,"40 - 1114",99,125,98,1,26,0.98989898989899
"186",21-02-16,"53 - 1103",60,71,59,1,11,0.983333333333333
"187",21-02-16,"2 - 1066",25,73,25,0,48,1
"188",21-02-16,"82 - 1163",149,0,74,75,-149,0.496644295302013
"189",21-02-17,"40 - 1114",100,125,98,2,25,0.98
"190",21-02-17,"53 - 1103",59,71,59,0,12,1
"191",21-02-17,"2 - 1066",26,73,26,0,47,1
"192",21-02-17,"82 - 1163",149,0,83,66,-149,0.557046979865772
"193",21-02-18,"40 - 1114",97,125,97,0,28,1
"194",21-02-18,"53 - 1103",60,71,60,0,11,1
"195",21-02-18,"2 - 1066",26,73,26,0,47,1
"196",21-02-18,"82 - 1163",149,0,95,54,-149,0.63758389261745
"197",21-02-19,"40 - 1114",97,125,96,1,28,0.989690721649485
"198",21-02-19,"53 - 1103",60,71,60,0,11,1
"199",21-02-19,"2 - 1066",27,73,27,0,46,1
"200",21-02-19,"82 - 1163",149,0,117,32,-149,0.785234899328859
"201",21-02-20,"40 - 1114",98,125,97,1,27,0.989795918367347
"202",21-02-20,"53 - 1103",60,71,60,0,11,1
"203",21-02-20,"2 - 1066",27,73,27,0,46,1
"204",21-02-20,"82 - 1163",149,0,113,36,-149,0.758389261744966
"205",21-02-21,"40 - 1114",98,125,98,0,27,1
"206",21-02-21,"53 - 1103",58,71,58,0,13,1
"207",21-02-21,"2 - 1066",27,73,27,0,46,1
"208",21-02-21,"82 - 1163",150,0,110,40,-150,0.733333333333333
"209",21-02-22,"40 - 1114",100,125,98,2,25,0.98
"210",21-02-22,"53 - 1103",58,71,58,0,13,1
"211",21-02-22,"2 - 1066",27,73,27,0,46,1
"212",21-02-22,"82 - 1163",150,0,103,47,-150,0.686666666666667
"213",21-02-23,"40 - 1114",98,125,97,1,27,0.989795918367347
"214",21-02-23,"53 - 1103",58,71,58,0,13,1
"215",21-02-23,"2 - 1066",27,73,27,0,46,1
"216",21-02-23,"82 - 1163",150,0,105,45,-150,0.7
"217",21-02-24,"40 - 1114",96,125,96,0,29,1
"218",21-02-24,"53 - 1103",60,71,60,0,11,1
"219",21-02-24,"2 - 1066",27,73,27,0,46,1
"220",21-02-24,"82 - 1163",150,0,116,34,-150,0.773333333333333
"221",21-02-25,"40 - 1114",96,125,96,0,29,1
"222",21-02-25,"53 - 1103",59,71,59,0,12,1
"223",21-02-25,"2 - 1066",28,73,28,0,45,1
"224",21-02-25,"82 - 1163",150,0,118,32,-150,0.786666666666667
"225",21-02-26,"40 - 1114",96,125,96,0,29,1
"226",21-02-26,"53 - 1103",56,71,56,0,15,1
"227",21-02-26,"2 - 1066",28,73,28,0,45,1
"228",21-02-26,"82 - 1163",151,0,114,37,-151,0.754966887417219
"229",21-02-27,"40 - 1114",97,125,96,1,28,0.989690721649485
"230",21-02-27,"53 - 1103",55,71,55,0,16,1
"231",21-02-27,"2 - 1066",27,73,27,0,46,1
"232",21-02-27,"82 - 1163",151,0,116,35,-151,0.768211920529801
"233",21-02-28,"40 - 1114",97,125,96,1,28,0.989690721649485
"234",21-02-28,"53 - 1103",55,71,55,0,16,1
"235",21-02-28,"2 - 1066",27,73,27,0,46,1
"236",21-02-28,"82 - 1163",151,0,106,45,-151,0.701986754966887
"237",21-03-01,"40 - 1114",96,125,96,0,29,1
"238",21-03-01,"53 - 1103",53,71,53,0,18,1
"239",21-03-01,"2 - 1066",27,73,27,0,46,1
"240",21-03-01,"82 - 1163",151,0,71,80,-151,0.470198675496689
"241",21-03-02,"40 - 1114",96,125,93,3,29,0.96875
"242",21-03-02,"53 - 1103",54,71,54,0,17,1
"243",21-03-02,"2 - 1066",26,73,26,0,47,1
"244",21-03-02,"82 - 1163",151,0,78,73,-151,0.516556291390728
"245",21-03-03,"40 - 1114",91,125,90,1,34,0.989010989010989
"246",21-03-03,"53 - 1103",53,70,53,0,17,1
"247",21-03-03,"2 - 1066",25,73,25,0,48,1
"248",21-03-03,"82 - 1163",151,0,80,71,-151,0.529801324503311
"249",21-03-04,"40 - 1114",91,125,91,0,34,1
"250",21-03-04,"53 - 1103",51,70,51,0,19,1
"251",21-03-04,"2 - 1066",24,73,24,0,49,1
"252",21-03-04,"82 - 1163",151,0,80,71,-151,0.529801324503311
"253",21-03-05,"40 - 1114",92,125,89,3,33,0.967391304347826
"254",21-03-05,"53 - 1103",51,70,51,0,19,1
"255",21-03-05,"2 - 1066",24,73,24,0,49,1
"256",21-03-05,"82 - 1163",151,0,78,73,-151,0.516556291390728
"257",21-03-06,"40 - 1114",88,125,88,0,37,1
"258",21-03-06,"53 - 1103",49,70,49,0,21,1
"259",21-03-06,"2 - 1066",24,73,24,0,49,1
"260",21-03-06,"82 - 1163",151,0,75,76,-151,0.496688741721854
"261",21-03-07,"40 - 1114",87,125,87,0,38,1
"262",21-03-07,"53 - 1103",48,70,47,1,22,0.979166666666667
"263",21-03-07,"2 - 1066",24,73,24,0,49,1
"264",21-03-07,"82 - 1163",151,0,70,81,-151,0.463576158940397
"265",21-03-08,"40 - 1114",86,125,86,0,39,1
"266",21-03-08,"53 - 1103",44,70,44,0,26,1
"267",21-03-08,"2 - 1066",24,73,24,0,49,1
"268",21-03-08,"82 - 1163",151,0,76,75,-151,0.503311258278146
"269",21-03-09,"40 - 1114",86,125,86,0,39,1
"270",21-03-09,"53 - 1103",44,70,44,0,26,1
"271",21-03-09,"2 - 1066",24,73,24,0,49,1
"272",21-03-09,"82 - 1163",151,0,75,76,-151,0.496688741721854
"273",21-03-10,"40 - 1114",86,125,86,0,39,1
"274",21-03-10,"53 - 1103",43,70,43,0,27,1
"275",21-03-10,"2 - 1066",25,73,25,0,48,1
"276",21-03-10,"82 - 1163",151,0,76,75,-151,0.503311258278146
"277",21-03-11,"40 - 1114",87,125,86,1,38,0.988505747126437
"278",21-03-11,"53 - 1103",43,70,43,0,27,1
"279",21-03-11,"2 - 1066",24,73,24,0,49,1
"280",21-03-11,"82 - 1163",151,0,79,72,-151,0.52317880794702
"281",21-03-12,"40 - 1114",87,125,87,0,38,1
"282",21-03-12,"53 - 1103",43,70,43,0,27,1
"283",21-03-12,"2 - 1066",22,73,22,0,51,1
"284",21-03-12,"82 - 1163",151,0,82,69,-151,0.543046357615894
"285",21-03-13,"40 - 1114",89,125,89,0,36,1
"286",21-03-13,"53 - 1103",41,70,41,0,29,1
"287",21-03-13,"2 - 1066",21,73,21,0,52,1
"288",21-03-13,"82 - 1163",151,0,89,62,-151,0.589403973509934
"289",21-03-14,"40 - 1114",89,125,89,0,36,1
"290",21-03-14,"53 - 1103",42,70,42,0,28,1
"291",21-03-14,"2 - 1066",20,73,20,0,53,1
"292",21-03-14,"82 - 1163",151,0,104,47,-151,0.688741721854305
"293",21-03-15,"40 - 1114",89,125,89,0,36,1
"294",21-03-15,"53 - 1103",42,70,42,0,28,1
"295",21-03-15,"2 - 1066",21,73,21,0,52,1
"296",21-03-15,"82 - 1163",151,0,104,47,-151,0.688741721854305
"297",21-03-16,"40 - 1114",87,125,87,0,38,1
"298",21-03-16,"53 - 1103",42,70,42,0,28,1
"299",21-03-16,"2 - 1066",21,73,21,0,52,1
"300",21-03-16,"82 - 1163",151,0,102,49,-151,0.675496688741722
"301",21-03-17,"40 - 1114",87,125,87,0,38,1
"302",21-03-17,"53 - 1103",44,70,44,0,26,1
"303",21-03-17,"2 - 1066",21,73,21,0,52,1
"304",21-03-17,"82 - 1163",151,0,115,36,-151,0.76158940397351
"305",21-03-18,"40 - 1114",88,125,88,0,37,1
"306",21-03-18,"53 - 1103",49,70,49,0,21,1
"307",21-03-18,"2 - 1066",22,73,22,0,51,1
"308",21-03-18,"82 - 1163",151,0,121,30,-151,0.801324503311258
"309",21-03-19,"40 - 1114",88,125,88,0,37,1
"310",21-03-19,"53 - 1103",53,70,53,0,17,1
"311",21-03-19,"2 - 1066",22,73,22,0,51,1
"312",21-03-19,"82 - 1163",152,0,122,30,-152,0.802631578947368
"313",21-03-20,"40 - 1114",88,125,88,0,37,1
"314",21-03-20,"53 - 1103",53,70,53,0,17,1
"315",21-03-20,"2 - 1066",22,73,22,0,51,1
"316",21-03-20,"82 - 1163",153,0,124,29,-153,0.810457516339869
"317",21-03-21,"40 - 1114",88,125,87,1,37,0.988636363636364
"318",21-03-21,"53 - 1103",51,70,51,0,19,1
"319",21-03-21,"2 - 1066",22,73,22,0,51,1
"320",21-03-21,"82 - 1163",153,0,119,34,-153,0.777777777777778
"321",21-03-22,"40 - 1114",87,125,87,0,38,1
"322",21-03-22,"53 - 1103",50,70,50,0,20,1
"323",21-03-22,"2 - 1066",22,73,22,0,51,1
"324",21-03-22,"82 - 1163",153,0,127,26,-153,0.830065359477124
"325",21-03-23,"40 - 1114",87,125,87,0,38,1
"326",21-03-23,"53 - 1103",49,70,49,0,21,1
"327",21-03-23,"2 - 1066",22,73,22,0,51,1
"328",21-03-23,"82 - 1163",153,0,118,35,-153,0.77124183006536
"329",21-03-24,"40 - 1114",87,125,87,0,38,1
"330",21-03-24,"53 - 1103",52,70,52,0,18,1
"331",21-03-24,"2 - 1066",23,73,23,0,50,1
"332",21-03-24,"82 - 1163",153,0,118,35,-153,0.77124183006536
"333",21-03-25,"40 - 1114",87,125,87,0,38,1
"334",21-03-25,"53 - 1103",55,70,55,0,15,1
"335",21-03-25,"2 - 1066",22,73,22,0,51,1
"336",21-03-25,"82 - 1163",153,0,118,35,-153,0.77124183006536
"337",21-03-26,"40 - 1114",88,125,88,0,37,1
"338",21-03-26,"53 - 1103",59,70,57,2,11,0.966101694915254
"339",21-03-26,"2 - 1066",21,73,21,0,52,1
"340",21-03-26,"82 - 1163",153,0,122,31,-153,0.797385620915033
"341",21-03-27,"40 - 1114",88,125,88,0,37,1
"342",21-03-27,"53 - 1103",58,70,58,0,12,1
"343",21-03-27,"2 - 1066",21,73,21,0,52,1
"344",21-03-27,"82 - 1163",153,0,118,35,-153,0.77124183006536
"345",21-03-28,"40 - 1114",88,125,88,0,37,1
"346",21-03-28,"53 - 1103",59,70,59,0,11,1
"347",21-03-28,"2 - 1066",21,73,21,0,52,1
"348",21-03-28,"82 - 1163",153,0,119,34,-153,0.777777777777778
"349",21-03-29,"40 - 1114",88,125,88,0,37,1
"350",21-03-29,"53 - 1103",58,70,58,0,12,1
"351",21-03-29,"2 - 1066",21,73,21,0,52,1
"352",21-03-29,"82 - 1163",153,0,105,48,-153,0.686274509803922
"353",21-03-30,"40 - 1114",88,125,88,0,37,1
"354",21-03-30,"53 - 1103",59,70,59,0,11,1
"355",21-03-30,"2 - 1066",20,73,20,0,53,1
"356",21-03-30,"82 - 1163",153,0,96,57,-153,0.627450980392157
"357",21-03-31,"40 - 1114",88,125,88,0,37,1
"358",21-03-31,"53 - 1103",61,70,61,0,9,1
"359",21-03-31,"2 - 1066",21,73,21,0,52,1
"360",21-03-31,"82 - 1163",153,0,105,48,-153,0.686274509803922
"361",21-04-01,"40 - 1114",87,125,87,0,38,1
"362",21-04-01,"53 - 1103",61,90,61,0,29,1
"363",21-04-01,"2 - 1066",21,73,21,0,52,1
"364",21-04-01,"82 - 1163",153,0,103,50,-153,0.673202614379085
"365",21-04-02,"40 - 1114",87,125,85,2,38,0.977011494252874
"366",21-04-02,"53 - 1103",65,90,65,0,25,1
"367",21-04-02,"2 - 1066",21,73,21,0,52,1
"368",21-04-02,"82 - 1163",153,0,102,51,-153,0.666666666666667
"369",21-04-03,"40 - 1114",87,125,85,2,38,0.977011494252874
"370",21-04-03,"53 - 1103",70,90,70,0,20,1
"371",21-04-03,"2 - 1066",21,73,21,0,52,1
"372",21-04-03,"82 - 1163",153,0,95,58,-153,0.620915032679739
"373",21-04-04,"40 - 1114",87,125,84,3,38,0.96551724137931
"374",21-04-04,"53 - 1103",73,90,73,0,17,1
"375",21-04-04,"2 - 1066",22,73,22,0,51,1
"376",21-04-04,"82 - 1163",153,0,96,57,-153,0.627450980392157
"377",21-04-05,"40 - 1114",83,125,83,0,42,1
"378",21-04-05,"53 - 1103",78,90,78,0,12,1
"379",21-04-05,"2 - 1066",22,73,22,0,51,1
"380",21-04-05,"82 - 1163",153,0,87,66,-153,0.568627450980392
"381",21-04-06,"40 - 1114",83,125,83,0,42,1
"382",21-04-06,"53 - 1103",84,91,84,0,7,1
"383",21-04-06,"2 - 1066",25,73,24,1,48,0.96
"384",21-04-06,"82 - 1163",153,0,89,64,-153,0.581699346405229
"385",21-04-07,"40 - 1114",82,125,82,0,43,1
"386",21-04-07,"53 - 1103",87,91,87,0,4,1
"387",21-04-07,"2 - 1066",24,73,24,0,49,1
"388",21-04-07,"82 - 1163",153,0,88,65,-153,0.57516339869281
"389",21-04-08,"40 - 1114",81,125,81,0,44,1
"390",21-04-08,"53 - 1103",89,91,88,1,2,0.98876404494382
"391",21-04-08,"2 - 1066",26,73,26,0,47,1
"392",21-04-08,"82 - 1163",147,0,101,46,-147,0.687074829931973
"393",21-04-09,"40 - 1114",81,125,81,0,44,1
"394",21-04-09,"53 - 1103",88,91,88,0,3,1
"395",21-04-09,"2 - 1066",26,73,26,0,47,1
"396",21-04-09,"82 - 1163",147,0,107,40,-147,0.727891156462585
"397",21-04-10,"40 - 1114",81,125,81,0,44,1
"398",21-04-10,"53 - 1103",87,91,87,0,4,1
"399",21-04-10,"2 - 1066",26,73,26,0,47,1
"400",21-04-10,"82 - 1163",147,0,108,39,-147,0.73469387755102
"401",21-04-11,"40 - 1114",81,125,81,0,44,1
"402",21-04-11,"53 - 1103",85,91,85,0,6,1
"403",21-04-11,"2 - 1066",26,73,26,0,47,1
"404",21-04-11,"82 - 1163",147,0,98,49,-147,0.666666666666667
"405",21-04-12,"40 - 1114",81,125,81,0,44,1
"406",21-04-12,"53 - 1103",84,91,84,0,7,1
"407",21-04-12,"2 - 1066",26,73,26,0,47,1
"408",21-04-12,"82 - 1163",148,0,104,44,-148,0.702702702702703
"409",21-04-13,"40 - 1114",79,125,79,0,46,1
"410",21-04-13,"53 - 1103",84,91,84,0,7,1
"411",21-04-13,"2 - 1066",26,73,26,0,47,1
"412",21-04-13,"82 - 1163",148,0,103,45,-148,0.695945945945946
"413",21-04-14,"40 - 1114",79,125,79,0,46,1
"414",21-04-14,"53 - 1103",84,91,83,1,7,0.988095238095238
"415",21-04-14,"2 - 1066",27,73,27,0,46,1
"416",21-04-14,"82 - 1163",148,0,92,56,-148,0.621621621621622
"417",21-04-15,"40 - 1114",79,125,79,0,46,1
"418",21-04-15,"53 - 1103",85,91,85,0,6,1
"419",21-04-15,"2 - 1066",28,73,28,0,45,1
"420",21-04-15,"82 - 1163",149,0,99,50,-149,0.664429530201342
"421",21-04-16,"40 - 1114",89,125,78,11,36,0.876404494382023
"422",21-04-16,"53 - 1103",89,91,89,0,2,1
"423",21-04-16,"2 - 1066",27,73,27,0,46,1
"424",21-04-16,"82 - 1163",149,0,106,43,-149,0.711409395973154
"425",21-04-17,"40 - 1114",88,125,77,11,37,0.875
"426",21-04-17,"53 - 1103",89,91,89,0,2,1
"427",21-04-17,"2 - 1066",27,73,27,0,46,1
"428",21-04-17,"82 - 1163",149,0,105,44,-149,0.704697986577181
"429",21-04-18,"40 - 1114",88,125,77,11,37,0.875
"430",21-04-18,"53 - 1103",85,91,85,0,6,1
"431",21-04-18,"2 - 1066",27,73,27,0,46,1
"432",21-04-18,"82 - 1163",149,0,91,58,-149,0.610738255033557
"433",21-04-19,"40 - 1114",80,125,76,4,45,0.95
"434",21-04-19,"53 - 1103",84,91,84,0,7,1
"435",21-04-19,"2 - 1066",27,73,27,0,46,1
"436",21-04-19,"82 - 1163",149,0,88,61,-149,0.590604026845638
"437",21-04-20,"40 - 1114",79,125,76,3,46,0.962025316455696
"438",21-04-20,"53 - 1103",83,91,83,0,8,1
"439",21-04-20,"2 - 1066",28,73,28,0,45,1
"440",21-04-20,"82 - 1163",149,0,88,61,-149,0.590604026845638
"441",21-04-21,"40 - 1114",80,125,78,2,45,0.975
"442",21-04-21,"53 - 1103",84,91,83,1,7,0.988095238095238
"443",21-04-21,"2 - 1066",28,73,27,1,45,0.964285714285714
"444",21-04-21,"82 - 1163",149,0,97,52,-149,0.651006711409396
"445",21-04-22,"40 - 1114",81,125,77,4,44,0.950617283950617
"446",21-04-22,"53 - 1103",84,91,84,0,7,1
"447",21-04-22,"2 - 1066",26,73,26,0,47,1
"448",21-04-22,"82 - 1163",149,0,106,43,-149,0.711409395973154
"449",21-04-23,"40 - 1114",86,125,78,8,39,0.906976744186046
"450",21-04-23,"53 - 1103",84,91,84,0,7,1
"451",21-04-23,"2 - 1066",26,73,26,0,47,1
"452",21-04-23,"82 - 1163",149,0,97,52,-149,0.651006711409396
"453",21-04-24,"40 - 1114",86,125,78,8,39,0.906976744186046
"454",21-04-24,"53 - 1103",81,91,81,0,10,1
"455",21-04-24,"2 - 1066",26,73,26,0,47,1
"456",21-04-24,"82 - 1163",149,0,98,51,-149,0.657718120805369
"457",21-04-25,"40 - 1114",87,125,79,8,38,0.908045977011494
"458",21-04-25,"53 - 1103",81,91,81,0,10,1
"459",21-04-25,"2 - 1066",26,73,26,0,47,1
"460",21-04-25,"82 - 1163",149,0,99,50,-149,0.664429530201342
"461",21-04-26,"40 - 1114",87,125,79,8,38,0.908045977011494
"462",21-04-26,"53 - 1103",78,91,78,0,13,1
"463",21-04-26,"2 - 1066",26,73,26,0,47,1
"464",21-04-26,"82 - 1163",149,0,88,61,-149,0.590604026845638
"465",21-04-27,"40 - 1114",87,125,80,7,38,0.919540229885057
"466",21-04-27,"53 - 1103",78,91,78,0,13,1
"467",21-04-27,"2 - 1066",24,73,24,0,49,1
"468",21-04-27,"82 - 1163",152,0,82,70,-152,0.539473684210526
"469",21-04-28,"40 - 1114",87,125,80,7,38,0.919540229885057
"470",21-04-28,"53 - 1103",78,91,78,0,13,1
"471",21-04-28,"2 - 1066",24,73,24,0,49,1
"472",21-04-28,"82 - 1163",152,0,81,71,-152,0.532894736842105
"473",21-04-29,"40 - 1114",86,125,81,5,39,0.941860465116279
"474",21-04-29,"53 - 1103",78,91,78,0,13,1
"475",21-04-29,"2 - 1066",24,73,24,0,49,1
"476",21-04-29,"82 - 1163",152,0,81,71,-152,0.532894736842105
"477",21-04-30,"40 - 1114",88,125,80,8,37,0.909090909090909
"478",21-04-30,"53 - 1103",77,91,77,0,14,1
"479",21-04-30,"2 - 1066",24,73,24,0,49,1
"480",21-04-30,"82 - 1163",153,0,68,85,-153,0.444444444444444
"481",21-05-01,"40 - 1114",88,125,80,8,37,0.909090909090909
"482",21-05-01,"53 - 1103",75,91,75,0,16,1
"483",21-05-01,"2 - 1066",23,73,23,0,50,1
"484",21-05-01,"82 - 1163",153,0,62,91,-153,0.405228758169935
"485",21-05-02,"40 - 1114",88,125,80,8,37,0.909090909090909
"486",21-05-02,"53 - 1103",75,91,75,0,16,1
"487",21-05-02,"2 - 1066",25,73,24,1,48,0.96
"488",21-05-02,"82 - 1163",154,0,57,97,-154,0.37012987012987
"489",21-05-03,"40 - 1114",89,125,83,6,36,0.932584269662921
"490",21-05-03,"53 - 1103",74,91,74,0,17,1
"491",21-05-03,"2 - 1066",23,73,23,0,50,1
"492",21-05-03,"82 - 1163",154,0,60,94,-154,0.38961038961039
"493",21-05-04,"40 - 1114",90,125,83,7,35,0.922222222222222
"494",21-05-04,"53 - 1103",75,91,75,0,16,1
"495",21-05-04,"2 - 1066",23,73,23,0,50,1
"496",21-05-04,"82 - 1163",154,0,54,100,-154,0.350649350649351
"497",21-05-05,"40 - 1114",88,237,83,5,149,0.943181818181818
"498",21-05-05,"53 - 1103",74,NA,74,0,NA,1
"499",21-05-05,"2 - 1066",24,NA,24,0,NA,1
"500",21-05-05,"82 - 1163",154,NA,48,106,NA,0.311688311688312
"501",21-05-06,"40 - 1114",91,237,83,8,146,0.912087912087912
"502",21-05-06,"53 - 1103",72,NA,72,0,NA,1
"503",21-05-06,"2 - 1066",23,NA,23,0,NA,1
"504",21-05-06,"82 - 1163",154,NA,47,107,NA,0.305194805194805
"505",21-05-07,"40 - 1114",93,237,84,9,144,0.903225806451613
"506",21-05-07,"53 - 1103",73,91,73,0,18,1
"507",21-05-07,"2 - 1066",23,73,23,0,50,1
"508",21-05-07,"82 - 1163",154,NA,44,110,NA,0.285714285714286
"509",21-05-08,"40 - 1114",93,237,85,8,144,0.913978494623656
"510",21-05-08,"53 - 1103",73,91,73,0,18,1
"511",21-05-08,"2 - 1066",23,73,23,0,50,1
"512",21-05-08,"82 - 1163",154,NA,43,111,NA,0.279220779220779
"513",21-05-09,"40 - 1114",93,237,85,8,144,0.913978494623656
"514",21-05-09,"53 - 1103",73,91,73,0,18,1
"515",21-05-09,"2 - 1066",23,73,23,0,50,1
"516",21-05-09,"82 - 1163",154,NA,43,111,NA,0.279220779220779
"517",21-05-10,"40 - 1114",92,237,83,9,145,0.902173913043478
"518",21-05-10,"53 - 1103",73,91,73,0,18,1
"519",21-05-10,"2 - 1066",23,73,23,0,50,1
"520",21-05-10,"82 - 1163",154,NA,42,112,NA,0.272727272727273
"521",21-05-11,"40 - 1114",92,237,84,8,145,0.91304347826087
"522",21-05-11,"53 - 1103",73,91,73,0,18,1
"523",21-05-11,"2 - 1066",23,73,23,0,50,1
"524",21-05-11,"82 - 1163",154,NA,51,103,NA,0.331168831168831
"525",21-05-12,"40 - 1114",93,237,86,7,144,0.924731182795699
"526",21-05-12,"53 - 1103",70,91,70,0,21,1
"527",21-05-12,"2 - 1066",24,73,23,1,49,0.958333333333333
"528",21-05-12,"82 - 1163",154,NA,49,105,NA,0.318181818181818
"529",21-05-13,"40 - 1114",95,237,88,7,142,0.926315789473684
"530",21-05-13,"53 - 1103",67,91,67,0,24,1
"531",21-05-13,"2 - 1066",23,73,23,0,50,1
"532",21-05-13,"82 - 1163",154,NA,53,101,NA,0.344155844155844
"533",21-05-14,"40 - 1114",102,237,85,17,135,0.833333333333333
"534",21-05-14,"53 - 1103",67,91,67,0,24,1
"535",21-05-14,"2 - 1066",24,73,24,0,49,1
"536",21-05-14,"82 - 1163",154,NA,55,99,NA,0.357142857142857
"537",21-05-15,"40 - 1114",102,237,86,16,135,0.843137254901961
"538",21-05-15,"53 - 1103",67,91,67,0,24,1
"539",21-05-15,"2 - 1066",24,73,24,0,49,1
"540",21-05-15,"82 - 1163",154,NA,55,99,NA,0.357142857142857
"541",21-05-16,"40 - 1114",102,237,86,16,135,0.843137254901961
"542",21-05-16,"53 - 1103",67,91,67,0,24,1
"543",21-05-16,"2 - 1066",23,73,23,0,50,1
"544",21-05-16,"82 - 1163",154,NA,48,106,NA,0.311688311688312
"545",21-05-17,"40 - 1114",94,237,88,6,143,0.936170212765957
"546",21-05-17,"53 - 1103",64,91,64,0,27,1
"547",21-05-17,"2 - 1066",24,73,24,0,49,1
"548",21-05-17,"82 - 1163",154,NA,43,111,NA,0.279220779220779
"549",21-05-18,"40 - 1114",95,237,89,6,142,0.936842105263158
"550",21-05-18,"53 - 1103",64,91,64,0,27,1
"551",21-05-18,"2 - 1066",24,73,24,0,49,1
"552",21-05-18,"82 - 1163",154,NA,53,101,NA,0.344155844155844
"553",21-05-19,"40 - 1114",96,237,91,5,141,0.947916666666667
"554",21-05-19,"53 - 1103",64,91,63,1,27,0.984375
"555",21-05-19,"2 - 1066",24,73,24,0,49,1
"556",21-05-19,"82 - 1163",154,NA,57,97,NA,0.37012987012987
"557",21-05-20,"40 - 1114",96,237,91,5,141,0.947916666666667
"558",21-05-20,"53 - 1103",66,91,63,3,25,0.954545454545455
"559",21-05-20,"2 - 1066",24,73,24,0,49,1
"560",21-05-20,"82 - 1163",154,NA,65,89,NA,0.422077922077922
"561",21-05-21,"40 - 1114",107,237,92,15,130,0.85981308411215
"562",21-05-21,"53 - 1103",88,91,62,26,3,0.704545454545455
"563",21-05-21,"2 - 1066",24,73,24,0,49,1
"564",21-05-21,"82 - 1163",154,NA,57,97,NA,0.37012987012987
"565",21-05-22,"40 - 1114",107,237,93,14,130,0.869158878504673
"566",21-05-22,"53 - 1103",88,91,61,27,3,0.693181818181818
"567",21-05-22,"2 - 1066",24,73,24,0,49,1
"568",21-05-22,"82 - 1163",154,NA,55,99,NA,0.357142857142857
"569",21-05-23,"40 - 1114",107,237,92,15,130,0.85981308411215
"570",21-05-23,"53 - 1103",88,91,61,27,3,0.693181818181818
"571",21-05-23,"2 - 1066",24,73,24,0,49,1
"572",21-05-23,"82 - 1163",154,NA,55,99,NA,0.357142857142857
"573",21-05-24,"40 - 1114",107,237,94,13,130,0.878504672897196
"574",21-05-24,"53 - 1103",88,91,61,27,3,0.693181818181818
"575",21-05-24,"2 - 1066",24,73,24,0,49,1
"576",21-05-24,"82 - 1163",154,NA,53,101,NA,0.344155844155844
"577",21-05-25,"40 - 1114",106,237,94,12,131,0.886792452830189
"578",21-05-25,"53 - 1103",87,91,61,26,4,0.701149425287356
"579",21-05-25,"2 - 1066",24,73,24,0,49,1
"580",21-05-25,"82 - 1163",154,NA,50,104,NA,0.324675324675325
"581",21-05-26,"40 - 1114",107,237,96,11,130,0.897196261682243
"582",21-05-26,"53 - 1103",86,91,61,25,5,0.709302325581395
"583",21-05-26,"2 - 1066",23,73,23,0,50,1
"584",21-05-26,"82 - 1163",154,NA,50,104,NA,0.324675324675325
"585",21-05-27,"40 - 1114",107,237,97,10,130,0.906542056074766
"586",21-05-27,"53 - 1103",86,91,62,24,5,0.720930232558139
"587",21-05-27,"2 - 1066",22,73,22,0,51,1
"588",21-05-27,"82 - 1163",154,NA,53,101,NA,0.344155844155844
"589",21-05-28,"40 - 1114",109,237,98,11,128,0.899082568807339
"590",21-05-28,"53 - 1103",85,91,65,20,6,0.764705882352941
"591",21-05-28,"2 - 1066",22,73,22,0,51,1
"592",21-05-28,"82 - 1163",154,NA,49,105,NA,0.318181818181818
"593",21-05-29,"40 - 1114",110,237,100,10,127,0.909090909090909
"594",21-05-29,"53 - 1103",85,91,65,20,6,0.764705882352941
"595",21-05-29,"2 - 1066",22,73,22,0,51,1
"596",21-05-29,"82 - 1163",154,NA,40,114,NA,0.25974025974026
"597",21-05-30,"40 - 1114",110,237,101,9,127,0.918181818181818
"598",21-05-30,"53 - 1103",85,91,65,20,6,0.764705882352941
"599",21-05-30,"2 - 1066",21,73,21,0,52,1
"600",21-05-30,"82 - 1163",154,NA,36,118,NA,0.233766233766234
"601",21-05-31,"40 - 1114",111,237,102,9,126,0.918918918918919
"602",21-05-31,"53 - 1103",89,91,65,24,2,0.730337078651685
"603",21-05-31,"2 - 1066",21,73,21,0,52,1
"604",21-05-31,"82 - 1163",154,NA,36,118,NA,0.233766233766234
"605",21-06-01,"40 - 1114",117,237,103,14,120,0.88034188034188
"606",21-06-01,"53 - 1103",88,91,66,22,3,0.75
"607",21-06-01,"2 - 1066",20,73,20,0,53,1
"608",21-06-01,"82 - 1163",154,NA,29,125,NA,0.188311688311688
"609",21-06-02,"40 - 1114",118,237,106,12,119,0.898305084745763
"610",21-06-02,"53 - 1103",88,91,69,19,3,0.784090909090909
"611",21-06-02,"2 - 1066",20,73,20,0,53,1
"612",21-06-02,"82 - 1163",154,NA,25,129,NA,0.162337662337662
"613",21-06-03,"40 - 1114",113,237,107,6,124,0.946902654867257
"614",21-06-03,"53 - 1103",86,91,67,19,5,0.779069767441861
"615",21-06-03,"2 - 1066",18,73,18,0,55,1
"616",21-06-03,"82 - 1163",154,NA,27,127,NA,0.175324675324675
"617",21-06-04,"40 - 1114",116,237,109,7,121,0.939655172413793
"618",21-06-04,"53 - 1103",85,91,65,20,6,0.764705882352941
"619",21-06-04,"2 - 1066",17,73,17,0,56,1
"620",21-06-04,"82 - 1163",154,NA,26,128,NA,0.168831168831169
"621",21-06-05,"40 - 1114",116,237,110,6,121,0.948275862068966
"622",21-06-05,"53 - 1103",85,91,65,20,6,0.764705882352941
"623",21-06-05,"2 - 1066",17,73,17,0,56,1
"624",21-06-05,"82 - 1163",154,NA,24,130,NA,0.155844155844156
"625",21-06-06,"40 - 1114",116,237,110,6,121,0.948275862068966
"626",21-06-06,"53 - 1103",85,91,65,20,6,0.764705882352941
"627",21-06-06,"2 - 1066",17,73,17,0,56,1
"628",21-06-06,"82 - 1163",154,NA,22,132,NA,0.142857142857143
"629",21-06-07,"40 - 1114",119,237,112,7,118,0.941176470588235
"630",21-06-07,"53 - 1103",83,91,63,20,8,0.759036144578313
"631",21-06-07,"2 - 1066",17,73,17,0,56,1
"632",21-06-07,"82 - 1163",154,NA,19,135,NA,0.123376623376623
"633",21-06-08,"40 - 1114",126,237,111,15,111,0.880952380952381
"634",21-06-08,"53 - 1103",83,91,62,21,8,0.746987951807229
"635",21-06-08,"2 - 1066",18,73,18,0,55,1
"636",21-06-08,"82 - 1163",154,NA,18,136,NA,0.116883116883117
"637",21-06-09,"40 - 1114",124,237,111,13,113,0.895161290322581
"638",21-06-09,"53 - 1103",83,91,63,20,8,0.759036144578313
"639",21-06-09,"2 - 1066",18,73,18,0,55,1
"640",21-06-09,"82 - 1163",154,NA,17,137,NA,0.11038961038961
"641",21-06-10,"40 - 1114",122,237,111,11,115,0.909836065573771
"642",21-06-10,"53 - 1103",88,91,64,24,3,0.727272727272727
"643",21-06-10,"2 - 1066",18,73,18,0,55,1
"644",21-06-10,"82 - 1163",154,NA,13,141,NA,0.0844155844155844
"645",21-06-11,"40 - 1114",122,237,111,11,115,0.909836065573771
"646",21-06-11,"53 - 1103",88,91,63,25,3,0.715909090909091
"647",21-06-11,"2 - 1066",18,73,18,0,55,1
"648",21-06-11,"82 - 1163",154,NA,12,142,NA,0.0779220779220779
"649",21-06-12,"40 - 1114",122,237,112,10,115,0.918032786885246
"650",21-06-12,"53 - 1103",86,91,61,25,5,0.709302325581395
"651",21-06-12,"2 - 1066",18,73,18,0,55,1
"652",21-06-12,"82 - 1163",154,NA,11,143,NA,0.0714285714285714
"653",21-06-13,"40 - 1114",122,237,112,10,115,0.918032786885246
"654",21-06-13,"53 - 1103",84,91,61,23,7,0.726190476190476
"655",21-06-13,"2 - 1066",18,73,18,0,55,1
"656",21-06-13,"82 - 1163",154,NA,9,145,NA,0.0584415584415584
"657",21-06-14,"40 - 1114",121,237,110,11,116,0.909090909090909
"658",21-06-14,"53 - 1103",86,91,61,25,5,0.709302325581395
"659",21-06-14,"2 - 1066",19,73,19,0,54,1
"660",21-06-14,"82 - 1163",154,NA,8,146,NA,0.051948051948052
"661",21-06-15,"40 - 1114",119,237,108,11,118,0.907563025210084
"662",21-06-15,"53 - 1103",81,91,60,21,10,0.740740740740741
"663",21-06-15,"2 - 1066",19,73,19,0,54,1
"664",21-06-15,"82 - 1163",154,NA,8,146,NA,0.051948051948052
"665",21-06-16,"40 - 1114",126,302,118,8,176,0.936507936507937
"666",21-06-16,"53 - 1103",89,91,59,30,2,0.662921348314607
"667",21-06-16,"2 - 1066",19,73,19,0,54,1
"668",21-06-16,"82 - 1163",114,NA,5,109,NA,0.043859649122807
"669",21-06-17,"40 - 1114",127,302,119,8,175,0.937007874015748
"670",21-06-17,"53 - 1103",89,91,59,30,2,0.662921348314607
"671",21-06-17,"2 - 1066",20,73,20,0,53,1
"672",21-06-17,"82 - 1163",114,NA,4,110,NA,0.0350877192982456
"673",21-06-18,"40 - 1114",138,302,124,14,164,0.898550724637681
"674",21-06-18,"53 - 1103",89,91,60,29,2,0.674157303370786
"675",21-06-18,"2 - 1066",21,73,21,0,52,1
"676",21-06-18,"82 - 1163",115,NA,5,110,NA,0.0434782608695652
"677",21-06-19,"40 - 1114",138,302,128,10,164,0.927536231884058
"678",21-06-19,"53 - 1103",89,91,61,28,2,0.685393258426966
"679",21-06-19,"2 - 1066",21,73,21,0,52,1
"680",21-06-19,"82 - 1163",115,NA,3,112,NA,0.0260869565217391
"681",21-06-20,"40 - 1114",138,302,129,9,164,0.934782608695652
"682",21-06-20,"53 - 1103",89,91,61,28,2,0.685393258426966
"683",21-06-20,"2 - 1066",20,73,20,0,53,1
"684",21-06-20,"82 - 1163",115,NA,3,112,NA,0.0260869565217391
"685",21-06-21,"40 - 1114",142,302,132,10,160,0.929577464788732
"686",21-06-21,"53 - 1103",89,91,62,27,2,0.696629213483146
"687",21-06-21,"2 - 1066",20,73,20,0,53,1
"688",21-06-21,"82 - 1163",115,NA,3,112,NA,0.0260869565217391
"689",21-06-22,"40 - 1114",145,302,133,12,157,0.917241379310345
"690",21-06-22,"53 - 1103",88,91,61,27,3,0.693181818181818
"691",21-06-22,"2 - 1066",20,73,20,0,53,1
"692",21-06-22,"82 - 1163",115,NA,4,111,NA,0.0347826086956522
"693",21-06-23,"40 - 1114",144,302,132,12,158,0.916666666666667
"694",21-06-23,"53 - 1103",89,91,64,25,2,0.719101123595506
"695",21-06-23,"2 - 1066",20,73,19,1,53,0.95
"696",21-06-23,"82 - 1163",115,NA,4,111,NA,0.0347826086956522
"697",21-06-24,"40 - 1114",144,302,133,11,158,0.923611111111111
"698",21-06-24,"53 - 1103",88,91,64,24,3,0.727272727272727
"699",21-06-24,"2 - 1066",19,73,19,0,54,1
"700",21-06-24,"82 - 1163",115,NA,5,110,NA,0.0434782608695652
"701",21-06-25,"40 - 1114",151,302,135,16,151,0.894039735099338
"702",21-06-25,"53 - 1103",88,91,63,25,3,0.715909090909091
"703",21-06-25,"2 - 1066",19,73,19,0,54,1
"704",21-06-25,"82 - 1163",116,NA,6,110,NA,0.0517241379310345
"705",21-06-26,"40 - 1114",151,302,135,16,151,0.894039735099338
"706",21-06-26,"53 - 1103",88,91,63,25,3,0.715909090909091
"707",21-06-26,"2 - 1066",20,73,20,0,53,1
"708",21-06-26,"82 - 1163",117,NA,6,111,NA,0.0512820512820513
"709",21-06-27,"40 - 1114",151,302,135,16,151,0.894039735099338
"710",21-06-27,"53 - 1103",88,91,62,26,3,0.704545454545455
"711",21-06-27,"2 - 1066",20,73,20,0,53,1
"712",21-06-27,"82 - 1163",117,NA,6,111,NA,0.0512820512820513
"713",21-06-28,"40 - 1114",147,302,138,9,155,0.938775510204082
"714",21-06-28,"53 - 1103",86,91,62,24,5,0.720930232558139
"715",21-06-28,"2 - 1066",20,73,20,0,53,1
"716",21-06-28,"82 - 1163",118,NA,8,110,NA,0.0677966101694915
"717",21-06-29,"40 - 1114",147,302,140,7,155,0.952380952380952
"718",21-06-29,"53 - 1103",86,91,64,22,5,0.744186046511628
"719",21-06-29,"2 - 1066",23,73,23,0,50,1
"720",21-06-29,"82 - 1163",118,NA,8,110,NA,0.0677966101694915
"721",21-06-30,"40 - 1114",170,302,143,27,132,0.841176470588235
"722",21-06-30,"53 - 1103",88,91,63,25,3,0.715909090909091
"723",21-06-30,"2 - 1066",22,73,22,0,51,1
"724",21-06-30,"82 - 1163",118,NA,8,110,NA,0.0677966101694915
"725",21-07-01,"40 - 1114",170,302,147,23,132,0.864705882352941
"726",21-07-01,"53 - 1103",84,91,62,22,7,0.738095238095238
"727",21-07-01,"2 - 1066",20,73,20,0,53,1
"728",21-07-01,"82 - 1163",118,NA,8,110,NA,0.0677966101694915
"729",21-07-02,"40 - 1114",172,302,148,24,130,0.86046511627907
"730",21-07-02,"53 - 1103",85,91,63,22,6,0.741176470588235
"731",21-07-02,"2 - 1066",19,73,19,0,54,1
"732",21-07-02,"82 - 1163",118,NA,10,108,NA,0.0847457627118644
"733",21-07-03,"40 - 1114",172,302,151,21,130,0.877906976744186
"734",21-07-03,"53 - 1103",85,91,64,21,6,0.752941176470588
"735",21-07-03,"2 - 1066",20,73,20,0,53,1
"736",21-07-03,"82 - 1163",118,NA,9,109,NA,0.076271186440678
"737",21-07-04,"40 - 1114",172,302,150,22,130,0.872093023255814
"738",21-07-04,"53 - 1103",81,91,64,17,10,0.790123456790123
"739",21-07-04,"2 - 1066",19,73,19,0,54,1
"740",21-07-04,"82 - 1163",118,NA,9,109,NA,0.076271186440678
"741",21-07-05,"40 - 1114",172,302,152,20,130,0.883720930232558
"742",21-07-05,"53 - 1103",77,91,65,12,14,0.844155844155844
"743",21-07-05,"2 - 1066",19,73,19,0,54,1
"744",21-07-05,"82 - 1163",118,NA,8,110,NA,0.0677966101694915
"745",21-07-06,"40 - 1114",174,302,154,20,128,0.885057471264368
"746",21-07-06,"53 - 1103",78,91,66,12,13,0.846153846153846
"747",21-07-06,"2 - 1066",19,73,19,0,54,1
"748",21-07-06,"82 - 1163",118,NA,11,107,NA,0.0932203389830508
"749",21-07-07,"40 - 1114",174,302,154,20,128,0.885057471264368
"750",21-07-07,"53 - 1103",80,91,64,16,11,0.8
"751",21-07-07,"2 - 1066",20,73,19,1,53,0.95
"752",21-07-07,"82 - 1163",66,NA,8,58,NA,0.121212121212121
"753",21-07-08,"40 - 1114",172,302,155,17,130,0.901162790697674
"754",21-07-08,"53 - 1103",61,91,61,0,30,1
"755",21-07-08,"2 - 1066",19,73,19,0,54,1
"756",21-07-08,"82 - 1163",66,NA,6,60,NA,0.0909090909090909
"757",21-07-09,"40 - 1114",179,230,157,22,51,0.877094972067039
"758",21-07-09,"53 - 1103",60,91,59,1,31,0.983333333333333
"759",21-07-09,"2 - 1066",19,73,19,0,54,1
"760",21-07-09,"82 - 1163",63,60,6,57,-3,0.0952380952380952
"761",21-07-10,"40 - 1114",181,232,158,23,51,0.87292817679558
"762",21-07-10,"53 - 1103",60,91,59,1,31,0.983333333333333
"763",21-07-10,"2 - 1066",20,73,20,0,53,1
"764",21-07-10,"82 - 1163",63,60,3,60,-3,0.0476190476190476
"765",21-07-11,"40 - 1114",179,230,160,19,51,0.893854748603352
"766",21-07-11,"53 - 1103",59,91,59,0,32,1
"767",21-07-11,"2 - 1066",20,73,20,0,53,1
"768",21-07-11,"82 - 1163",29,30,1,28,1,0.0344827586206897
"769",21-07-12,"40 - 1114",179,230,161,18,51,0.899441340782123
"770",21-07-12,"53 - 1103",59,91,58,1,32,0.983050847457627
"771",21-07-12,"2 - 1066",21,73,21,0,52,1
"772",21-07-12,"82 - 1163",29,30,1,28,1,0.0344827586206897
"773",21-07-13,"40 - 1114",183,232,157,26,49,0.85792349726776
"774",21-07-13,"53 - 1103",58,91,58,0,33,1
"775",21-07-13,"2 - 1066",19,73,19,0,54,1
"776",21-07-13,"82 - 1163",29,30,1,28,1,0.0344827586206897
"777",21-07-14,"40 - 1114",185,231,157,28,46,0.848648648648649
"778",21-07-14,"53 - 1103",57,91,57,0,34,1
"779",21-07-14,"2 - 1066",20,73,20,0,53,1
"780",21-07-14,"82 - 1163",63,60,3,60,-3,0.0476190476190476
"781",21-07-15,"40 - 1114",175,231,159,16,56,0.908571428571429
"782",21-07-15,"53 - 1103",56,91,56,0,35,1
"783",21-07-15,"2 - 1066",19,63,19,0,44,1
"784",21-07-15,"82 - 1163",63,60,4,59,-3,0.0634920634920635
"785",21-07-16,"40 - 1114",176,231,161,15,55,0.914772727272727
"786",21-07-16,"53 - 1103",55,91,55,0,36,1
"787",21-07-16,"2 - 1066",19,63,19,0,44,1
"788",21-07-16,"82 - 1163",63,60,4,59,-3,0.0634920634920635
"789",21-07-17,"40 - 1114",176,231,161,15,55,0.914772727272727
"790",21-07-17,"53 - 1103",55,91,55,0,36,1
"791",21-07-17,"2 - 1066",19,63,19,0,44,1
"792",21-07-17,"82 - 1163",34,30,2,32,-4,0.0588235294117647
"793",21-07-18,"40 - 1114",176,231,160,16,55,0.909090909090909
"794",21-07-18,"53 - 1103",55,91,55,0,36,1
"795",21-07-18,"2 - 1066",18,63,18,0,45,1
"796",21-07-18,"82 - 1163",34,30,1,33,-4,0.0294117647058824
"797",21-07-19,"40 - 1114",175,231,160,15,56,0.914285714285714
"798",21-07-19,"53 - 1103",53,91,53,0,38,1
"799",21-07-19,"2 - 1066",19,63,19,0,44,1
"800",21-07-19,"82 - 1163",62,60,2,60,-2,0.032258064516129
"801",21-07-20,"40 - 1114",175,231,161,14,56,0.92
"802",21-07-20,"53 - 1103",50,91,50,0,41,1
"803",21-07-20,"2 - 1066",20,63,20,0,43,1
"804",21-07-20,"82 - 1163",62,60,4,58,-2,0.0645161290322581
"805",21-07-21,"40 - 1114",180,231,163,17,51,0.905555555555556
"806",21-07-21,"53 - 1103",49,91,49,0,42,1
"807",21-07-21,"2 - 1066",21,63,21,0,42,1
"808",21-07-21,"82 - 1163",62,60,2,60,-2,0.032258064516129
"809",21-07-22,"40 - 1114",183,231,165,18,48,0.901639344262295
"810",21-07-22,"53 - 1103",48,91,48,0,43,1
"811",21-07-22,"2 - 1066",21,63,21,0,42,1
"812",21-07-22,"82 - 1163",28,30,2,26,2,0.0714285714285714
"813",21-07-23,"40 - 1114",181,231,166,15,50,0.917127071823204
"814",21-07-23,"53 - 1103",46,77,46,0,31,1
"815",21-07-23,"2 - 1066",21,63,21,0,42,1
"816",21-07-23,"82 - 1163",28,30,2,26,2,0.0714285714285714
"817",21-07-24,"40 - 1114",181,231,165,16,50,0.911602209944751
"818",21-07-24,"53 - 1103",45,77,45,0,32,1
"819",21-07-24,"2 - 1066",21,63,21,0,42,1
"820",21-07-24,"82 - 1163",62,60,3,59,-2,0.0483870967741935
"821",21-07-25,"40 - 1114",181,231,165,16,50,0.911602209944751
"822",21-07-25,"53 - 1103",45,77,45,0,32,1
"823",21-07-25,"2 - 1066",21,63,21,0,42,1
"824",21-07-25,"82 - 1163",62,60,4,58,-2,0.0645161290322581
"825",21-07-26,"40 - 1114",177,231,165,12,54,0.932203389830508
"826",21-07-26,"53 - 1103",44,77,43,1,33,0.977272727272727
"827",21-07-26,"2 - 1066",20,63,20,0,43,1
"828",21-07-26,"82 - 1163",62,60,5,57,-2,0.0806451612903226
"829",21-07-27,"40 - 1114",176,231,163,13,55,0.926136363636364
"830",21-07-27,"53 - 1103",43,77,43,0,34,1
"831",21-07-27,"2 - 1066",20,63,20,0,43,1
"832",21-07-27,"82 - 1163",62,60,4,58,-2,0.0645161290322581
"833",21-07-28,"40 - 1114",172,231,160,12,59,0.930232558139535
"834",21-07-28,"53 - 1103",39,91,39,0,52,1
"835",21-07-28,"2 - 1066",20,63,20,0,43,1
"836",21-07-28,"82 - 1163",62,60,2,60,-2,0.032258064516129
"837",21-07-29,"40 - 1114",172,231,159,13,59,0.924418604651163
"838",21-07-29,"53 - 1103",37,91,37,0,54,1
"839",21-07-29,"2 - 1066",20,63,20,0,43,1
"840",21-07-29,"82 - 1163",62,60,2,60,-2,0.032258064516129
"841",21-07-30,"40 - 1114",175,231,161,14,56,0.92
"842",21-07-30,"53 - 1103",36,91,34,2,55,0.944444444444444
"843",21-07-30,"2 - 1066",20,63,20,0,43,1
"844",21-07-30,"82 - 1163",62,60,2,60,-2,0.032258064516129
"845",21-07-31,"40 - 1114",176,231,161,15,55,0.914772727272727
"846",21-07-31,"53 - 1103",32,91,32,0,59,1
"847",21-07-31,"2 - 1066",19,63,19,0,44,1
"848",21-07-31,"82 - 1163",62,60,2,60,-2,0.032258064516129
"849",21-08-01,"40 - 1114",176,231,163,13,55,0.926136363636364
"850",21-08-01,"53 - 1103",32,91,32,0,59,1
"851",21-08-01,"2 - 1066",19,63,19,0,44,1
"852",21-08-01,"82 - 1163",62,60,3,59,-2,0.0483870967741935
"853",21-08-02,"40 - 1114",176,231,163,13,55,0.926136363636364
"854",21-08-02,"53 - 1103",32,91,32,0,59,1
"855",21-08-02,"2 - 1066",19,63,19,0,44,1
"856",21-08-02,"82 - 1163",62,60,2,60,-2,0.032258064516129
"857",21-08-03,"40 - 1114",179,231,165,14,52,0.921787709497207
"858",21-08-03,"53 - 1103",31,91,31,0,60,1
"859",21-08-03,"2 - 1066",18,63,18,0,45,1
"860",21-08-03,"82 - 1163",62,60,4,58,-2,0.0645161290322581
"861",21-08-04,"40 - 1114",180,231,166,14,51,0.922222222222222
"862",21-08-04,"53 - 1103",33,91,33,0,58,1
"863",21-08-04,"2 - 1066",18,63,18,0,45,1
"864",21-08-04,"82 - 1163",62,60,4,58,-2,0.0645161290322581
"865",21-08-05,"40 - 1114",167,231,164,3,64,0.982035928143713
"866",21-08-05,"53 - 1103",33,91,33,0,58,1
"867",21-08-05,"2 - 1066",18,63,18,0,45,1
"868",21-08-05,"82 - 1163",62,60,7,55,-2,0.112903225806452
"869",21-08-06,"40 - 1114",171,231,165,6,60,0.964912280701754
"870",21-08-06,"53 - 1103",33,91,33,0,58,1
"871",21-08-06,"2 - 1066",18,63,18,0,45,1
"872",21-08-06,"82 - 1163",62,60,10,52,-2,0.161290322580645
"873",21-08-07,"40 - 1114",171,231,165,6,60,0.964912280701754
"874",21-08-07,"53 - 1103",33,91,33,0,58,1
"875",21-08-07,"2 - 1066",19,63,19,0,44,1
"876",21-08-07,"82 - 1163",62,60,7,55,-2,0.112903225806452
"877",21-08-08,"40 - 1114",171,231,163,8,60,0.953216374269006
"878",21-08-08,"53 - 1103",33,91,33,0,58,1
"879",21-08-08,"2 - 1066",18,63,18,0,45,1
"880",21-08-08,"82 - 1163",62,60,6,56,-2,0.0967741935483871
"881",21-08-09,"40 - 1114",168,231,162,6,63,0.964285714285714
"882",21-08-09,"53 - 1103",33,91,33,0,58,1
"883",21-08-09,"2 - 1066",17,63,17,0,46,1
"884",21-08-09,"82 - 1163",62,60,5,57,-2,0.0806451612903226
"885",21-08-10,"40 - 1114",167,231,161,6,64,0.964071856287425
"886",21-08-10,"53 - 1103",33,91,33,0,58,1
"887",21-08-10,"2 - 1066",17,63,17,0,46,1
"888",21-08-10,"82 - 1163",62,60,4,58,-2,0.0645161290322581
"889",21-08-11,"40 - 1114",167,231,159,8,64,0.952095808383233
"890",21-08-11,"53 - 1103",33,91,33,0,58,1
"891",21-08-11,"2 - 1066",18,63,18,0,45,1
"892",21-08-11,"82 - 1163",62,60,4,58,-2,0.0645161290322581
"893",21-08-12,"40 - 1114",167,231,162,5,64,0.970059880239521
"894",21-08-12,"53 - 1103",33,91,33,0,58,1
"895",21-08-12,"2 - 1066",18,63,18,0,45,1
"896",21-08-12,"82 - 1163",62,60,5,57,-2,0.0806451612903226
"897",21-08-13,"40 - 1114",168,231,162,6,63,0.964285714285714
"898",21-08-13,"53 - 1103",33,91,33,0,58,1
"899",21-08-13,"2 - 1066",19,63,19,0,44,1
"900",21-08-13,"82 - 1163",62,60,4,58,-2,0.0645161290322581
"901",21-08-14,"40 - 1114",168,231,162,6,63,0.964285714285714
"902",21-08-14,"53 - 1103",33,91,33,0,58,1
"903",21-08-14,"2 - 1066",21,63,21,0,42,1
"904",21-08-14,"82 - 1163",62,60,4,58,-2,0.0645161290322581
"905",21-08-15,"40 - 1114",168,231,162,6,63,0.964285714285714
"906",21-08-15,"53 - 1103",33,91,33,0,58,1
"907",21-08-15,"2 - 1066",22,63,22,0,41,1
"908",21-08-15,"82 - 1163",34,30,3,31,-4,0.0882352941176471
"909",21-08-16,"40 - 1114",170,231,164,6,61,0.964705882352941
"910",21-08-16,"53 - 1103",33,91,33,0,58,1
"911",21-08-16,"2 - 1066",23,63,23,0,40,1
"912",21-08-16,"82 - 1163",34,30,5,29,-4,0.147058823529412
"913",21-08-17,"40 - 1114",170,231,164,6,61,0.964705882352941
"914",21-08-17,"53 - 1103",33,91,32,1,58,0.96969696969697
"915",21-08-17,"2 - 1066",23,63,23,0,40,1
"916",21-08-17,"82 - 1163",34,30,5,29,-4,0.147058823529412
"917",21-08-18,"40 - 1114",166,231,161,5,65,0.969879518072289
"918",21-08-18,"53 - 1103",32,91,32,0,59,1
"919",21-08-18,"2 - 1066",24,63,24,0,39,1
"920",21-08-18,"82 - 1163",34,30,8,26,-4,0.235294117647059
"921",21-08-19,"40 - 1114",165,231,161,4,66,0.975757575757576
"922",21-08-19,"53 - 1103",33,91,33,0,58,1
"923",21-08-19,"2 - 1066",24,63,23,1,39,0.958333333333333
"924",21-08-19,"82 - 1163",63,60,13,50,-3,0.206349206349206
"925",21-08-20,"40 - 1114",165,231,162,3,66,0.981818181818182
"926",21-08-20,"53 - 1103",33,91,33,0,58,1
"927",21-08-20,"2 - 1066",22,63,22,0,41,1
"928",21-08-20,"82 - 1163",63,60,8,55,-3,0.126984126984127
"929",21-08-21,"40 - 1114",165,231,163,2,66,0.987878787878788
"930",21-08-21,"53 - 1103",33,91,32,1,58,0.96969696969697
"931",21-08-21,"2 - 1066",20,63,20,0,43,1
"932",21-08-21,"82 - 1163",63,60,8,55,-3,0.126984126984127
"933",21-08-22,"40 - 1114",165,231,163,2,66,0.987878787878788
"934",21-08-22,"53 - 1103",31,91,31,0,60,1
"935",21-08-22,"2 - 1066",19,63,19,0,44,1
"936",21-08-22,"82 - 1163",63,60,9,54,-3,0.142857142857143
"937",21-08-23,"40 - 1114",165,231,163,2,66,0.987878787878788
"938",21-08-23,"53 - 1103",31,91,31,0,60,1
"939",21-08-23,"2 - 1066",19,63,19,0,44,1
"940",21-08-23,"82 - 1163",63,60,10,53,-3,0.158730158730159
"941",21-08-24,"40 - 1114",163,231,160,3,68,0.98159509202454
"942",21-08-24,"53 - 1103",31,91,31,0,60,1
"943",21-08-24,"2 - 1066",17,63,17,0,46,1
"944",21-08-24,"82 - 1163",63,60,9,54,-3,0.142857142857143
"945",21-08-25,"40 - 1114",162,231,160,2,69,0.987654320987654
"946",21-08-25,"53 - 1103",30,91,30,0,61,1
"947",21-08-25,"2 - 1066",17,63,17,0,46,1
"948",21-08-25,"82 - 1163",63,60,10,53,-3,0.158730158730159
"949",21-08-26,"40 - 1114",163,231,160,3,68,0.98159509202454
"950",21-08-26,"53 - 1103",31,91,30,1,60,0.967741935483871
"951",21-08-26,"2 - 1066",19,63,19,0,44,1
"952",21-08-26,"82 - 1163",63,60,8,55,-3,0.126984126984127
"953",21-08-27,"40 - 1114",163,231,160,3,68,0.98159509202454
"954",21-08-27,"53 - 1103",31,91,30,1,60,0.967741935483871
"955",21-08-27,"2 - 1066",17,63,17,0,46,1
"956",21-08-27,"82 - 1163",63,60,10,53,-3,0.158730158730159
"957",21-08-28,"40 - 1114",163,231,160,3,68,0.98159509202454
"958",21-08-28,"53 - 1103",30,91,30,0,61,1
"959",21-08-28,"2 - 1066",17,63,17,0,46,1
"960",21-08-28,"82 - 1163",63,60,9,54,-3,0.142857142857143
"961",21-08-29,"40 - 1114",163,231,160,3,68,0.98159509202454
"962",21-08-29,"53 - 1103",30,91,30,0,61,1
"963",21-08-29,"2 - 1066",17,63,17,0,46,1
"964",21-08-29,"82 - 1163",63,60,9,54,-3,0.142857142857143
"965",21-08-30,"40 - 1114",163,231,159,4,68,0.975460122699387
"966",21-08-30,"53 - 1103",31,91,30,1,60,0.967741935483871
"967",21-08-30,"2 - 1066",18,63,18,0,45,1
"968",21-08-30,"82 - 1163",63,60,7,56,-3,0.111111111111111
"969",21-08-31,"40 - 1114",164,231,159,5,67,0.969512195121951
"970",21-08-31,"53 - 1103",30,91,30,0,61,1
"971",21-08-31,"2 - 1066",20,63,20,0,43,1
"972",21-08-31,"82 - 1163",63,60,11,52,-3,0.174603174603175
"973",21-09-01,"40 - 1114",163,231,161,2,68,0.987730061349693
"974",21-09-01,"53 - 1103",29,91,29,0,62,1
"975",21-09-01,"2 - 1066",20,63,20,0,43,1
"976",21-09-01,"82 - 1163",63,60,11,52,-3,0.174603174603175
"977",21-09-02,"40 - 1114",163,231,161,2,68,0.987730061349693
"978",21-09-02,"53 - 1103",28,91,28,0,63,1
"979",21-09-02,"2 - 1066",23,63,23,0,40,1
"980",21-09-02,"82 - 1163",63,60,10,53,-3,0.158730158730159
"981",21-09-03,"40 - 1114",161,231,159,2,70,0.987577639751553
"982",21-09-03,"53 - 1103",28,91,28,0,63,1
"983",21-09-03,"2 - 1066",23,63,23,0,40,1
"984",21-09-03,"82 - 1163",63,60,10,53,-3,0.158730158730159
"985",21-09-04,"40 - 1114",161,231,159,2,70,0.987577639751553
"986",21-09-04,"53 - 1103",28,91,28,0,63,1
"987",21-09-04,"2 - 1066",23,63,23,0,40,1
"988",21-09-04,"82 - 1163",63,60,10,53,-3,0.158730158730159
"989",21-09-05,"40 - 1114",161,231,158,3,70,0.981366459627329
"990",21-09-05,"53 - 1103",28,91,28,0,63,1
"991",21-09-05,"2 - 1066",23,63,23,0,40,1
"992",21-09-05,"82 - 1163",63,60,10,53,-3,0.158730158730159
"993",21-09-06,"40 - 1114",161,231,158,3,70,0.981366459627329
"994",21-09-06,"53 - 1103",28,91,28,0,63,1
"995",21-09-06,"2 - 1066",24,63,24,0,39,1
"996",21-09-06,"82 - 1163",63,60,10,53,-3,0.158730158730159
"997",21-09-07,"40 - 1114",161,231,158,3,70,0.981366459627329
"998",21-09-07,"53 - 1103",28,91,28,0,63,1
"999",21-09-07,"2 - 1066",25,63,25,0,38,1
"1000",21-09-07,"82 - 1163",63,60,9,54,-3,0.142857142857143
"1001",21-09-08,"40 - 1114",158,231,157,1,73,0.993670886075949
"1002",21-09-08,"53 - 1103",28,91,28,0,63,1
"1003",21-09-08,"2 - 1066",26,63,26,0,37,1
"1004",21-09-08,"82 - 1163",63,60,10,53,-3,0.158730158730159
"1005",21-09-09,"40 - 1114",158,231,157,1,73,0.993670886075949
"1006",21-09-09,"53 - 1103",28,91,28,0,63,1
"1007",21-09-09,"2 - 1066",27,63,27,0,36,1
"1008",21-09-09,"82 - 1163",63,60,10,53,-3,0.158730158730159
"1009",21-09-10,"40 - 1114",161,231,159,2,70,0.987577639751553
"1010",21-09-10,"53 - 1103",27,77,27,0,50,1
"1011",21-09-10,"2 - 1066",26,63,26,0,37,1
"1012",21-09-10,"82 - 1163",63,60,12,51,-3,0.19047619047619
"1013",21-09-11,"40 - 1114",161,231,156,5,70,0.968944099378882
"1014",21-09-11,"53 - 1103",27,77,27,0,50,1
"1015",21-09-11,"2 - 1066",26,63,26,0,37,1
"1016",21-09-11,"82 - 1163",63,60,7,56,-3,0.111111111111111
"1017",21-09-12,"40 - 1114",161,231,154,7,70,0.956521739130435
"1018",21-09-12,"53 - 1103",27,77,27,0,50,1
"1019",21-09-12,"2 - 1066",26,63,25,1,37,0.961538461538462
"1020",21-09-12,"82 - 1163",63,60,6,57,-3,0.0952380952380952
"1021",21-09-13,"40 - 1114",163,231,156,7,68,0.957055214723926
"1022",21-09-13,"53 - 1103",31,77,27,4,46,0.870967741935484
"1023",21-09-13,"2 - 1066",25,63,25,0,38,1
"1024",21-09-13,"82 - 1163",63,60,12,51,-3,0.19047619047619
"1025",21-09-14,"40 - 1114",163,231,156,7,68,0.957055214723926
"1026",21-09-14,"53 - 1103",31,77,27,4,46,0.870967741935484
"1027",21-09-14,"2 - 1066",26,63,26,0,37,1
"1028",21-09-14,"82 - 1163",63,60,12,51,-3,0.19047619047619
"1029",21-09-15,"40 - 1114",163,231,156,7,68,0.957055214723926
"1030",21-09-15,"53 - 1103",32,77,27,5,45,0.84375
"1031",21-09-15,"2 - 1066",26,63,26,0,37,1
"1032",21-09-15,"82 - 1163",63,60,17,46,-3,0.26984126984127
"1033",21-09-16,"40 - 1114",163,231,156,7,68,0.957055214723926
"1034",21-09-16,"53 - 1103",27,77,27,0,50,1
"1035",21-09-16,"2 - 1066",26,63,26,0,37,1
"1036",21-09-16,"82 - 1163",63,60,19,44,-3,0.301587301587302
"1037",21-09-17,"40 - 1114",162,231,156,6,69,0.962962962962963
"1038",21-09-17,"53 - 1103",27,77,27,0,50,1
"1039",21-09-17,"2 - 1066",26,63,26,0,37,1
"1040",21-09-17,"82 - 1163",63,60,20,43,-3,0.317460317460317
"1041",21-09-18,"40 - 1114",162,231,155,7,69,0.95679012345679
"1042",21-09-18,"53 - 1103",27,77,27,0,50,1
"1043",21-09-18,"2 - 1066",26,63,26,0,37,1
"1044",21-09-18,"82 - 1163",63,60,20,43,-3,0.317460317460317
"1045",21-09-19,"40 - 1114",162,231,155,7,69,0.95679012345679
"1046",21-09-19,"53 - 1103",27,77,27,0,50,1
"1047",21-09-19,"2 - 1066",26,63,26,0,37,1
"1048",21-09-19,"82 - 1163",63,60,18,45,-3,0.285714285714286
"1049",21-09-20,"40 - 1114",160,229,155,5,69,0.96875
"1050",21-09-20,"53 - 1103",33,77,28,5,44,0.848484848484849
"1051",21-09-20,"2 - 1066",24,63,24,0,39,1
"1052",21-09-20,"82 - 1163",63,60,19,44,-3,0.301587301587302
"1053",21-09-21,"40 - 1114",160,229,155,5,69,0.96875
"1054",21-09-21,"53 - 1103",33,77,28,5,44,0.848484848484849
"1055",21-09-21,"2 - 1066",25,63,25,0,38,1
"1056",21-09-21,"82 - 1163",63,60,18,45,-3,0.285714285714286
"1057",21-09-22,"40 - 1114",160,229,156,4,69,0.975
"1058",21-09-22,"53 - 1103",33,77,28,5,44,0.848484848484849
"1059",21-09-22,"2 - 1066",27,63,27,0,36,1
"1060",21-09-22,"82 - 1163",63,60,20,43,-3,0.317460317460317
"1061",21-09-23,"40 - 1114",159,229,156,3,70,0.981132075471698
"1062",21-09-23,"53 - 1103",33,77,28,5,44,0.848484848484849
"1063",21-09-23,"2 - 1066",27,63,27,0,36,1
"1064",21-09-23,"82 - 1163",63,60,19,44,-3,0.301587301587302
"1065",21-09-24,"40 - 1114",159,229,155,4,70,0.974842767295597
"1066",21-09-24,"53 - 1103",33,77,30,3,44,0.909090909090909
"1067",21-09-24,"2 - 1066",27,63,27,0,36,1
"1068",21-09-24,"82 - 1163",63,60,17,46,-3,0.26984126984127
"1069",21-09-25,"40 - 1114",159,229,155,4,70,0.974842767295597
"1070",21-09-25,"53 - 1103",31,77,31,0,46,1
"1071",21-09-25,"2 - 1066",27,63,27,0,36,1
"1072",21-09-25,"82 - 1163",63,60,15,48,-3,0.238095238095238
"1073",21-09-26,"40 - 1114",159,229,154,5,70,0.968553459119497
"1074",21-09-26,"53 - 1103",31,77,30,1,46,0.967741935483871
"1075",21-09-26,"2 - 1066",27,63,27,0,36,1
"1076",21-09-26,"82 - 1163",63,60,13,50,-3,0.206349206349206
"1077",21-09-27,"40 - 1114",160,229,158,2,69,0.9875
"1078",21-09-27,"53 - 1103",30,77,30,0,47,1
"1079",21-09-27,"2 - 1066",27,63,27,0,36,1
"1080",21-09-27,"82 - 1163",63,60,13,50,-3,0.206349206349206
"1081",21-09-28,"40 - 1114",158,229,158,0,71,1
"1082",21-09-28,"53 - 1103",30,77,29,1,47,0.966666666666667
"1083",21-09-28,"2 - 1066",27,63,27,0,36,1
"1084",21-09-28,"82 - 1163",63,60,10,53,-3,0.158730158730159
"1085",21-09-29,"40 - 1114",157,229,157,0,72,1
"1086",21-09-29,"53 - 1103",28,77,28,0,49,1
"1087",21-09-29,"2 - 1066",27,63,27,0,36,1
"1088",21-09-29,"82 - 1163",63,60,14,49,-3,0.222222222222222
"1089",21-09-30,"40 - 1114",161,229,161,0,68,1
"1090",21-09-30,"53 - 1103",28,77,27,1,49,0.964285714285714
"1091",21-09-30,"2 - 1066",28,63,28,0,35,1
"1092",21-09-30,"82 - 1163",63,60,16,47,-3,0.253968253968254
"1093",21-10-01,"40 - 1114",166,230,162,4,64,0.975903614457831
"1094",21-10-01,"53 - 1103",27,77,27,0,50,1
"1095",21-10-01,"2 - 1066",30,63,30,0,33,1
"1096",21-10-01,"82 - 1163",63,60,16,47,-3,0.253968253968254
"1097",21-10-02,"40 - 1114",166,230,162,4,64,0.975903614457831
"1098",21-10-02,"53 - 1103",30,77,27,3,47,0.9
"1099",21-10-02,"2 - 1066",31,63,31,0,32,1
"1100",21-10-02,"82 - 1163",63,60,15,48,-3,0.238095238095238
"1101",21-10-03,"40 - 1114",166,230,162,4,64,0.975903614457831
"1102",21-10-03,"53 - 1103",27,77,27,0,50,1
"1103",21-10-03,"2 - 1066",32,63,32,0,31,1
"1104",21-10-03,"82 - 1163",63,60,13,50,-3,0.206349206349206
"1105",21-10-04,"40 - 1114",165,230,164,1,65,0.993939393939394
"1106",21-10-04,"53 - 1103",47,77,29,18,30,0.617021276595745
"1107",21-10-04,"2 - 1066",33,63,33,0,30,1
"1108",21-10-04,"82 - 1163",63,60,16,47,-3,0.253968253968254
"1109",21-10-05,"40 - 1114",168,230,163,5,62,0.970238095238095
"1110",21-10-05,"53 - 1103",45,77,29,16,32,0.644444444444444
"1111",21-10-05,"2 - 1066",34,63,34,0,29,1
"1112",21-10-05,"82 - 1163",63,60,10,53,-3,0.158730158730159
"1113",21-10-06,"40 - 1114",168,230,163,5,62,0.970238095238095
"1114",21-10-06,"53 - 1103",45,77,30,15,32,0.666666666666667
"1115",21-10-06,"2 - 1066",35,63,35,0,28,1
"1116",21-10-06,"82 - 1163",63,60,8,55,-3,0.126984126984127
"1117",21-10-07,"40 - 1114",175,230,166,9,55,0.948571428571429
"1118",21-10-07,"53 - 1103",58,77,33,25,19,0.568965517241379
"1119",21-10-07,"2 - 1066",35,63,35,0,28,1
"1120",21-10-07,"82 - 1163",63,60,10,53,-3,0.158730158730159
"1121",21-10-08,"40 - 1114",189,230,180,9,41,0.952380952380952
"1122",21-10-08,"53 - 1103",59,77,38,21,18,0.644067796610169
"1123",21-10-08,"2 - 1066",35,63,35,0,28,1
"1124",21-10-08,"82 - 1163",63,60,9,54,-3,0.142857142857143
"1125",21-10-09,"40 - 1114",190,230,183,7,40,0.963157894736842
"1126",21-10-09,"53 - 1103",59,77,39,20,18,0.661016949152542
"1127",21-10-09,"2 - 1066",34,63,34,0,29,1
"1128",21-10-09,"82 - 1163",63,60,8,55,-3,0.126984126984127
"1129",21-10-10,"40 - 1114",190,230,184,6,40,0.968421052631579
"1130",21-10-10,"53 - 1103",56,77,38,18,21,0.678571428571429
"1131",21-10-10,"2 - 1066",34,63,34,0,29,1
"1132",21-10-10,"82 - 1163",63,60,9,54,-3,0.142857142857143
"1133",21-10-11,"40 - 1114",190,230,185,5,40,0.973684210526316
"1134",21-10-11,"53 - 1103",55,77,37,18,22,0.672727272727273
"1135",21-10-11,"2 - 1066",34,63,34,0,29,1
"1136",21-10-11,"82 - 1163",63,60,11,52,-3,0.174603174603175
"1137",21-10-12,"40 - 1114",192,230,189,3,38,0.984375
"1138",21-10-12,"53 - 1103",55,77,36,19,22,0.654545454545455
"1139",21-10-12,"2 - 1066",34,63,34,0,29,1
"1140",21-10-12,"82 - 1163",63,60,11,52,-3,0.174603174603175
"1141",21-10-13,"40 - 1114",199,230,196,3,31,0.984924623115578
"1142",21-10-13,"53 - 1103",73,77,37,36,4,0.506849315068493
"1143",21-10-13,"2 - 1066",34,63,34,0,29,1
"1144",21-10-13,"82 - 1163",63,60,10,53,-3,0.158730158730159
"1145",21-10-14,"40 - 1114",204,232,203,1,28,0.995098039215686
"1146",21-10-14,"53 - 1103",39,77,39,0,38,1
"1147",21-10-14,"2 - 1066",35,63,35,0,28,1
"1148",21-10-14,"82 - 1163",63,60,10,53,-3,0.158730158730159
"1149",21-10-15,"40 - 1114",208,232,204,4,24,0.980769230769231
"1150",21-10-15,"53 - 1103",37,77,36,1,40,0.972972972972973
"1151",21-10-15,"2 - 1066",35,63,35,0,28,1
"1152",21-10-15,"82 - 1163",63,60,8,55,-3,0.126984126984127
"1153",21-10-16,"40 - 1114",208,232,204,4,24,0.980769230769231
"1154",21-10-16,"53 - 1103",37,77,37,0,40,1
"1155",21-10-16,"2 - 1066",35,63,35,0,28,1
"1156",21-10-16,"82 - 1163",63,60,8,55,-3,0.126984126984127
"1157",21-10-17,"40 - 1114",208,232,203,5,24,0.975961538461538
"1158",21-10-17,"53 - 1103",37,77,37,0,40,1
"1159",21-10-17,"2 - 1066",34,63,34,0,29,1
"1160",21-10-17,"82 - 1163",63,60,9,54,-3,0.142857142857143
"1161",21-10-18,"40 - 1114",210,232,208,2,22,0.990476190476191
"1162",21-10-18,"53 - 1103",37,77,37,0,40,1
"1163",21-10-18,"2 - 1066",34,63,34,0,29,1
"1164",21-10-18,"82 - 1163",63,60,8,55,-3,0.126984126984127
"1165",21-10-19,"40 - 1114",211,232,207,4,21,0.981042654028436
"1166",21-10-19,"53 - 1103",38,77,37,1,39,0.973684210526316
"1167",21-10-19,"2 - 1066",34,63,34,0,29,1
"1168",21-10-19,"82 - 1163",63,60,8,55,-3,0.126984126984127
"1169",21-10-20,"40 - 1114",210,232,206,4,22,0.980952380952381
"1170",21-10-20,"53 - 1103",38,77,36,2,39,0.947368421052632
"1171",21-10-20,"2 - 1066",34,63,34,0,29,1
"1172",21-10-20,"82 - 1163",63,60,6,57,-3,0.0952380952380952
"1173",21-10-21,"40 - 1114",207,233,204,3,26,0.985507246376812
"1174",21-10-21,"53 - 1103",38,77,35,3,39,0.921052631578947
"1175",21-10-21,"2 - 1066",34,63,34,0,29,1
"1176",21-10-21,"82 - 1163",63,60,4,59,-3,0.0634920634920635
"1177",21-10-22,"40 - 1114",209,233,205,4,24,0.980861244019139
"1178",21-10-22,"53 - 1103",39,77,35,4,38,0.897435897435897
"1179",21-10-22,"2 - 1066",35,63,35,0,28,1
"1180",21-10-22,"82 - 1163",63,60,6,57,-3,0.0952380952380952
"1181",21-10-23,"40 - 1114",209,233,207,2,24,0.990430622009569
"1182",21-10-23,"53 - 1103",39,77,35,4,38,0.897435897435897
"1183",21-10-23,"2 - 1066",35,63,35,0,28,1
"1184",21-10-23,"82 - 1163",33,30,2,31,-3,0.0606060606060606
"1185",21-10-24,"40 - 1114",209,233,208,1,24,0.995215311004785
"1186",21-10-24,"53 - 1103",39,77,35,4,38,0.897435897435897
"1187",21-10-24,"2 - 1066",35,63,35,0,28,1
"1188",21-10-24,"82 - 1163",33,30,2,31,-3,0.0606060606060606
"1189",21-10-25,"40 - 1114",212,233,209,3,21,0.985849056603774
"1190",21-10-25,"53 - 1103",39,77,37,2,38,0.948717948717949
"1191",21-10-25,"2 - 1066",35,63,35,0,28,1
"1192",21-10-25,"82 - 1163",33,30,4,29,-3,0.121212121212121
"1193",21-10-26,"40 - 1114",214,233,212,2,19,0.990654205607477
"1194",21-10-26,"53 - 1103",38,77,38,0,39,1
"1195",21-10-26,"2 - 1066",33,63,33,0,30,1
"1196",21-10-26,"82 - 1163",33,30,4,29,-3,0.121212121212121
"1197",21-10-27,"40 - 1114",218,233,213,5,15,0.977064220183486
"1198",21-10-27,"53 - 1103",59,77,45,14,18,0.76271186440678
"1199",21-10-27,"2 - 1066",33,63,33,0,30,1
"1200",21-10-27,"82 - 1163",33,30,2,31,-3,0.0606060606060606
"1201",21-10-28,"40 - 1114",221,233,213,8,12,0.963800904977376
"1202",21-10-28,"53 - 1103",56,77,55,1,21,0.982142857142857
"1203",21-10-28,"2 - 1066",33,63,33,0,30,1
"1204",21-10-28,"82 - 1163",33,30,2,31,-3,0.0606060606060606
"1205",21-10-29,"40 - 1114",217,233,214,3,16,0.986175115207373
"1206",21-10-29,"53 - 1103",57,77,57,0,20,1
"1207",21-10-29,"2 - 1066",33,63,33,0,30,1
"1208",21-10-29,"82 - 1163",33,30,3,30,-3,0.0909090909090909
"1209",21-10-30,"40 - 1114",217,233,216,1,16,0.995391705069124
"1210",21-10-30,"53 - 1103",56,77,56,0,21,1
"1211",21-10-30,"2 - 1066",34,63,34,0,29,1
"1212",21-10-30,"82 - 1163",33,30,3,30,-3,0.0909090909090909
"1213",21-10-31,"40 - 1114",219,233,217,2,14,0.990867579908676
"1214",21-10-31,"53 - 1103",57,77,55,2,20,0.964912280701754
"1215",21-10-31,"2 - 1066",34,63,34,0,29,1
"1216",21-10-31,"82 - 1163",33,30,2,31,-3,0.0606060606060606
"1217",21-11-01,"40 - 1114",220,233,218,2,13,0.990909090909091
"1218",21-11-01,"53 - 1103",56,77,56,0,21,1
"1219",21-11-01,"2 - 1066",31,63,31,0,32,1
"1220",21-11-01,"82 - 1163",33,30,3,30,-3,0.0909090909090909
"1221",21-11-02,"40 - 1114",220,233,220,0,13,1
"1222",21-11-02,"53 - 1103",57,77,57,0,20,1
"1223",21-11-02,"2 - 1066",34,73,34,0,39,1
"1224",21-11-02,"82 - 1163",33,30,2,31,-3,0.0606060606060606
"1225",21-11-03,"40 - 1114",218,233,218,0,15,1
"1226",21-11-03,"53 - 1103",57,77,57,0,20,1
"1227",21-11-03,"2 - 1066",34,73,34,0,39,1
"1228",21-11-03,"82 - 1163",33,30,3,30,-3,0.0909090909090909
"1229",21-11-04,"40 - 1114",224,233,223,1,9,0.995535714285714
"1230",21-11-04,"53 - 1103",58,77,57,1,19,0.982758620689655
"1231",21-11-04,"2 - 1066",35,73,35,0,38,1
"1232",21-11-04,"82 - 1163",33,30,6,27,-3,0.181818181818182
"1233",21-11-05,"40 - 1114",225,233,222,3,8,0.986666666666667
"1234",21-11-05,"53 - 1103",54,77,54,0,23,1
"1235",21-11-05,"2 - 1066",34,73,34,0,39,1
"1236",21-11-05,"82 - 1163",33,30,4,29,-3,0.121212121212121
"1237",21-11-06,"40 - 1114",225,233,225,0,8,1
"1238",21-11-06,"53 - 1103",54,77,54,0,23,1
"1239",21-11-06,"2 - 1066",34,73,34,0,39,1
"1240",21-11-06,"82 - 1163",33,30,3,30,-3,0.0909090909090909
"1241",21-11-07,"40 - 1114",225,233,225,0,8,1
"1242",21-11-07,"53 - 1103",55,77,53,2,22,0.963636363636364
"1243",21-11-07,"2 - 1066",34,73,34,0,39,1
"1244",21-11-07,"82 - 1163",63,60,4,59,-3,0.0634920634920635
"1245",21-11-08,"40 - 1114",226,233,226,0,7,1
"1246",21-11-08,"53 - 1103",55,77,53,2,22,0.963636363636364
"1247",21-11-08,"2 - 1066",34,73,34,0,39,1
"1248",21-11-08,"82 - 1163",33,30,2,31,-3,0.0606060606060606
"1249",21-11-09,"40 - 1114",226,233,226,0,7,1
"1250",21-11-09,"53 - 1103",56,77,53,3,21,0.946428571428571
"1251",21-11-09,"2 - 1066",34,73,34,0,39,1
"1252",21-11-09,"82 - 1163",33,30,7,26,-3,0.212121212121212
"1253",21-11-10,"40 - 1114",224,233,224,0,9,1
"1254",21-11-10,"53 - 1103",58,77,54,4,19,0.931034482758621
"1255",21-11-10,"2 - 1066",34,73,34,0,39,1
"1256",21-11-10,"82 - 1163",33,30,4,29,-3,0.121212121212121
"1257",21-11-11,"40 - 1114",223,233,223,0,10,1
"1258",21-11-11,"53 - 1103",58,77,54,4,19,0.931034482758621
"1259",21-11-11,"2 - 1066",34,73,34,0,39,1
"1260",21-11-11,"82 - 1163",33,30,5,28,-3,0.151515151515152
"1261",21-11-12,"40 - 1114",224,232,224,0,8,1
"1262",21-11-12,"53 - 1103",58,77,54,4,19,0.931034482758621
"1263",21-11-12,"2 - 1066",34,73,34,0,39,1
"1264",21-11-12,"82 - 1163",33,30,5,28,-3,0.151515151515152
"1265",21-11-13,"40 - 1114",224,232,224,0,8,1
"1266",21-11-13,"53 - 1103",59,77,54,5,18,0.915254237288136
"1267",21-11-13,"2 - 1066",34,73,34,0,39,1
"1268",21-11-13,"82 - 1163",33,30,1,32,-3,0.0303030303030303
"1269",21-11-14,"40 - 1114",226,232,225,1,6,0.995575221238938
"1270",21-11-14,"53 - 1103",57,77,54,3,20,0.947368421052632
"1271",21-11-14,"2 - 1066",34,73,34,0,39,1
"1272",21-11-14,"82 - 1163",63,60,2,61,-3,0.0317460317460317
"1273",21-11-15,"40 - 1114",226,232,224,2,6,0.991150442477876
"1274",21-11-15,"53 - 1103",77,77,56,21,0,0.727272727272727
"1275",21-11-15,"2 - 1066",35,73,35,0,38,1
"1276",21-11-15,"82 - 1163",63,60,3,60,-3,0.0476190476190476
"1277",21-11-16,"40 - 1114",224,232,224,0,8,1
"1278",21-11-16,"53 - 1103",89,91,69,20,2,0.775280898876405
"1279",21-11-16,"2 - 1066",34,73,34,0,39,1
"1280",21-11-16,"82 - 1163",63,60,6,57,-3,0.0952380952380952
"1281",21-11-17,"40 - 1114",224,232,224,0,8,1
"1282",21-11-17,"53 - 1103",89,91,76,13,2,0.853932584269663
"1283",21-11-17,"2 - 1066",35,73,35,0,38,1
"1284",21-11-17,"82 - 1163",63,60,14,49,-3,0.222222222222222
"1285",21-11-18,"40 - 1114",223,232,223,0,9,1
"1286",21-11-18,"53 - 1103",86,91,75,11,5,0.872093023255814
"1287",21-11-18,"2 - 1066",36,73,36,0,37,1
"1288",21-11-18,"82 - 1163",63,60,14,49,-3,0.222222222222222
"1289",21-11-19,"40 - 1114",225,232,225,0,7,1
"1290",21-11-19,"53 - 1103",88,91,81,7,3,0.920454545454545
"1291",21-11-19,"2 - 1066",41,73,36,5,32,0.878048780487805
"1292",21-11-19,"82 - 1163",63,60,12,51,-3,0.19047619047619
"1293",21-11-20,"40 - 1114",227,232,226,1,5,0.995594713656388
"1294",21-11-20,"53 - 1103",88,91,81,7,3,0.920454545454545
"1295",21-11-20,"2 - 1066",42,73,37,5,31,0.880952380952381
"1296",21-11-20,"82 - 1163",63,60,11,52,-3,0.174603174603175
"1297",21-11-21,"40 - 1114",227,232,226,1,5,0.995594713656388
"1298",21-11-21,"53 - 1103",88,91,80,8,3,0.909090909090909
"1299",21-11-21,"2 - 1066",41,73,36,5,32,0.878048780487805
"1300",21-11-21,"82 - 1163",63,60,9,54,-3,0.142857142857143
"1301",21-11-22,"40 - 1114",227,232,227,0,5,1
"1302",21-11-22,"53 - 1103",87,91,81,6,4,0.931034482758621
"1303",21-11-22,"2 - 1066",41,73,36,5,32,0.878048780487805
"1304",21-11-22,"82 - 1163",63,60,12,51,-3,0.19047619047619
"1305",21-11-23,"40 - 1114",227,232,227,0,5,1
"1306",21-11-23,"53 - 1103",90,91,85,5,1,0.944444444444444
"1307",21-11-23,"2 - 1066",41,73,36,5,32,0.878048780487805
"1308",21-11-23,"82 - 1163",64,60,12,52,-4,0.1875
"1309",21-11-24,"40 - 1114",227,232,227,0,5,1
"1310",21-11-24,"53 - 1103",89,91,86,3,2,0.966292134831461
"1311",21-11-24,"2 - 1066",41,73,36,5,32,0.878048780487805
"1312",21-11-24,"82 - 1163",64,60,15,49,-4,0.234375
"1313",21-11-25,"40 - 1114",227,232,227,0,5,1
"1314",21-11-25,"53 - 1103",88,91,87,1,3,0.988636363636364
"1315",21-11-25,"2 - 1066",42,73,38,4,31,0.904761904761905
"1316",21-11-25,"82 - 1163",64,60,15,49,-4,0.234375
"1317",21-11-26,"40 - 1114",227,232,227,0,5,1
"1318",21-11-26,"53 - 1103",88,91,86,2,3,0.977272727272727
"1319",21-11-26,"2 - 1066",43,73,38,5,30,0.883720930232558
"1320",21-11-26,"82 - 1163",64,60,15,49,-4,0.234375
"1321",21-11-27,"40 - 1114",227,232,227,0,5,1
"1322",21-11-27,"53 - 1103",85,91,84,1,6,0.988235294117647
"1323",21-11-27,"2 - 1066",44,73,39,5,29,0.886363636363636
"1324",21-11-27,"82 - 1163",65,60,16,49,-5,0.246153846153846
"1325",21-11-28,"40 - 1114",227,232,227,0,5,1
"1326",21-11-28,"53 - 1103",85,91,84,1,6,0.988235294117647
"1327",21-11-28,"2 - 1066",44,73,39,5,29,0.886363636363636
"1328",21-11-28,"82 - 1163",65,60,14,51,-5,0.215384615384615
"1329",21-11-29,"40 - 1114",227,232,227,0,5,1
"1330",21-11-29,"53 - 1103",84,91,81,3,7,0.964285714285714
"1331",21-11-29,"2 - 1066",44,73,39,5,29,0.886363636363636
"1332",21-11-29,"82 - 1163",65,60,15,50,-5,0.230769230769231
"1333",21-11-30,"40 - 1114",228,232,228,0,4,1
"1334",21-11-30,"53 - 1103",84,91,83,1,7,0.988095238095238
"1335",21-11-30,"2 - 1066",44,73,39,5,29,0.886363636363636
"1336",21-11-30,"82 - 1163",65,60,10,55,-5,0.153846153846154
"1337",21-12-01,"40 - 1114",229,232,228,1,3,0.995633187772926
"1338",21-12-01,"53 - 1103",86,91,82,4,5,0.953488372093023
"1339",21-12-01,"2 - 1066",45,73,39,6,28,0.866666666666667
"1340",21-12-01,"82 - 1163",65,60,14,51,-5,0.215384615384615
"1341",21-12-02,"40 - 1114",226,232,226,0,6,1
"1342",21-12-02,"53 - 1103",81,91,81,0,10,1
"1343",21-12-02,"2 - 1066",45,73,38,7,28,0.844444444444444
"1344",21-12-02,"82 - 1163",65,60,14,51,-5,0.215384615384615
"1345",21-12-03,"40 - 1114",225,233,225,0,8,1
"1346",21-12-03,"53 - 1103",80,91,79,1,11,0.9875
"1347",21-12-03,"2 - 1066",44,73,38,6,29,0.863636363636364
"1348",21-12-03,"82 - 1163",65,60,12,53,-5,0.184615384615385
"1349",21-12-04,"40 - 1114",225,233,224,1,8,0.995555555555556
"1350",21-12-04,"53 - 1103",82,91,80,2,9,0.975609756097561
"1351",21-12-04,"2 - 1066",44,73,38,6,29,0.863636363636364
"1352",21-12-04,"82 - 1163",65,60,13,52,-5,0.2
"1353",21-12-05,"40 - 1114",225,233,223,2,8,0.991111111111111
"1354",21-12-05,"53 - 1103",83,91,82,1,8,0.987951807228916
"1355",21-12-05,"2 - 1066",45,73,39,6,28,0.866666666666667
"1356",21-12-05,"82 - 1163",65,60,13,52,-5,0.2
"1357",21-12-06,"40 - 1114",223,233,223,0,10,1
"1358",21-12-06,"53 - 1103",82,91,81,1,9,0.98780487804878
"1359",21-12-06,"2 - 1066",45,73,39,6,28,0.866666666666667
"1360",21-12-06,"82 - 1163",65,60,14,51,-5,0.215384615384615
"1361",21-12-07,"40 - 1114",222,233,222,0,11,1
"1362",21-12-07,"53 - 1103",85,91,83,2,6,0.976470588235294
"1363",21-12-07,"2 - 1066",45,73,41,4,28,0.911111111111111
"1364",21-12-07,"82 - 1163",65,60,16,49,-5,0.246153846153846
"1365",21-12-08,"40 - 1114",224,233,223,1,9,0.995535714285714
"1366",21-12-08,"53 - 1103",86,91,85,1,5,0.988372093023256
"1367",21-12-08,"2 - 1066",45,73,43,2,28,0.955555555555556
"1368",21-12-08,"82 - 1163",65,60,14,51,-5,0.215384615384615
"1369",21-12-09,"40 - 1114",228,233,226,2,5,0.991228070175439
"1370",21-12-09,"53 - 1103",85,91,85,0,6,1
"1371",21-12-09,"2 - 1066",45,73,43,2,28,0.955555555555556
"1372",21-12-09,"82 - 1163",65,60,17,48,-5,0.261538461538462
"1373",21-12-10,"40 - 1114",226,233,226,0,7,1
"1374",21-12-10,"53 - 1103",84,91,84,0,7,1
"1375",21-12-10,"2 - 1066",45,73,43,2,28,0.955555555555556
"1376",21-12-10,"82 - 1163",65,60,21,44,-5,0.323076923076923
"1377",21-12-11,"40 - 1114",226,233,225,1,7,0.995575221238938
"1378",21-12-11,"53 - 1103",84,91,84,0,7,1
"1379",21-12-11,"2 - 1066",45,73,43,2,28,0.955555555555556
"1380",21-12-11,"82 - 1163",65,60,18,47,-5,0.276923076923077
"1381",21-12-12,"40 - 1114",226,233,225,1,7,0.995575221238938
"1382",21-12-12,"53 - 1103",84,91,84,0,7,1
"1383",21-12-12,"2 - 1066",45,73,44,1,28,0.977777777777778
"1384",21-12-12,"82 - 1163",65,60,12,53,-5,0.184615384615385
"1385",21-12-13,"40 - 1114",225,233,225,0,8,1
"1386",21-12-13,"53 - 1103",84,91,84,0,7,1
"1387",21-12-13,"2 - 1066",45,73,44,1,28,0.977777777777778
"1388",21-12-13,"82 - 1163",65,60,15,50,-5,0.230769230769231
"1389",21-12-14,"40 - 1114",226,233,226,0,7,1
"1390",21-12-14,"53 - 1103",88,91,88,0,3,1
"1391",21-12-14,"2 - 1066",45,73,44,1,28,0.977777777777778
"1392",21-12-14,"82 - 1163",65,60,16,49,-5,0.246153846153846
"1393",21-12-15,"40 - 1114",225,233,225,0,8,1
"1394",21-12-15,"53 - 1103",88,91,87,1,3,0.988636363636364
"1395",21-12-15,"2 - 1066",45,73,43,2,28,0.955555555555556
"1396",21-12-15,"82 - 1163",65,60,12,53,-5,0.184615384615385
"1397",21-12-16,"40 - 1114",224,233,224,0,9,1
"1398",21-12-16,"53 - 1103",89,91,87,2,2,0.97752808988764
"1399",21-12-16,"2 - 1066",44,73,42,2,29,0.954545454545455
"1400",21-12-16,"82 - 1163",65,60,13,52,-5,0.2
"1401",21-12-17,"40 - 1114",225,233,225,0,8,1
"1402",21-12-17,"53 - 1103",87,91,87,0,4,1
"1403",21-12-17,"2 - 1066",45,73,43,2,28,0.955555555555556
"1404",21-12-17,"82 - 1163",65,60,22,43,-5,0.338461538461538
"1405",21-12-18,"40 - 1114",225,233,223,2,8,0.991111111111111
"1406",21-12-18,"53 - 1103",87,91,87,0,4,1
"1407",21-12-18,"2 - 1066",45,73,44,1,28,0.977777777777778
"1408",21-12-18,"82 - 1163",65,60,17,48,-5,0.261538461538462
"1409",21-12-19,"40 - 1114",225,233,225,0,8,1
"1410",21-12-19,"53 - 1103",87,91,87,0,4,1
"1411",21-12-19,"2 - 1066",45,73,44,1,28,0.977777777777778
"1412",21-12-19,"82 - 1163",65,60,14,51,-5,0.215384615384615
"1413",21-12-20,"40 - 1114",226,233,226,0,7,1
"1414",21-12-20,"53 - 1103",87,91,85,2,4,0.977011494252874
"1415",21-12-20,"2 - 1066",45,73,45,0,28,1
"1416",21-12-20,"82 - 1163",65,60,19,46,-5,0.292307692307692
"1417",21-12-21,"40 - 1114",226,233,226,0,7,1
"1418",21-12-21,"53 - 1103",86,91,85,1,5,0.988372093023256
"1419",21-12-21,"2 - 1066",44,73,44,0,29,1
"1420",21-12-21,"82 - 1163",65,60,27,38,-5,0.415384615384615
"1421",21-12-22,"40 - 1114",225,233,225,0,8,1
"1422",21-12-22,"53 - 1103",85,91,84,1,6,0.988235294117647
"1423",21-12-22,"2 - 1066",44,73,44,0,29,1
"1424",21-12-22,"82 - 1163",67,60,37,30,-7,0.552238805970149
"1425",21-12-23,"40 - 1114",227,233,224,3,6,0.986784140969163
"1426",21-12-23,"53 - 1103",86,91,86,0,5,1
"1427",21-12-23,"2 - 1066",44,73,44,0,29,1
"1428",21-12-23,"82 - 1163",70,60,44,26,-10,0.628571428571429
"1429",21-12-24,"40 - 1114",226,233,226,0,7,1
"1430",21-12-24,"53 - 1103",86,91,86,0,5,1
"1431",21-12-24,"2 - 1066",44,73,44,0,29,1
"1432",21-12-24,"82 - 1163",70,60,37,33,-10,0.528571428571429
"1433",21-12-25,"40 - 1114",227,233,227,0,6,1
"1434",21-12-25,"53 - 1103",87,91,87,0,4,1
"1435",21-12-25,"2 - 1066",45,73,45,0,28,1
"1436",21-12-25,"82 - 1163",70,60,40,30,-10,0.571428571428571
"1437",21-12-26,"40 - 1114",227,233,227,0,6,1
"1438",21-12-26,"53 - 1103",85,91,85,0,6,1
"1439",21-12-26,"2 - 1066",45,73,45,0,28,1
"1440",21-12-26,"82 - 1163",70,60,41,29,-10,0.585714285714286
"1441",21-12-27,"40 - 1114",227,233,227,0,6,1
"1442",21-12-27,"53 - 1103",85,91,85,0,6,1
"1443",21-12-27,"2 - 1066",45,73,45,0,28,1
"1444",21-12-27,"82 - 1163",70,60,48,22,-10,0.685714285714286
"1445",21-12-28,"40 - 1114",228,233,228,0,5,1
"1446",21-12-28,"53 - 1103",87,91,87,0,4,1
"1447",21-12-28,"2 - 1066",45,73,45,0,28,1
"1448",21-12-28,"82 - 1163",70,60,49,21,-10,0.7
"1449",21-12-29,"40 - 1114",228,233,228,0,5,1
"1450",21-12-29,"53 - 1103",88,91,87,1,3,0.988636363636364
"1451",21-12-29,"2 - 1066",45,73,45,0,28,1
"1452",21-12-29,"82 - 1163",74,60,55,19,-14,0.743243243243243
"1453",21-12-30,"40 - 1114",228,233,227,1,5,0.995614035087719
"1454",21-12-30,"53 - 1103",89,91,88,1,2,0.98876404494382
"1455",21-12-30,"2 - 1066",45,73,45,0,28,1
"1456",21-12-30,"82 - 1163",76,60,62,14,-16,0.815789473684211
"1457",21-12-31,"40 - 1114",228,233,227,1,5,0.995614035087719
"1458",21-12-31,"53 - 1103",89,91,88,1,2,0.98876404494382
"1459",21-12-31,"2 - 1066",46,73,45,1,27,0.978260869565217
"1460",21-12-31,"82 - 1163",78,60,59,19,-18,0.756410256410256
"1461",22-01-01,"40 - 1114",226,233,226,0,7,1
"1462",22-01-01,"53 - 1103",89,91,88,1,2,0.98876404494382
"1463",22-01-01,"2 - 1066",46,73,46,0,27,1
"1464",22-01-01,"82 - 1163",150,142,115,35,-8,0.766666666666667
"1465",22-01-02,"40 - 1114",226,233,226,0,7,1
"1466",22-01-02,"53 - 1103",88,91,87,1,3,0.988636363636364
"1467",22-01-02,"2 - 1066",45,73,45,0,28,1
"1468",22-01-02,"82 - 1163",150,142,112,38,-8,0.746666666666667
"1469",22-01-03,"40 - 1114",226,233,224,2,7,0.991150442477876
"1470",22-01-03,"53 - 1103",88,91,86,2,3,0.977272727272727
"1471",22-01-03,"2 - 1066",45,73,45,0,28,1
"1472",22-01-03,"82 - 1163",151,142,118,33,-9,0.781456953642384
"1473",22-01-04,"40 - 1114",224,233,223,1,9,0.995535714285714
"1474",22-01-04,"53 - 1103",87,91,87,0,4,1
"1475",22-01-04,"2 - 1066",44,73,44,0,29,1
"1476",22-01-04,"82 - 1163",152,142,117,35,-10,0.769736842105263
"1477",22-01-05,"40 - 1114",215,233,215,0,18,1
"1478",22-01-05,"53 - 1103",88,91,88,0,3,1
"1479",22-01-05,"2 - 1066",45,73,45,0,28,1
"1480",22-01-05,"82 - 1163",152,142,119,33,-10,0.782894736842105
"1481",22-01-06,"40 - 1114",215,233,214,1,18,0.995348837209302
"1482",22-01-06,"53 - 1103",88,91,88,0,3,1
"1483",22-01-06,"2 - 1066",45,73,45,0,28,1
"1484",22-01-06,"82 - 1163",153,142,118,35,-11,0.77124183006536
"1485",22-01-07,"40 - 1114",213,233,213,0,20,1
"1486",22-01-07,"53 - 1103",88,91,88,0,3,1
"1487",22-01-07,"2 - 1066",45,73,45,0,28,1
"1488",22-01-07,"82 - 1163",132,142,113,19,10,0.856060606060606
"1489",22-01-08,"40 - 1114",213,233,212,1,20,0.995305164319249
"1490",22-01-08,"53 - 1103",88,91,88,0,3,1
"1491",22-01-08,"2 - 1066",45,73,45,0,28,1
"1492",22-01-08,"82 - 1163",134,142,110,24,8,0.82089552238806
"1493",22-01-09,"40 - 1114",213,233,212,1,20,0.995305164319249
"1494",22-01-09,"53 - 1103",88,91,88,0,3,1
"1495",22-01-09,"2 - 1066",45,73,45,0,28,1
"1496",22-01-09,"82 - 1163",147,142,107,40,-5,0.727891156462585
"1497",22-01-10,"40 - 1114",212,233,212,0,21,1
"1498",22-01-10,"53 - 1103",88,91,88,0,3,1
"1499",22-01-10,"2 - 1066",45,73,45,0,28,1
"1500",22-01-10,"82 - 1163",139,112,104,35,-27,0.748201438848921
"1501",22-01-11,"40 - 1114",215,233,215,0,18,1
"1502",22-01-11,"53 - 1103",89,91,89,0,2,1
"1503",22-01-11,"2 - 1066",45,73,45,0,28,1
"1504",22-01-11,"82 - 1163",139,112,102,37,-27,0.733812949640288
"1505",22-01-12,"40 - 1114",218,233,217,1,15,0.995412844036697
"1506",22-01-12,"53 - 1103",89,91,89,0,2,1
"1507",22-01-12,"2 - 1066",45,50,45,0,5,1
"1508",22-01-12,"82 - 1163",139,112,104,35,-27,0.748201438848921
"1509",22-01-13,"40 - 1114",221,233,221,0,12,1
"1510",22-01-13,"53 - 1103",89,91,89,0,2,1
"1511",22-01-13,"2 - 1066",45,50,45,0,5,1
"1512",22-01-13,"82 - 1163",136,112,109,27,-24,0.801470588235294
"1513",22-01-14,"40 - 1114",221,233,221,0,12,1
"1514",22-01-14,"53 - 1103",89,91,89,0,2,1
"1515",22-01-14,"2 - 1066",45,50,45,0,5,1
"1516",22-01-14,"82 - 1163",143,142,110,33,-1,0.769230769230769
"1517",22-01-15,"40 - 1114",221,233,220,1,12,0.995475113122172
"1518",22-01-15,"53 - 1103",89,91,89,0,2,1
"1519",22-01-15,"2 - 1066",45,50,45,0,5,1
"1520",22-01-15,"82 - 1163",138,112,107,31,-26,0.77536231884058
"1521",22-01-16,"40 - 1114",220,233,220,0,13,1
"1522",22-01-16,"53 - 1103",184,186,153,31,2,0.831521739130435
"1523",22-01-16,"2 - 1066",45,50,45,0,5,1
"1524",22-01-16,"82 - 1163",138,112,109,29,-26,0.789855072463768
"1525",22-01-17,"40 - 1114",219,233,219,0,14,1
"1526",22-01-17,"53 - 1103",162,186,162,0,24,1
"1527",22-01-17,"2 - 1066",45,58,45,0,13,1
"1528",22-01-17,"82 - 1163",140,112,111,29,-28,0.792857142857143
"1529",22-01-18,"40 - 1114",219,233,219,0,14,1
"1530",22-01-18,"53 - 1103",169,186,162,7,17,0.958579881656805
"1531",22-01-18,"2 - 1066",45,58,45,0,13,1
"1532",22-01-18,"82 - 1163",140,112,107,33,-28,0.764285714285714
"1533",22-01-19,"40 - 1114",220,233,220,0,13,1
"1534",22-01-19,"53 - 1103",169,186,166,3,17,0.982248520710059
"1535",22-01-19,"2 - 1066",45,58,45,0,13,1
"1536",22-01-19,"82 - 1163",141,112,104,37,-29,0.737588652482269
"1537",22-01-20,"40 - 1114",223,233,223,0,10,1
"1538",22-01-20,"53 - 1103",168,186,166,2,18,0.988095238095238
"1539",22-01-20,"2 - 1066",45,45,45,0,0,1
"1540",22-01-20,"82 - 1163",141,112,95,46,-29,0.673758865248227
"1541",22-01-21,"40 - 1114",225,233,225,0,8,1
"1542",22-01-21,"53 - 1103",171,186,166,5,15,0.970760233918129
"1543",22-01-21,"2 - 1066",45,58,45,0,13,1
"1544",22-01-21,"82 - 1163",149,142,86,63,-7,0.577181208053691
"1545",22-01-22,"40 - 1114",225,233,225,0,8,1
"1546",22-01-22,"53 - 1103",171,186,165,6,15,0.964912280701754
"1547",22-01-22,"2 - 1066",45,58,45,0,13,1
"1548",22-01-22,"82 - 1163",141,112,81,60,-29,0.574468085106383
"1549",22-01-23,"40 - 1114",226,233,225,1,7,0.995575221238938
"1550",22-01-23,"53 - 1103",173,186,164,9,13,0.947976878612717
"1551",22-01-23,"2 - 1066",45,58,45,0,13,1
"1552",22-01-23,"82 - 1163",141,112,76,65,-29,0.539007092198582
"1553",22-01-24,"40 - 1114",225,233,225,0,8,1
"1554",22-01-24,"53 - 1103",175,186,167,8,11,0.954285714285714
"1555",22-01-24,"2 - 1066",45,58,45,0,13,1
"1556",22-01-24,"82 - 1163",141,112,69,72,-29,0.48936170212766
"1557",22-01-25,"40 - 1114",226,233,226,0,7,1
"1558",22-01-25,"53 - 1103",175,186,170,5,11,0.971428571428571
"1559",22-01-25,"2 - 1066",45,58,45,0,13,1
"1560",22-01-25,"82 - 1163",56,112,56,0,56,1
"1561",22-01-26,"40 - 1114",229,233,229,0,4,1
"1562",22-01-26,"53 - 1103",171,186,167,4,15,0.976608187134503
"1563",22-01-26,"2 - 1066",44,58,44,0,14,1
"1564",22-01-26,"82 - 1163",57,112,52,5,55,0.912280701754386
"1565",22-01-27,"40 - 1114",227,233,227,0,6,1
"1566",22-01-27,"53 - 1103",175,186,169,6,11,0.965714285714286
"1567",22-01-27,"2 - 1066",44,58,44,0,14,1
"1568",22-01-27,"82 - 1163",51,30,33,18,-21,0.647058823529412
"1569",22-01-28,"40 - 1114",225,233,225,0,8,1
"1570",22-01-28,"53 - 1103",179,186,171,8,7,0.955307262569832
"1571",22-01-28,"2 - 1066",46,58,46,0,12,1
"1572",22-01-28,"82 - 1163",54,30,26,28,-24,0.481481481481481
"1573",22-01-29,"40 - 1114",225,233,225,0,8,1
"1574",22-01-29,"53 - 1103",181,186,178,3,5,0.983425414364641
"1575",22-01-29,"2 - 1066",46,58,46,0,12,1
"1576",22-01-29,"82 - 1163",55,30,29,26,-25,0.527272727272727
"1577",22-01-30,"40 - 1114",223,233,223,0,10,1
"1578",22-01-30,"53 - 1103",181,186,180,1,5,0.994475138121547
"1579",22-01-30,"2 - 1066",46,58,46,0,12,1
"1580",22-01-30,"82 - 1163",54,30,28,26,-24,0.518518518518518
"1581",22-01-31,"40 - 1114",223,233,223,0,10,1
"1582",22-01-31,"53 - 1103",178,186,178,0,8,1
"1583",22-01-31,"2 - 1066",46,58,46,0,12,1
"1584",22-01-31,"82 - 1163",68,30,27,41,-38,0.397058823529412
"1585",22-02-01,"40 - 1114",222,233,222,0,11,1
"1586",22-02-01,"53 - 1103",179,186,179,0,7,1
"1587",22-02-01,"2 - 1066",44,58,44,0,14,1
"1588",22-02-01,"82 - 1163",68,30,28,40,-38,0.411764705882353
"1589",22-02-02,"40 - 1114",222,233,222,0,11,1
"1590",22-02-02,"53 - 1103",181,186,178,3,5,0.983425414364641
"1591",22-02-02,"2 - 1066",42,58,42,0,16,1
"1592",22-02-02,"82 - 1163",68,30,27,41,-38,0.397058823529412
"1593",22-02-03,"40 - 1114",224,233,224,0,9,1
"1594",22-02-03,"53 - 1103",181,186,181,0,5,1
"1595",22-02-03,"2 - 1066",42,58,42,0,16,1
"1596",22-02-03,"82 - 1163",79,60,28,51,-19,0.354430379746835
"1597",22-02-04,"40 - 1114",225,233,224,1,8,0.995555555555556
"1598",22-02-04,"53 - 1103",181,186,181,0,5,1
"1599",22-02-04,"2 - 1066",42,58,42,0,16,1
"1600",22-02-04,"82 - 1163",79,60,29,50,-19,0.367088607594937
"1601",22-02-05,"40 - 1114",225,233,225,0,8,1
"1602",22-02-05,"53 - 1103",177,186,175,2,9,0.988700564971751
"1603",22-02-05,"2 - 1066",43,58,43,0,15,1
"1604",22-02-05,"82 - 1163",79,60,29,50,-19,0.367088607594937
"1605",22-02-06,"40 - 1114",224,233,224,0,9,1
"1606",22-02-06,"53 - 1103",177,186,177,0,9,1
"1607",22-02-06,"2 - 1066",42,58,42,0,16,1
"1608",22-02-06,"82 - 1163",79,60,27,52,-19,0.341772151898734
"1609",22-02-07,"40 - 1114",224,233,224,0,9,1
"1610",22-02-07,"53 - 1103",181,186,177,4,5,0.977900552486188
"1611",22-02-07,"2 - 1066",41,58,41,0,17,1
"1612",22-02-07,"82 - 1163",68,30,21,47,-38,0.308823529411765
"1613",22-02-08,"40 - 1114",224,233,224,0,9,1
"1614",22-02-08,"53 - 1103",182,186,174,8,4,0.956043956043956
"1615",22-02-08,"2 - 1066",41,58,41,0,17,1
"1616",22-02-08,"82 - 1163",85,60,26,59,-25,0.305882352941176
"1617",22-02-09,"40 - 1114",224,233,224,0,9,1
"1618",22-02-09,"53 - 1103",181,186,175,6,5,0.966850828729282
"1619",22-02-09,"2 - 1066",41,58,41,0,17,1
"1620",22-02-09,"82 - 1163",85,60,28,57,-25,0.329411764705882
"1621",22-02-10,"40 - 1114",222,233,222,0,11,1
"1622",22-02-10,"53 - 1103",182,186,176,6,4,0.967032967032967
"1623",22-02-10,"2 - 1066",41,58,41,0,17,1
"1624",22-02-10,"82 - 1163",85,60,28,57,-25,0.329411764705882
"1625",22-02-11,"40 - 1114",224,233,224,0,9,1
"1626",22-02-11,"53 - 1103",181,186,177,4,5,0.977900552486188
"1627",22-02-11,"2 - 1066",41,58,41,0,17,1
"1628",22-02-11,"82 - 1163",85,60,26,59,-25,0.305882352941176
"1629",22-02-12,"40 - 1114",224,233,224,0,9,1
"1630",22-02-12,"53 - 1103",180,186,176,4,6,0.977777777777778
"1631",22-02-12,"2 - 1066",41,58,41,0,17,1
"1632",22-02-12,"82 - 1163",80,60,29,51,-20,0.3625
"1633",22-02-13,"40 - 1114",224,233,224,0,9,1
"1634",22-02-13,"53 - 1103",179,186,176,3,7,0.983240223463687
"1635",22-02-13,"2 - 1066",41,58,41,0,17,1
"1636",22-02-13,"82 - 1163",80,60,26,54,-20,0.325
"1637",22-02-14,"40 - 1114",223,233,223,0,10,1
"1638",22-02-14,"53 - 1103",179,186,176,3,7,0.983240223463687
"1639",22-02-14,"2 - 1066",39,58,39,0,19,1
"1640",22-02-14,"82 - 1163",80,60,23,57,-20,0.2875
"1641",22-02-15,"40 - 1114",222,233,222,0,11,1
"1642",22-02-15,"53 - 1103",177,186,175,2,9,0.988700564971751
"1643",22-02-15,"2 - 1066",39,58,39,0,19,1
"1644",22-02-15,"82 - 1163",80,60,22,58,-20,0.275
"1645",22-02-16,"40 - 1114",219,233,219,0,14,1
"1646",22-02-16,"53 - 1103",177,186,176,1,9,0.994350282485876
"1647",22-02-16,"2 - 1066",39,58,39,0,19,1
"1648",22-02-16,"82 - 1163",81,60,22,59,-21,0.271604938271605
"1649",22-02-17,"40 - 1114",221,233,221,0,12,1
"1650",22-02-17,"53 - 1103",176,186,176,0,10,1
"1651",22-02-17,"2 - 1066",39,58,39,0,19,1
"1652",22-02-17,"82 - 1163",79,60,22,57,-19,0.278481012658228
"1653",22-02-18,"40 - 1114",223,233,221,2,10,0.991031390134529
"1654",22-02-18,"53 - 1103",179,186,177,2,7,0.988826815642458
"1655",22-02-18,"2 - 1066",39,58,39,0,19,1
"1656",22-02-18,"82 - 1163",79,60,19,60,-19,0.240506329113924
"1657",22-02-19,"40 - 1114",223,233,222,1,10,0.995515695067265
"1658",22-02-19,"53 - 1103",178,186,176,2,8,0.98876404494382
"1659",22-02-19,"2 - 1066",40,58,40,0,18,1
"1660",22-02-19,"82 - 1163",79,60,19,60,-19,0.240506329113924
"1661",22-02-20,"40 - 1114",221,233,221,0,12,1
"1662",22-02-20,"53 - 1103",177,186,176,1,9,0.994350282485876
"1663",22-02-20,"2 - 1066",41,58,41,0,17,1
"1664",22-02-20,"82 - 1163",79,60,19,60,-19,0.240506329113924
"1665",22-02-21,"40 - 1114",221,233,221,0,12,1
"1666",22-02-21,"53 - 1103",177,186,176,1,9,0.994350282485876
"1667",22-02-21,"2 - 1066",41,58,41,0,17,1
"1668",22-02-21,"82 - 1163",79,60,17,62,-19,0.215189873417722
"1669",22-02-22,"40 - 1114",221,233,221,0,12,1
"1670",22-02-22,"53 - 1103",181,186,177,4,5,0.977900552486188
"1671",22-02-22,"2 - 1066",41,58,41,0,17,1
"1672",22-02-22,"82 - 1163",79,60,13,66,-19,0.164556962025316
"1673",22-02-23,"40 - 1114",224,233,224,0,9,1
"1674",22-02-23,"53 - 1103",179,186,176,3,7,0.983240223463687
"1675",22-02-23,"2 - 1066",41,58,41,0,17,1
"1676",22-02-23,"82 - 1163",78,60,13,65,-18,0.166666666666667
"1677",22-02-24,"40 - 1114",224,233,224,0,9,1
"1678",22-02-24,"53 - 1103",183,186,180,3,3,0.983606557377049
"1679",22-02-24,"2 - 1066",42,58,42,0,16,1
"1680",22-02-24,"82 - 1163",65,30,8,57,-35,0.123076923076923
"1681",22-02-25,"40 - 1114",226,233,226,0,7,1
"1682",22-02-25,"53 - 1103",182,186,177,5,4,0.972527472527473
"1683",22-02-25,"2 - 1066",42,58,42,0,16,1
"1684",22-02-25,"82 - 1163",78,60,9,69,-18,0.115384615384615
"1685",22-02-26,"40 - 1114",226,233,226,0,7,1
"1686",22-02-26,"53 - 1103",181,186,176,5,5,0.972375690607735
"1687",22-02-26,"2 - 1066",41,58,41,0,17,1
"1688",22-02-26,"82 - 1163",78,60,8,70,-18,0.102564102564103
"1689",22-02-27,"40 - 1114",226,233,226,0,7,1
"1690",22-02-27,"53 - 1103",181,186,174,7,5,0.961325966850829
"1691",22-02-27,"2 - 1066",42,58,42,0,16,1
"1692",22-02-27,"82 - 1163",78,60,8,70,-18,0.102564102564103
"1693",22-02-28,"40 - 1114",226,233,226,0,7,1
"1694",22-02-28,"53 - 1103",181,186,173,8,5,0.955801104972376
"1695",22-02-28,"2 - 1066",42,58,42,0,16,1
"1696",22-02-28,"82 - 1163",78,60,8,70,-18,0.102564102564103
"1697",22-03-01,"40 - 1114",226,233,224,2,7,0.991150442477876
"1698",22-03-01,"53 - 1103",180,186,176,4,6,0.977777777777778
"1699",22-03-01,"2 - 1066",43,58,43,0,15,1
"1700",22-03-01,"82 - 1163",65,30,8,57,-35,0.123076923076923
"1701",22-03-02,"40 - 1114",222,233,222,0,11,1
"1702",22-03-02,"53 - 1103",180,186,178,2,6,0.988888888888889
"1703",22-03-02,"2 - 1066",43,58,43,0,15,1
"1704",22-03-02,"82 - 1163",65,30,7,58,-35,0.107692307692308
"1705",22-03-03,"40 - 1114",223,233,222,1,10,0.995515695067265
"1706",22-03-03,"53 - 1103",182,186,177,5,4,0.972527472527473
"1707",22-03-03,"2 - 1066",43,58,43,0,15,1
"1708",22-03-03,"82 - 1163",65,30,7,58,-35,0.107692307692308
"1709",22-03-04,"40 - 1114",224,233,223,1,9,0.995535714285714
"1710",22-03-04,"53 - 1103",182,186,178,4,4,0.978021978021978
"1711",22-03-04,"2 - 1066",42,58,42,0,16,1
"1712",22-03-04,"82 - 1163",78,60,7,71,-18,0.0897435897435897
"1713",22-03-05,"40 - 1114",224,233,223,1,9,0.995535714285714
"1714",22-03-05,"53 - 1103",181,186,176,5,5,0.972375690607735
"1715",22-03-05,"2 - 1066",43,58,43,0,15,1
"1716",22-03-05,"82 - 1163",62,30,7,55,-32,0.112903225806452
"1717",22-03-06,"40 - 1114",224,233,222,2,9,0.991071428571429
"1718",22-03-06,"53 - 1103",179,186,175,4,7,0.977653631284916
"1719",22-03-06,"2 - 1066",43,58,43,0,15,1
"1720",22-03-06,"82 - 1163",62,30,6,56,-32,0.0967741935483871
"1721",22-03-07,"40 - 1320",2,80,2,0,78,1
"1722",22-03-07,"40 - 1114",218,233,217,1,15,0.995412844036697
"1723",22-03-07,"53 - 1103",183,186,175,8,3,0.956284153005464
"1724",22-03-07,"2 - 1066",43,58,43,0,15,1
"1725",22-03-07,"82 - 1163",62,30,5,57,-32,0.0806451612903226
"1726",22-03-08,"40 - 1320",6,80,6,0,74,1
"1727",22-03-08,"40 - 1114",213,233,213,0,20,1
"1728",22-03-08,"53 - 1103",183,186,180,3,3,0.983606557377049
"1729",22-03-08,"2 - 1066",43,58,43,0,15,1
"1730",22-03-08,"82 - 1163",62,30,5,57,-32,0.0806451612903226
"1731",22-03-09,"40 - 1320",9,80,9,0,71,1
"1732",22-03-09,"40 - 1114",212,233,211,1,21,0.995283018867924
"1733",22-03-09,"53 - 1103",185,186,180,5,1,0.972972972972973
"1734",22-03-09,"2 - 1066",43,58,43,0,15,1
"1735",22-03-09,"82 - 1163",62,30,5,57,-32,0.0806451612903226
"1736",22-03-10,"40 - 1320",12,80,12,0,68,1
"1737",22-03-10,"40 - 1114",212,233,211,1,21,0.995283018867924
"1738",22-03-10,"53 - 1103",182,186,178,4,4,0.978021978021978
"1739",22-03-10,"2 - 1066",43,58,43,0,15,1
"1740",22-03-10,"82 - 1163",62,30,5,57,-32,0.0806451612903226
"1741",22-03-11,"40 - 1320",15,80,15,0,65,1
"1742",22-03-11,"40 - 1114",212,233,211,1,21,0.995283018867924
"1743",22-03-11,"53 - 1103",185,186,180,5,1,0.972972972972973
"1744",22-03-11,"2 - 1066",44,58,44,0,14,1
"1745",22-03-11,"82 - 1163",62,30,7,55,-32,0.112903225806452
"1746",22-03-12,"40 - 1320",15,80,14,1,65,0.933333333333333
"1747",22-03-12,"40 - 1114",212,233,212,0,21,1
"1748",22-03-12,"53 - 1103",184,186,177,7,2,0.96195652173913
"1749",22-03-12,"2 - 1066",43,58,43,0,15,1
"1750",22-03-12,"82 - 1163",62,30,9,53,-32,0.145161290322581
"1751",22-03-13,"40 - 1320",16,80,16,0,64,1
"1752",22-03-13,"40 - 1114",212,233,212,0,21,1
"1753",22-03-13,"53 - 1103",180,186,177,3,6,0.983333333333333
"1754",22-03-13,"2 - 1066",43,58,43,0,15,1
"1755",22-03-13,"82 - 1163",62,30,9,53,-32,0.145161290322581
"1756",22-03-14,"40 - 1320",21,105,21,0,84,1
"1757",22-03-14,"40 - 1114",214,233,212,2,19,0.990654205607477
"1758",22-03-14,"53 - 1103",182,186,179,3,4,0.983516483516483
"1759",22-03-14,"2 - 1066",43,58,43,0,15,1
"1760",22-03-14,"82 - 1163",74,60,10,64,-14,0.135135135135135
"1761",22-03-15,"40 - 1320",24,105,24,0,81,1
"1762",22-03-15,"40 - 1114",213,233,212,1,20,0.995305164319249
"1763",22-03-15,"53 - 1103",185,186,175,10,1,0.945945945945946
"1764",22-03-15,"2 - 1066",42,58,42,0,16,1
"1765",22-03-15,"82 - 1163",74,60,10,64,-14,0.135135135135135
"1766",22-03-16,"40 - 1320",29,105,28,1,76,0.96551724137931
"1767",22-03-16,"40 - 1114",214,233,214,0,19,1
"1768",22-03-16,"53 - 1103",185,186,174,11,1,0.940540540540541
"1769",22-03-16,"2 - 1066",43,58,43,0,15,1
"1770",22-03-16,"82 - 1163",74,60,13,61,-14,0.175675675675676
"1771",22-03-17,"40 - 1320",33,105,33,0,72,1
"1772",22-03-17,"40 - 1114",213,233,213,0,20,1
"1773",22-03-17,"53 - 1103",183,186,176,7,3,0.961748633879781
"1774",22-03-17,"2 - 1066",43,58,43,0,15,1
"1775",22-03-17,"82 - 1163",74,60,15,59,-14,0.202702702702703
"1776",22-03-18,"40 - 1320",38,105,37,1,67,0.973684210526316
"1777",22-03-18,"40 - 1114",213,233,213,0,20,1
"1778",22-03-18,"53 - 1103",183,186,176,7,3,0.961748633879781
"1779",22-03-18,"2 - 1066",45,58,45,0,13,1
"1780",22-03-18,"82 - 1163",74,60,16,58,-14,0.216216216216216
"1781",22-03-19,"40 - 1320",38,105,38,0,67,1
"1782",22-03-19,"40 - 1114",213,233,212,1,20,0.995305164319249
"1783",22-03-19,"53 - 1103",184,186,178,6,2,0.967391304347826
"1784",22-03-19,"2 - 1066",44,58,44,0,14,1
"1785",22-03-19,"82 - 1163",74,60,16,58,-14,0.216216216216216
"1786",22-03-20,"40 - 1320",40,105,38,2,65,0.95
"1787",22-03-20,"40 - 1114",215,233,214,1,18,0.995348837209302
"1788",22-03-20,"53 - 1103",182,186,176,6,4,0.967032967032967
"1789",22-03-20,"2 - 1066",44,58,44,0,14,1
"1790",22-03-20,"82 - 1163",74,60,16,58,-14,0.216216216216216
"1791",22-03-21,"40 - 1320",47,105,47,0,58,1
"1792",22-03-21,"40 - 1114",214,233,214,0,19,1
"1793",22-03-21,"53 - 1103",176,186,175,1,10,0.994318181818182
"1794",22-03-21,"2 - 1066",44,58,44,0,14,1
"1795",22-03-21,"82 - 1163",74,60,15,59,-14,0.202702702702703
"1796",22-03-22,"40 - 1320",49,105,49,0,56,1
"1797",22-03-22,"40 - 1114",215,233,215,0,18,1
"1798",22-03-22,"53 - 1103",177,186,177,0,9,1
"1799",22-03-22,"2 - 1066",44,58,44,0,14,1
"1800",22-03-22,"82 - 1163",74,60,14,60,-14,0.189189189189189
"1801",22-03-23,"40 - 1320",53,105,53,0,52,1
"1802",22-03-23,"40 - 1114",216,233,216,0,17,1
"1803",22-03-23,"53 - 1103",185,186,181,4,1,0.978378378378378
"1804",22-03-23,"2 - 1066",44,58,44,0,14,1
"1805",22-03-23,"82 - 1163",74,60,7,67,-14,0.0945945945945946
"1806",22-03-24,"40 - 1320",54,105,54,0,51,1
"1807",22-03-24,"40 - 1114",218,233,218,0,15,1
"1808",22-03-24,"53 - 1103",185,186,180,5,1,0.972972972972973
"1809",22-03-24,"2 - 1066",45,58,45,0,13,1
"1810",22-03-24,"82 - 1163",74,60,7,67,-14,0.0945945945945946
"1811",22-03-25,"40 - 1320",56,105,56,0,49,1
"1812",22-03-25,"40 - 1114",217,233,217,0,16,1
"1813",22-03-25,"53 - 1103",183,186,180,3,3,0.983606557377049
"1814",22-03-25,"2 - 1066",45,58,45,0,13,1
"1815",22-03-25,"82 - 1163",74,60,7,67,-14,0.0945945945945946
"1816",22-03-26,"40 - 1320",57,105,57,0,48,1
"1817",22-03-26,"40 - 1114",217,233,216,1,16,0.995391705069124
"1818",22-03-26,"53 - 1103",184,186,180,4,2,0.978260869565217
"1819",22-03-26,"2 - 1066",45,58,45,0,13,1
"1820",22-03-26,"82 - 1163",74,60,5,69,-14,0.0675675675675676
"1821",22-03-27,"40 - 1320",57,105,57,0,48,1
"1822",22-03-27,"40 - 1114",218,233,218,0,15,1
"1823",22-03-27,"53 - 1103",183,186,180,3,3,0.983606557377049
"1824",22-03-27,"2 - 1066",45,58,45,0,13,1
"1825",22-03-27,"82 - 1163",74,60,2,72,-14,0.027027027027027
"1826",22-03-28,"40 - 1320",60,105,60,0,45,1
"1827",22-03-28,"40 - 1114",218,233,218,0,15,1
"1828",22-03-28,"53 - 1103",179,186,179,0,7,1
"1829",22-03-28,"2 - 1066",45,58,45,0,13,1
"1830",22-03-28,"82 - 1163",74,60,5,69,-14,0.0675675675675676
"1831",22-03-29,"40 - 1320",67,105,66,1,38,0.985074626865672
"1832",22-03-29,"40 - 1114",217,233,217,0,16,1
"1833",22-03-29,"53 - 1103",183,186,182,1,3,0.994535519125683
"1834",22-03-29,"2 - 1066",45,58,45,0,13,1
"1835",22-03-29,"82 - 1163",62,30,4,58,-32,0.0645161290322581
"1836",22-03-30,"40 - 1320",69,105,69,0,36,1
"1837",22-03-30,"40 - 1114",217,233,217,0,16,1
"1838",22-03-30,"53 - 1103",183,186,181,2,3,0.989071038251366
"1839",22-03-30,"2 - 1066",45,58,45,0,13,1
"1840",22-03-30,"82 - 1163",62,30,4,58,-32,0.0645161290322581
"1841",22-03-31,"40 - 1320",74,105,74,0,31,1
"1842",22-03-31,"40 - 1114",217,233,217,0,16,1
"1843",22-03-31,"53 - 1103",183,186,180,3,3,0.983606557377049
"1844",22-03-31,"2 - 1066",45,58,45,0,13,1
"1845",22-03-31,"82 - 1163",62,30,4,58,-32,0.0645161290322581
"1846",22-04-01,"40 - 1320",78,105,78,0,27,1
"1847",22-04-01,"40 - 1114",216,233,216,0,17,1
"1848",22-04-01,"53 - 1103",182,186,180,2,4,0.989010989010989
"1849",22-04-01,"2 - 1066",41,58,41,0,17,1
"1850",22-04-01,"82 - 1163",76,30,5,71,-46,0.0657894736842105
"1851",22-04-02,"40 - 1320",80,105,80,0,25,1
"1852",22-04-02,"40 - 1114",216,233,216,0,17,1
"1853",22-04-02,"53 - 1103",182,186,179,3,4,0.983516483516483
"1854",22-04-02,"2 - 1066",42,58,42,0,16,1
"1855",22-04-02,"82 - 1163",78,30,14,64,-48,0.179487179487179
"1856",22-04-03,"40 - 1320",82,105,82,0,23,1
"1857",22-04-03,"40 - 1114",216,233,216,0,17,1
"1858",22-04-03,"53 - 1103",182,186,178,4,4,0.978021978021978
"1859",22-04-03,"2 - 1066",42,58,42,0,16,1
"1860",22-04-03,"82 - 1163",79,30,16,63,-49,0.20253164556962
"1861",22-04-04,"40 - 1320",87,105,87,0,18,1
"1862",22-04-04,"40 - 1114",222,231,215,7,9,0.968468468468468
"1863",22-04-04,"53 - 1103",183,186,181,2,3,0.989071038251366
"1864",22-04-04,"2 - 1066",42,58,42,0,16,1
"1865",22-04-04,"82 - 1163",125,148,17,108,23,0.136
"1866",22-04-05,"40 - 1320",88,105,88,0,17,1
"1867",22-04-05,"40 - 1114",220,231,219,1,11,0.995454545454545
"1868",22-04-05,"53 - 1103",184,186,180,4,2,0.978260869565217
"1869",22-04-05,"2 - 1066",43,58,43,0,15,1
"1870",22-04-05,"82 - 1163",129,148,21,108,19,0.162790697674419
"1871",22-04-06,"40 - 1320",90,105,90,0,15,1
"1872",22-04-06,"40 - 1114",219,232,219,0,13,1
"1873",22-04-06,"53 - 1103",184,186,178,6,2,0.967391304347826
"1874",22-04-06,"2 - 1066",42,58,42,0,16,1
"1875",22-04-06,"82 - 1163",129,148,32,97,19,0.248062015503876
"1876",22-04-07,"40 - 1320",95,105,91,4,10,0.957894736842105
"1877",22-04-07,"40 - 1114",219,232,219,0,13,1
"1878",22-04-07,"53 - 1103",184,186,179,5,2,0.972826086956522
"1879",22-04-07,"2 - 1066",42,58,42,0,16,1
"1880",22-04-07,"82 - 1163",129,148,43,86,19,0.333333333333333
"1881",22-04-08,"40 - 1320",95,105,91,4,10,0.957894736842105
"1882",22-04-08,"40 - 1114",218,232,218,0,14,1
"1883",22-04-08,"53 - 1103",182,186,178,4,4,0.978021978021978
"1884",22-04-08,"2 - 1066",41,58,41,0,17,1
"1885",22-04-08,"82 - 1163",130,148,51,79,18,0.392307692307692
"1886",22-04-09,"40 - 1320",99,105,94,5,6,0.94949494949495
"1887",22-04-09,"40 - 1114",220,232,218,2,12,0.990909090909091
"1888",22-04-09,"53 - 1103",184,186,179,5,2,0.972826086956522
"1889",22-04-09,"2 - 1066",41,58,41,0,17,1
"1890",22-04-09,"82 - 1163",130,148,49,81,18,0.376923076923077
"1891",22-04-10,"40 - 1320",100,105,96,4,5,0.96
"1892",22-04-10,"40 - 1114",219,232,216,3,13,0.986301369863014
"1893",22-04-10,"53 - 1103",184,186,177,7,2,0.96195652173913
"1894",22-04-10,"2 - 1066",41,58,41,0,17,1
"1895",22-04-10,"82 - 1163",132,178,52,80,46,0.393939393939394
"1896",22-04-11,"40 - 1320",105,105,101,4,0,0.961904761904762
"1897",22-04-11,"40 - 1114",217,232,215,2,15,0.990783410138249
"1898",22-04-11,"53 - 1103",181,186,173,8,5,0.955801104972376
"1899",22-04-11,"2 - 1066",41,58,41,0,17,1
"1900",22-04-11,"82 - 1163",138,178,54,84,40,0.391304347826087
"1901",22-04-12,"40 - 1320",104,105,104,0,1,1
"1902",22-04-12,"40 - 1114",217,232,216,1,15,0.995391705069124
"1903",22-04-12,"53 - 1103",184,186,175,9,2,0.951086956521739
"1904",22-04-12,"2 - 1066",40,58,40,0,18,1
"1905",22-04-12,"82 - 1163",139,178,58,81,39,0.41726618705036
"1906",22-04-13,"40 - 1320",104,105,104,0,1,1
"1907",22-04-13,"40 - 1114",219,232,219,0,13,1
"1908",22-04-13,"53 - 1103",184,186,178,6,2,0.967391304347826
"1909",22-04-13,"2 - 1066",41,58,41,0,17,1
"1910",22-04-13,"82 - 1163",150,178,61,89,28,0.406666666666667
"1911",22-04-14,"40 - 1320",104,105,103,1,1,0.990384615384615
"1912",22-04-14,"40 - 1114",218,232,218,0,14,1
"1913",22-04-14,"53 - 1103",183,186,179,4,3,0.978142076502732
"1914",22-04-14,"2 - 1066",42,58,42,0,16,1
"1915",22-04-14,"82 - 1163",151,178,64,87,27,0.423841059602649
"1916",22-04-15,"40 - 1320",104,105,103,1,1,0.990384615384615
"1917",22-04-15,"40 - 1114",218,232,218,0,14,1
"1918",22-04-15,"53 - 1103",181,186,177,4,5,0.977900552486188
"1919",22-04-15,"2 - 1066",43,58,43,0,15,1
"1920",22-04-15,"82 - 1163",151,178,63,88,27,0.417218543046358
"1921",22-04-16,"40 - 1320",105,105,105,0,0,1
"1922",22-04-16,"40 - 1114",220,232,218,2,12,0.990909090909091
"1923",22-04-16,"53 - 1103",182,186,174,8,4,0.956043956043956
"1924",22-04-16,"2 - 1066",43,58,43,0,15,1
"1925",22-04-16,"82 - 1163",151,178,64,87,27,0.423841059602649
"1926",22-04-17,"40 - 1320",105,105,105,0,0,1
"1927",22-04-17,"40 - 1114",220,232,218,2,12,0.990909090909091
"1928",22-04-17,"53 - 1103",185,186,178,7,1,0.962162162162162
"1929",22-04-17,"2 - 1066",42,58,42,0,16,1
"1930",22-04-17,"82 - 1163",151,178,62,89,27,0.410596026490066
"1931",22-04-18,"40 - 1320",105,105,105,0,0,1
"1932",22-04-18,"40 - 1114",219,232,217,2,13,0.990867579908676
"1933",22-04-18,"53 - 1103",186,186,179,7,0,0.962365591397849
"1934",22-04-18,"2 - 1066",42,58,42,0,16,1
"1935",22-04-18,"82 - 1163",151,178,60,91,27,0.397350993377483
"1936",22-04-19,"40 - 1320",105,105,105,0,0,1
"1937",22-04-19,"40 - 1114",218,232,218,0,14,1
"1938",22-04-19,"53 - 1103",186,186,176,10,0,0.946236559139785
"1939",22-04-19,"2 - 1066",42,58,42,0,16,1
"1940",22-04-19,"82 - 1163",151,178,63,88,27,0.417218543046358
"1941",22-04-20,"40 - 1320",105,105,105,0,0,1
"1942",22-04-20,"40 - 1114",218,232,218,0,14,1
"1943",22-04-20,"53 - 1103",186,186,177,9,0,0.951612903225806
"1944",22-04-20,"2 - 1066",41,58,41,0,17,1
"1945",22-04-20,"82 - 1163",149,148,65,84,-1,0.436241610738255
"1946",22-04-21,"40 - 1320",105,105,105,0,0,1
"1947",22-04-21,"40 - 1114",218,232,218,0,14,1
"1948",22-04-21,"53 - 1103",184,186,175,9,2,0.951086956521739
"1949",22-04-21,"2 - 1066",43,58,43,0,15,1
"1950",22-04-21,"82 - 1163",86,148,76,10,62,0.883720930232558
"1951",22-04-22,"40 - 1320",105,105,105,0,0,1
"1952",22-04-22,"40 - 1114",219,232,219,0,13,1
"1953",22-04-22,"53 - 1103",184,186,178,6,2,0.967391304347826
"1954",22-04-22,"2 - 1066",41,58,41,0,17,1
"1955",22-04-22,"82 - 1163",108,148,86,22,40,0.796296296296296
"1956",22-04-23,"40 - 1320",105,105,105,0,0,1
"1957",22-04-23,"40 - 1114",219,232,219,0,13,1
"1958",22-04-23,"53 - 1103",186,186,179,7,0,0.962365591397849
"1959",22-04-23,"2 - 1066",41,58,41,0,17,1
"1960",22-04-23,"82 - 1163",109,178,90,19,69,0.825688073394495
"1961",22-04-24,"40 - 1320",105,105,105,0,0,1
"1962",22-04-24,"40 - 1114",219,232,219,0,13,1
"1963",22-04-24,"53 - 1103",186,186,179,7,0,0.962365591397849
"1964",22-04-24,"2 - 1066",41,58,41,0,17,1
"1965",22-04-24,"82 - 1163",110,178,87,23,68,0.790909090909091
"1966",22-04-25,"40 - 1320",105,105,105,0,0,1
"1967",22-04-25,"40 - 1114",217,232,217,0,15,1
"1968",22-04-25,"53 - 1103",185,186,182,3,1,0.983783783783784
"1969",22-04-25,"2 - 1066",41,58,41,0,17,1
"1970",22-04-25,"82 - 1163",109,148,87,22,39,0.798165137614679
"1971",22-04-26,"40 - 1320",105,105,105,0,0,1
"1972",22-04-26,"40 - 1114",217,232,217,0,15,1
"1973",22-04-26,"53 - 1103",186,186,182,4,0,0.978494623655914
"1974",22-04-26,"2 - 1066",40,58,40,0,18,1
"1975",22-04-26,"82 - 1163",125,148,87,38,23,0.696
"1976",22-04-27,"40 - 1320",105,105,105,0,0,1
"1977",22-04-27,"40 - 1114",216,232,216,0,16,1
"1978",22-04-27,"53 - 1103",184,186,183,1,2,0.994565217391304
"1979",22-04-27,"2 - 1066",41,58,41,0,17,1
"1980",22-04-27,"82 - 1163",126,148,99,27,22,0.785714285714286
"1981",22-04-28,"40 - 1320",105,105,105,0,0,1
"1982",22-04-28,"40 - 1114",217,232,217,0,15,1
"1983",22-04-28,"53 - 1103",184,186,182,2,2,0.989130434782609
"1984",22-04-28,"2 - 1066",41,58,41,0,17,1
"1985",22-04-28,"82 - 1163",119,148,100,19,29,0.840336134453782
"1986",22-04-29,"40 - 1320",105,105,104,1,0,0.990476190476191
"1987",22-04-29,"40 - 1114",214,231,214,0,17,1
"1988",22-04-29,"53 - 1103",184,186,181,3,2,0.983695652173913
"1989",22-04-29,"2 - 1066",41,58,41,0,17,1
"1990",22-04-29,"82 - 1163",119,148,102,17,29,0.857142857142857
"1991",22-04-30,"40 - 1320",105,105,104,1,0,0.990476190476191
"1992",22-04-30,"40 - 1114",214,231,213,1,17,0.995327102803738
"1993",22-04-30,"53 - 1103",181,186,181,0,5,1
"1994",22-04-30,"2 - 1066",39,58,39,0,19,1
"1995",22-04-30,"82 - 1163",119,148,100,19,29,0.840336134453782
"1996",22-05-01,"40 - 1320",105,105,104,1,0,0.990476190476191
"1997",22-05-01,"40 - 1114",212,231,211,1,19,0.995283018867924
"1998",22-05-01,"53 - 1103",181,186,181,0,5,1
"1999",22-05-01,"2 - 1066",37,58,37,0,21,1
"2000",22-05-01,"82 - 1163",117,148,85,32,31,0.726495726495726
"2001",22-05-02,"40 - 1320",105,105,105,0,0,1
"2002",22-05-02,"40 - 1114",210,231,210,0,21,1
"2003",22-05-02,"53 - 1103",182,186,180,2,4,0.989010989010989
"2004",22-05-02,"2 - 1066",36,58,36,0,22,1
"2005",22-05-02,"82 - 1163",117,178,82,35,61,0.700854700854701
"2006",22-05-03,"40 - 1320",105,105,105,0,0,1
"2007",22-05-03,"40 - 1114",211,231,211,0,20,1
"2008",22-05-03,"53 - 1103",182,186,182,0,4,1
"2009",22-05-03,"2 - 1066",38,58,37,1,20,0.973684210526316
"2010",22-05-03,"82 - 1163",118,178,84,34,60,0.711864406779661
"2011",22-05-04,"40 - 1320",105,105,105,0,0,1
"2012",22-05-04,"40 - 1114",211,231,211,0,20,1
"2013",22-05-04,"53 - 1103",184,186,184,0,2,1
"2014",22-05-04,"2 - 1066",39,58,38,1,19,0.974358974358974
"2015",22-05-04,"82 - 1163",118,178,83,35,60,0.703389830508475
"2016",22-05-05,"40 - 1320",104,105,104,0,1,1
"2017",22-05-05,"40 - 1114",211,231,211,0,20,1
"2018",22-05-05,"53 - 1103",184,186,182,2,2,0.989130434782609
"2019",22-05-05,"2 - 1066",40,58,39,1,18,0.975
"2020",22-05-05,"82 - 1163",115,178,82,33,63,0.71304347826087
"2021",22-05-06,"40 - 1320",104,105,104,0,1,1
"2022",22-05-06,"40 - 1114",213,231,212,1,18,0.995305164319249
"2023",22-05-06,"53 - 1103",183,186,182,1,3,0.994535519125683
"2024",22-05-06,"2 - 1066",37,58,37,0,21,1
"2025",22-05-06,"82 - 1163",115,178,81,34,63,0.704347826086957
"2026",22-05-07,"40 - 1320",104,105,104,0,1,1
"2027",22-05-07,"40 - 1114",215,231,213,2,16,0.990697674418605
"2028",22-05-07,"53 - 1103",185,186,183,2,1,0.989189189189189
"2029",22-05-07,"2 - 1066",37,58,37,0,21,1
"2030",22-05-07,"82 - 1163",114,178,80,34,64,0.701754385964912
"2031",22-05-08,"40 - 1320",104,105,104,0,1,1
"2032",22-05-08,"40 - 1114",216,231,214,2,15,0.990740740740741
"2033",22-05-08,"53 - 1103",185,186,183,2,1,0.989189189189189
"2034",22-05-08,"2 - 1066",39,58,39,0,19,1
"2035",22-05-08,"82 - 1163",114,178,80,34,64,0.701754385964912
"2036",22-05-09,"40 - 1320",104,105,104,0,1,1
"2037",22-05-09,"40 - 1114",216,231,215,1,15,0.99537037037037
"2038",22-05-09,"53 - 1103",186,186,186,0,0,1
"2039",22-05-09,"2 - 1066",39,58,39,0,19,1
"2040",22-05-09,"82 - 1163",117,178,84,33,61,0.717948717948718
"2041",22-05-10,"40 - 1320",105,105,105,0,0,1
"2042",22-05-10,"40 - 1114",216,231,216,0,15,1
"2043",22-05-10,"53 - 1103",185,186,185,0,1,1
"2044",22-05-10,"2 - 1066",37,58,37,0,21,1
"2045",22-05-10,"82 - 1163",119,178,85,34,59,0.714285714285714
"2046",22-05-11,"40 - 1320",105,105,105,0,0,1
"2047",22-05-11,"40 - 1114",211,231,211,0,20,1
"2048",22-05-11,"53 - 1103",186,186,186,0,0,1
"2049",22-05-11,"2 - 1066",38,58,38,0,20,1
"2050",22-05-11,"82 - 1163",121,178,88,33,57,0.727272727272727
"2051",22-05-12,"40 - 1320",105,105,105,0,0,1
"2052",22-05-12,"40 - 1114",211,231,211,0,20,1
"2053",22-05-12,"53 - 1103",185,186,184,1,1,0.994594594594595
"2054",22-05-12,"2 - 1066",40,58,40,0,18,1
"2055",22-05-12,"82 - 1163",125,178,90,35,53,0.72
"2056",22-05-13,"40 - 1320",105,105,105,0,0,1
"2057",22-05-13,"40 - 1114",213,231,213,0,18,1
"2058",22-05-13,"53 - 1103",185,186,185,0,1,1
"2059",22-05-13,"2 - 1066",39,58,39,0,19,1
"2060",22-05-13,"82 - 1163",125,178,86,39,53,0.688
"2061",22-05-14,"40 - 1320",105,105,105,0,0,1
"2062",22-05-14,"40 - 1114",215,231,215,0,16,1
"2063",22-05-14,"53 - 1103",185,186,184,1,1,0.994594594594595
"2064",22-05-14,"2 - 1066",38,58,38,0,20,1
"2065",22-05-14,"82 - 1163",125,178,90,35,53,0.72
"2066",22-05-15,"40 - 1320",105,105,105,0,0,1
"2067",22-05-15,"40 - 1114",216,231,216,0,15,1
"2068",22-05-15,"53 - 1103",184,186,182,2,2,0.989130434782609
"2069",22-05-15,"2 - 1066",38,58,38,0,20,1
"2070",22-05-15,"82 - 1163",122,148,84,38,26,0.688524590163934
"2071",22-05-16,"40 - 1320",105,105,105,0,0,1
"2072",22-05-16,"40 - 1114",215,231,215,0,16,1
"2073",22-05-16,"53 - 1103",179,186,179,0,7,1
"2074",22-05-16,"2 - 1066",38,58,38,0,20,1
"2075",22-05-16,"82 - 1163",121,148,85,36,27,0.702479338842975
"2076",22-05-17,"40 - 1320",105,105,105,0,0,1
"2077",22-05-17,"40 - 1114",216,231,216,0,15,1
"2078",22-05-17,"53 - 1103",179,186,177,2,7,0.988826815642458
"2079",22-05-17,"2 - 1066",39,58,39,0,19,1
"2080",22-05-17,"82 - 1163",127,148,91,36,21,0.716535433070866
"2081",22-05-18,"40 - 1320",105,105,105,0,0,1
"2082",22-05-18,"40 - 1114",219,231,218,1,12,0.995433789954338
"2083",22-05-18,"53 - 1103",176,186,176,0,10,1
"2084",22-05-18,"2 - 1066",40,58,39,1,18,0.975
"2085",22-05-18,"82 - 1163",129,148,94,35,19,0.728682170542636
"2086",22-05-19,"40 - 1320",105,105,105,0,0,1
"2087",22-05-19,"40 - 1114",217,231,217,0,14,1
"2088",22-05-19,"53 - 1103",179,186,179,0,7,1
"2089",22-05-19,"2 - 1066",41,58,40,1,17,0.975609756097561
"2090",22-05-19,"82 - 1163",129,148,92,37,19,0.713178294573643
"2091",22-05-20,"40 - 1320",105,105,103,2,0,0.980952380952381
"2092",22-05-20,"40 - 1114",217,231,217,0,14,1
"2093",22-05-20,"53 - 1103",183,186,183,0,3,1
"2094",22-05-20,"2 - 1066",42,58,42,0,16,1
"2095",22-05-20,"82 - 1163",129,148,97,32,19,0.751937984496124
"2096",22-05-21,"40 - 1320",104,105,104,0,1,1
"2097",22-05-21,"40 - 1114",219,231,218,1,12,0.995433789954338
"2098",22-05-21,"53 - 1103",185,186,184,1,1,0.994594594594595
"2099",22-05-21,"2 - 1066",42,58,42,0,16,1
"2100",22-05-21,"82 - 1163",129,148,96,33,19,0.744186046511628
"2101",22-05-22,"40 - 1320",104,105,104,0,1,1
"2102",22-05-22,"40 - 1114",219,231,219,0,12,1
"2103",22-05-22,"53 - 1103",185,186,184,1,1,0.994594594594595
"2104",22-05-22,"2 - 1066",42,58,42,0,16,1
"2105",22-05-22,"82 - 1163",129,148,96,33,19,0.744186046511628
"2106",22-05-23,"40 - 1320",104,105,103,1,1,0.990384615384615
"2107",22-05-23,"40 - 1114",219,231,219,0,12,1
"2108",22-05-23,"53 - 1103",186,186,183,3,0,0.983870967741935
"2109",22-05-23,"2 - 1066",44,58,43,1,14,0.977272727272727
"2110",22-05-23,"82 - 1163",129,148,95,34,19,0.736434108527132
"2111",22-05-24,"40 - 1320",105,105,105,0,0,1
"2112",22-05-24,"40 - 1114",220,231,219,1,11,0.995454545454545
"2113",22-05-24,"53 - 1103",185,186,182,3,1,0.983783783783784
"2114",22-05-24,"2 - 1066",44,58,44,0,14,1
"2115",22-05-24,"82 - 1163",129,148,94,35,19,0.728682170542636
"2116",22-05-25,"40 - 1320",105,105,105,0,0,1
"2117",22-05-25,"40 - 1114",220,231,220,0,11,1
"2118",22-05-25,"53 - 1103",178,186,176,2,8,0.98876404494382
"2119",22-05-25,"2 - 1066",44,58,44,0,14,1
"2120",22-05-25,"82 - 1163",129,148,93,36,19,0.720930232558139
"2121",22-05-26,"40 - 1320",105,105,105,0,0,1
"2122",22-05-26,"40 - 1114",219,231,219,0,12,1
"2123",22-05-26,"53 - 1103",183,186,180,3,3,0.983606557377049
"2124",22-05-26,"2 - 1066",44,58,44,0,14,1
"2125",22-05-26,"82 - 1163",129,148,94,35,19,0.728682170542636
"2126",22-05-27,"40 - 1320",105,105,105,0,0,1
"2127",22-05-27,"40 - 1114",215,231,215,0,16,1
"2128",22-05-27,"53 - 1103",182,186,181,1,4,0.994505494505495
"2129",22-05-27,"2 - 1066",43,58,43,0,15,1
"2130",22-05-27,"82 - 1163",127,148,93,34,21,0.732283464566929
"2131",22-05-28,"40 - 1320",105,105,105,0,0,1
"2132",22-05-28,"40 - 1114",216,231,215,1,15,0.99537037037037
"2133",22-05-28,"53 - 1103",186,186,182,4,0,0.978494623655914
"2134",22-05-28,"2 - 1066",44,58,44,0,14,1
"2135",22-05-28,"82 - 1163",127,148,92,35,21,0.724409448818898
"2136",22-05-29,"40 - 1320",105,105,105,0,0,1
"2137",22-05-29,"40 - 1114",216,231,215,1,15,0.99537037037037
"2138",22-05-29,"53 - 1103",184,186,182,2,2,0.989130434782609
"2139",22-05-29,"2 - 1066",44,58,44,0,14,1
"2140",22-05-29,"82 - 1163",127,148,92,35,21,0.724409448818898
"2141",22-05-30,"40 - 1320",105,105,105,0,0,1
"2142",22-05-30,"40 - 1114",215,231,215,0,16,1
"2143",22-05-30,"53 - 1103",184,186,183,1,2,0.994565217391304
"2144",22-05-30,"2 - 1066",44,58,44,0,14,1
"2145",22-05-30,"82 - 1163",127,148,91,36,21,0.716535433070866
"2146",22-05-31,"40 - 1320",105,105,105,0,0,1
"2147",22-05-31,"40 - 1114",215,231,213,2,16,0.990697674418605
"2148",22-05-31,"53 - 1103",183,186,182,1,3,0.994535519125683
"2149",22-05-31,"2 - 1066",45,58,45,0,13,1
"2150",22-05-31,"82 - 1163",127,148,87,40,21,0.68503937007874
"2151",22-06-01,"40 - 1320",105,105,105,0,0,1
"2152",22-06-01,"40 - 1114",211,231,211,0,20,1
"2153",22-06-01,"53 - 1103",181,186,180,1,5,0.994475138121547
"2154",22-06-01,"2 - 1066",45,58,45,0,13,1
"2155",22-06-01,"82 - 1163",126,148,89,37,22,0.706349206349206
"2156",22-06-02,"40 - 1320",105,105,104,1,0,0.990476190476191
"2157",22-06-02,"40 - 1114",211,231,211,0,20,1
"2158",22-06-02,"53 - 1103",182,186,181,1,4,0.994505494505495
"2159",22-06-02,"2 - 1066",43,58,43,0,15,1
"2160",22-06-02,"82 - 1163",125,148,88,37,23,0.704
"2161",22-06-03,"40 - 1320",104,105,104,0,1,1
"2162",22-06-03,"40 - 1114",209,231,209,0,22,1
"2163",22-06-03,"53 - 1103",185,186,184,1,1,0.994594594594595
"2164",22-06-03,"2 - 1066",44,58,44,0,14,1
"2165",22-06-03,"82 - 1163",127,148,86,41,21,0.677165354330709
"2166",22-06-04,"40 - 1320",104,105,103,1,1,0.990384615384615
"2167",22-06-04,"40 - 1114",209,231,209,0,22,1
"2168",22-06-04,"53 - 1103",184,186,184,0,2,1
"2169",22-06-04,"2 - 1066",44,58,44,0,14,1
"2170",22-06-04,"82 - 1163",124,148,84,40,24,0.67741935483871
"2171",22-06-05,"40 - 1320",105,105,105,0,0,1
"2172",22-06-05,"40 - 1114",209,231,209,0,22,1
"2173",22-06-05,"53 - 1103",183,186,181,2,3,0.989071038251366
"2174",22-06-05,"2 - 1066",45,58,44,1,13,0.977777777777778
"2175",22-06-05,"82 - 1163",124,148,84,40,24,0.67741935483871
"2176",22-06-06,"40 - 1320",105,105,105,0,0,1
"2177",22-06-06,"40 - 1114",210,231,208,2,21,0.990476190476191
"2178",22-06-06,"53 - 1103",183,186,183,0,3,1
"2179",22-06-06,"2 - 1066",45,58,45,0,13,1
"2180",22-06-06,"82 - 1163",123,148,82,41,25,0.666666666666667
"2181",22-06-07,"40 - 1320",105,105,105,0,0,1
"2182",22-06-07,"40 - 1114",214,231,212,2,17,0.990654205607477
"2183",22-06-07,"53 - 1103",183,186,181,2,3,0.989071038251366
"2184",22-06-07,"2 - 1066",45,58,45,0,13,1
"2185",22-06-07,"82 - 1163",126,148,85,41,22,0.674603174603175
"2186",22-06-08,"40 - 1320",105,105,105,0,0,1
"2187",22-06-08,"40 - 1114",214,231,214,0,17,1
"2188",22-06-08,"53 - 1103",179,186,179,0,7,1
"2189",22-06-08,"2 - 1066",45,58,45,0,13,1
"2190",22-06-08,"82 - 1163",126,148,83,43,22,0.658730158730159
"2191",22-06-09,"40 - 1320",105,105,105,0,0,1
"2192",22-06-09,"40 - 1114",216,231,215,1,15,0.99537037037037
"2193",22-06-09,"53 - 1103",179,186,179,0,7,1
"2194",22-06-09,"2 - 1066",45,58,45,0,13,1
"2195",22-06-09,"82 - 1163",125,148,84,41,23,0.672
"2196",22-06-10,"40 - 1320",105,105,105,0,0,1
"2197",22-06-10,"40 - 1114",220,231,219,1,11,0.995454545454545
"2198",22-06-10,"53 - 1103",174,186,174,0,12,1
"2199",22-06-10,"2 - 1066",45,58,45,0,13,1
"2200",22-06-10,"82 - 1163",134,148,93,41,14,0.694029850746269
"2201",22-06-11,"40 - 1320",105,105,105,0,0,1
"2202",22-06-11,"40 - 1114",219,231,218,1,12,0.995433789954338
"2203",22-06-11,"53 - 1103",176,186,174,2,10,0.988636363636364
"2204",22-06-11,"2 - 1066",45,58,45,0,13,1
"2205",22-06-11,"82 - 1163",142,148,98,44,6,0.690140845070423
"2206",22-06-12,"40 - 1320",105,105,105,0,0,1
"2207",22-06-12,"40 - 1114",219,231,219,0,12,1
"2208",22-06-12,"53 - 1103",180,186,178,2,6,0.988888888888889
"2209",22-06-12,"2 - 1066",45,58,45,0,13,1
"2210",22-06-12,"82 - 1163",140,148,97,43,8,0.692857142857143
"2211",22-06-13,"40 - 1320",105,105,105,0,0,1
"2212",22-06-13,"40 - 1114",219,231,219,0,12,1
"2213",22-06-13,"53 - 1103",178,186,177,1,8,0.99438202247191
"2214",22-06-13,"2 - 1066",45,58,45,0,13,1
"2215",22-06-13,"82 - 1163",147,148,107,40,1,0.727891156462585
"2216",22-06-14,"40 - 1320",105,105,105,0,0,1
"2217",22-06-14,"40 - 1114",217,231,216,1,14,0.995391705069124
"2218",22-06-14,"53 - 1103",180,186,180,0,6,1
"2219",22-06-14,"2 - 1066",45,58,45,0,13,1
"2220",22-06-14,"82 - 1163",149,148,111,38,-1,0.74496644295302
"2221",22-06-15,"40 - 1320",105,105,105,0,0,1
"2222",22-06-15,"40 - 1114",218,231,218,0,13,1
"2223",22-06-15,"53 - 1103",180,186,177,3,6,0.983333333333333
"2224",22-06-15,"2 - 1066",45,58,45,0,13,1
"2225",22-06-15,"82 - 1163",141,148,113,28,7,0.801418439716312
"2226",22-06-16,"40 - 1320",105,105,105,0,0,1
"2227",22-06-16,"40 - 1114",221,231,220,1,10,0.995475113122172
"2228",22-06-16,"53 - 1103",181,186,180,1,5,0.994475138121547
"2229",22-06-16,"2 - 1066",46,58,46,0,12,1
"2230",22-06-16,"82 - 1163",138,148,112,26,10,0.811594202898551
"2231",22-06-17,"40 - 1320",105,105,105,0,0,1
"2232",22-06-17,"40 - 1114",223,231,223,0,8,1
"2233",22-06-17,"53 - 1103",180,186,180,0,6,1
"2234",22-06-17,"2 - 1066",46,58,46,0,12,1
"2235",22-06-17,"82 - 1163",137,148,109,28,11,0.795620437956204
"2236",22-06-18,"40 - 1320",105,105,105,0,0,1
"2237",22-06-18,"40 - 1114",225,231,225,0,6,1
"2238",22-06-18,"53 - 1103",179,186,179,0,7,1
"2239",22-06-18,"2 - 1066",46,58,46,0,12,1
"2240",22-06-18,"82 - 1163",137,148,109,28,11,0.795620437956204
"2241",22-06-19,"40 - 1320",105,105,105,0,0,1
"2242",22-06-19,"40 - 1114",227,231,226,1,4,0.995594713656388
"2243",22-06-19,"53 - 1103",178,186,178,0,8,1
"2244",22-06-19,"2 - 1066",46,58,46,0,12,1
"2245",22-06-19,"82 - 1163",136,148,109,27,12,0.801470588235294
"2246",22-06-20,"40 - 1320",105,105,105,0,0,1
"2247",22-06-20,"40 - 1114",226,231,226,0,5,1
"2248",22-06-20,"53 - 1103",181,186,178,3,5,0.983425414364641
"2249",22-06-20,"2 - 1066",45,58,45,0,13,1
"2250",22-06-20,"82 - 1163",134,148,108,26,14,0.805970149253731
"2251",22-06-21,"40 - 1320",105,105,105,0,0,1
"2252",22-06-21,"40 - 1114",226,231,226,0,5,1
"2253",22-06-21,"53 - 1103",178,186,178,0,8,1
"2254",22-06-21,"2 - 1066",45,58,45,0,13,1
"2255",22-06-21,"82 - 1163",137,148,113,24,11,0.824817518248175
"2256",22-06-22,"40 - 1320",105,105,104,1,0,0.990476190476191
"2257",22-06-22,"40 - 1114",227,231,227,0,4,1
"2258",22-06-22,"53 - 1103",177,186,176,1,9,0.994350282485876
"2259",22-06-22,"2 - 1066",45,58,45,0,13,1
"2260",22-06-22,"82 - 1163",138,148,115,23,10,0.833333333333333
"2261",22-06-23,"40 - 1320",105,105,105,0,0,1
"2262",22-06-23,"40 - 1114",227,231,227,0,4,1
"2263",22-06-23,"53 - 1103",178,186,175,3,8,0.98314606741573
"2264",22-06-23,"2 - 1066",44,58,44,0,14,1
"2265",22-06-23,"82 - 1163",138,148,118,20,10,0.855072463768116
"2266",22-06-24,"40 - 1320",105,105,105,0,0,1
"2267",22-06-24,"40 - 1114",226,231,226,0,5,1
"2268",22-06-24,"53 - 1103",179,186,176,3,7,0.983240223463687
"2269",22-06-24,"2 - 1066",45,58,45,0,13,1
"2270",22-06-24,"82 - 1163",139,148,118,21,9,0.848920863309353
"2271",22-06-25,"40 - 1320",105,105,105,0,0,1
"2272",22-06-25,"40 - 1114",227,231,227,0,4,1
"2273",22-06-25,"53 - 1103",177,186,175,2,9,0.988700564971751
"2274",22-06-25,"2 - 1066",44,58,43,1,14,0.977272727272727
"2275",22-06-25,"82 - 1163",139,148,119,20,9,0.856115107913669
"2276",22-06-26,"40 - 1320",105,105,105,0,0,1
"2277",22-06-26,"40 - 1114",227,231,227,0,4,1
"2278",22-06-26,"53 - 1103",177,186,173,4,9,0.977401129943503
"2279",22-06-26,"2 - 1066",44,58,43,1,14,0.977272727272727
"2280",22-06-26,"82 - 1163",139,148,119,20,9,0.856115107913669
"2281",22-06-27,"40 - 1320",105,105,105,0,0,1
"2282",22-06-27,"40 - 1114",226,231,226,0,5,1
"2283",22-06-27,"53 - 1103",177,186,175,2,9,0.988700564971751
"2284",22-06-27,"2 - 1066",44,58,44,0,14,1
"2285",22-06-27,"82 - 1163",135,148,116,19,13,0.859259259259259
"2286",22-06-28,"40 - 1320",105,105,105,0,0,1
"2287",22-06-28,"40 - 1114",226,231,226,0,5,1
"2288",22-06-28,"53 - 1103",177,186,176,1,9,0.994350282485876
"2289",22-06-28,"2 - 1066",44,58,44,0,14,1
"2290",22-06-28,"82 - 1163",136,178,119,17,42,0.875
"2291",22-06-29,"40 - 1320",105,105,105,0,0,1
"2292",22-06-29,"40 - 1114",226,231,226,0,5,1
"2293",22-06-29,"53 - 1103",179,186,179,0,7,1
"2294",22-06-29,"2 - 1066",44,58,44,0,14,1
"2295",22-06-29,"82 - 1163",138,178,124,14,40,0.898550724637681
"2296",22-06-30,"40 - 1320",104,105,103,1,1,0.990384615384615
"2297",22-06-30,"40 - 1114",226,231,226,0,5,1
"2298",22-06-30,"53 - 1103",179,186,177,2,7,0.988826815642458
"2299",22-06-30,"2 - 1066",44,58,44,0,14,1
"2300",22-06-30,"82 - 1163",141,178,125,16,37,0.886524822695035
"2301",22-07-01,"40 - 1320",104,105,102,2,1,0.980769230769231
"2302",22-07-01,"40 - 1114",227,231,227,0,4,1
"2303",22-07-01,"53 - 1103",178,186,177,1,8,0.99438202247191
"2304",22-07-01,"2 - 1066",44,58,44,0,14,1
"2305",22-07-01,"82 - 1163",138,178,120,18,40,0.869565217391304
"2306",22-07-02,"40 - 1320",105,105,105,0,0,1
"2307",22-07-02,"40 - 1114",227,231,227,0,4,1
"2308",22-07-02,"53 - 1103",180,186,178,2,6,0.988888888888889
"2309",22-07-02,"2 - 1066",44,58,44,0,14,1
"2310",22-07-02,"82 - 1163",138,178,117,21,40,0.847826086956522
"2311",22-07-03,"40 - 1320",105,105,105,0,0,1
"2312",22-07-03,"40 - 1114",226,231,226,0,5,1
"2313",22-07-03,"53 - 1103",179,186,178,1,7,0.994413407821229
"2314",22-07-03,"2 - 1066",43,58,43,0,15,1
"2315",22-07-03,"82 - 1163",138,178,116,22,40,0.840579710144927
"2316",22-07-04,"40 - 1320",105,105,105,0,0,1
"2317",22-07-04,"40 - 1114",224,231,224,0,7,1
"2318",22-07-04,"53 - 1103",177,186,177,0,9,1
"2319",22-07-04,"2 - 1066",44,58,44,0,14,1
"2320",22-07-04,"82 - 1163",137,178,112,25,41,0.817518248175182
"2321",22-07-05,"40 - 1320",105,105,105,0,0,1
"2322",22-07-05,"40 - 1114",221,231,221,0,10,1
"2323",22-07-05,"53 - 1103",180,186,179,1,6,0.994444444444444
"2324",22-07-05,"2 - 1066",43,40,43,0,-3,1
"2325",22-07-05,"82 - 1163",139,178,116,23,39,0.834532374100719
"2326",22-07-06,"40 - 1320",105,105,105,0,0,1
"2327",22-07-06,"40 - 1114",220,231,219,1,11,0.995454545454545
"2328",22-07-06,"53 - 1103",180,186,180,0,6,1
"2329",22-07-06,"2 - 1066",42,40,42,0,-2,1
"2330",22-07-06,"82 - 1163",137,178,117,20,41,0.854014598540146
"2331",22-07-07,"40 - 1320",105,105,105,0,0,1
"2332",22-07-07,"40 - 1114",226,232,220,6,6,0.973451327433628
"2333",22-07-07,"53 - 1103",179,186,178,1,7,0.994413407821229
"2334",22-07-07,"2 - 1066",42,40,42,0,-2,1
"2335",22-07-07,"82 - 1163",138,178,124,14,40,0.898550724637681
"2336",22-07-08,"40 - 1320",105,105,105,0,0,1
"2337",22-07-08,"40 - 1114",222,232,222,0,10,1
"2338",22-07-08,"53 - 1103",179,186,179,0,7,1
"2339",22-07-08,"2 - 1066",44,40,44,0,-4,1
"2340",22-07-08,"82 - 1163",139,178,120,19,39,0.863309352517986
"2341",22-07-09,"40 - 1320",105,105,105,0,0,1
"2342",22-07-09,"40 - 1114",226,232,226,0,6,1
"2343",22-07-09,"53 - 1103",179,186,179,0,7,1
"2344",22-07-09,"2 - 1066",45,40,45,0,-5,1
"2345",22-07-09,"82 - 1163",139,178,121,18,39,0.870503597122302
"2346",22-07-10,"40 - 1320",105,105,105,0,0,1
"2347",22-07-10,"40 - 1114",226,232,225,1,6,0.995575221238938
"2348",22-07-10,"53 - 1103",179,186,178,1,7,0.994413407821229
"2349",22-07-10,"2 - 1066",45,40,45,0,-5,1
"2350",22-07-10,"82 - 1163",140,178,123,17,38,0.878571428571429
"2351",22-07-11,"40 - 1320",105,105,105,0,0,1
"2352",22-07-11,"40 - 1114",223,232,223,0,9,1
"2353",22-07-11,"53 - 1103",178,186,178,0,8,1
"2354",22-07-11,"2 - 1066",45,40,45,0,-5,1
"2355",22-07-11,"82 - 1163",135,178,123,12,43,0.911111111111111
"2356",22-07-12,"40 - 1320",104,105,104,0,1,1
"2357",22-07-12,"40 - 1114",225,232,225,0,7,1
"2358",22-07-12,"53 - 1103",179,186,178,1,7,0.994413407821229
"2359",22-07-12,"2 - 1066",45,40,45,0,-5,1
"2360",22-07-12,"82 - 1163",134,178,122,12,44,0.91044776119403
"2361",22-07-13,"40 - 1320",104,105,104,0,1,1
"2362",22-07-13,"40 - 1114",228,232,228,0,4,1
"2363",22-07-13,"53 - 1103",180,186,179,1,6,0.994444444444444
"2364",22-07-13,"2 - 1066",45,40,45,0,-5,1
"2365",22-07-13,"82 - 1163",136,178,125,11,42,0.919117647058823
"2366",22-07-14,"40 - 1320",104,105,104,0,1,1
"2367",22-07-14,"40 - 1114",228,232,228,0,4,1
"2368",22-07-14,"53 - 1103",181,186,179,2,5,0.988950276243094
"2369",22-07-14,"2 - 1066",46,40,46,0,-6,1
"2370",22-07-14,"82 - 1163",136,178,125,11,42,0.919117647058823
"2371",22-07-15,"40 - 1320",105,105,104,1,0,0.990476190476191
"2372",22-07-15,"40 - 1114",227,232,227,0,5,1
"2373",22-07-15,"53 - 1103",182,186,179,3,4,0.983516483516483
"2374",22-07-15,"2 - 1066",46,40,46,0,-6,1
"2375",22-07-15,"82 - 1163",136,178,127,9,42,0.933823529411765
"2376",22-07-16,"40 - 1320",105,105,105,0,0,1
"2377",22-07-16,"40 - 1114",227,232,227,0,5,1
"2378",22-07-16,"53 - 1103",183,186,179,4,3,0.978142076502732
"2379",22-07-16,"2 - 1066",46,40,46,0,-6,1
"2380",22-07-16,"82 - 1163",136,178,126,10,42,0.926470588235294
"2381",22-07-17,"40 - 1320",105,105,105,0,0,1
"2382",22-07-17,"40 - 1114",227,232,227,0,5,1
"2383",22-07-17,"53 - 1103",183,186,178,5,3,0.972677595628415
"2384",22-07-17,"2 - 1066",46,40,46,0,-6,1
"2385",22-07-17,"82 - 1163",135,178,126,9,43,0.933333333333333
"2386",22-07-18,"40 - 1320",105,105,105,0,0,1
"2387",22-07-18,"40 - 1114",227,231,226,1,4,0.995594713656388
"2388",22-07-18,"53 - 1103",178,186,179,-1,8,1.00561797752809
"2389",22-07-18,"2 - 1066",46,40,46,0,-6,1
"2390",22-07-18,"82 - 1163",134,178,123,11,44,0.917910447761194
"2391",22-07-19,"40 - 1320",105,105,105,0,0,1
"2392",22-07-19,"40 - 1114",229,232,227,2,3,0.991266375545852
"2393",22-07-19,"53 - 1103",179,186,178,1,7,0.994413407821229
"2394",22-07-19,"2 - 1066",46,40,46,0,-6,1
"2395",22-07-19,"82 - 1163",134,178,124,10,44,0.925373134328358
"2396",22-07-20,"40 - 1320",105,105,105,0,0,1
"2397",22-07-20,"40 - 1114",228,232,228,0,4,1
"2398",22-07-20,"53 - 1103",182,186,182,0,4,1
"2399",22-07-20,"2 - 1066",45,40,45,0,-5,1
"2400",22-07-20,"82 - 1163",133,178,122,11,45,0.917293233082707
"2401",22-07-21,"40 - 1320",105,105,105,0,0,1
"2402",22-07-21,"40 - 1114",229,232,229,0,3,1
"2403",22-07-21,"53 - 1103",184,186,183,1,2,0.994565217391304
"2404",22-07-21,"2 - 1066",46,40,46,0,-6,1
"2405",22-07-21,"82 - 1163",133,178,126,7,45,0.947368421052632
"2406",22-07-22,"40 - 1320",105,105,105,0,0,1
"2407",22-07-22,"40 - 1114",230,232,229,1,2,0.995652173913044
"2408",22-07-22,"53 - 1103",183,186,183,0,3,1
"2409",22-07-22,"2 - 1066",45,40,45,0,-5,1
"2410",22-07-22,"82 - 1163",133,178,126,7,45,0.947368421052632
"2411",22-07-23,"40 - 1320",105,105,104,1,0,0.990476190476191
"2412",22-07-23,"40 - 1114",230,232,230,0,2,1
"2413",22-07-23,"53 - 1103",183,186,182,1,3,0.994535519125683
"2414",22-07-23,"2 - 1066",45,40,45,0,-5,1
"2415",22-07-23,"82 - 1163",136,178,127,9,42,0.933823529411765
"2416",22-07-24,"40 - 1320",105,105,105,0,0,1
"2417",22-07-24,"40 - 1114",230,232,230,0,2,1
"2418",22-07-24,"53 - 1103",182,186,179,3,4,0.983516483516483
"2419",22-07-24,"2 - 1066",45,40,45,0,-5,1
"2420",22-07-24,"82 - 1163",132,178,123,9,46,0.931818181818182
"2421",22-07-25,"40 - 1320",105,105,105,0,0,1
"2422",22-07-25,"40 - 1114",230,232,230,0,2,1
"2423",22-07-25,"53 - 1103",183,186,183,0,3,1
"2424",22-07-25,"2 - 1066",45,40,45,0,-5,1
"2425",22-07-25,"82 - 1163",131,178,124,7,47,0.946564885496183
"2426",22-07-26,"40 - 1320",105,105,105,0,0,1
"2427",22-07-26,"40 - 1114",230,232,230,0,2,1
"2428",22-07-26,"53 - 1103",184,186,183,1,2,0.994565217391304
"2429",22-07-26,"2 - 1066",44,40,44,0,-4,1
"2430",22-07-26,"82 - 1163",142,178,125,17,36,0.880281690140845
"2431",22-07-27,"40 - 1320",105,105,105,0,0,1
"2432",22-07-27,"40 - 1114",230,232,230,0,2,1
"2433",22-07-27,"53 - 1103",184,186,183,1,2,0.994565217391304
"2434",22-07-27,"2 - 1066",46,40,46,0,-6,1
"2435",22-07-27,"82 - 1163",143,178,129,14,35,0.902097902097902
"2436",22-07-28,"40 - 1320",105,105,105,0,0,1
"2437",22-07-28,"40 - 1114",228,231,228,0,3,1
"2438",22-07-28,"53 - 1103",183,186,182,1,3,0.994535519125683
"2439",22-07-28,"2 - 1066",46,40,46,0,-6,1
"2440",22-07-28,"82 - 1163",143,178,133,10,35,0.93006993006993
"2441",22-07-29,"40 - 1320",105,105,104,1,0,0.990476190476191
"2442",22-07-29,"40 - 1114",228,231,228,0,3,1
"2443",22-07-29,"53 - 1103",185,186,185,0,1,1
"2444",22-07-29,"2 - 1066",46,40,46,0,-6,1
"2445",22-07-29,"82 - 1163",144,178,136,8,34,0.944444444444444
"2446",22-07-30,"40 - 1320",105,105,105,0,0,1
"2447",22-07-30,"40 - 1114",228,231,228,0,3,1
"2448",22-07-30,"53 - 1103",184,186,184,0,2,1
"2449",22-07-30,"2 - 1066",46,40,46,0,-6,1
"2450",22-07-30,"82 - 1163",145,178,134,11,33,0.924137931034483
"2451",22-07-31,"40 - 1320",105,105,105,0,0,1
"2452",22-07-31,"40 - 1114",228,231,228,0,3,1
"2453",22-07-31,"53 - 1103",184,186,184,0,2,1
"2454",22-07-31,"2 - 1066",46,40,46,0,-6,1
"2455",22-07-31,"82 - 1163",146,178,128,18,32,0.876712328767123
"2456",22-08-01,"40 - 1320",105,105,104,1,0,0.990476190476191
"2457",22-08-01,"40 - 1114",227,231,227,0,4,1
"2458",22-08-01,"53 - 1103",183,186,183,0,3,1
"2459",22-08-01,"2 - 1066",45,40,45,0,-5,1
"2460",22-08-01,"82 - 1163",146,178,126,20,32,0.863013698630137
"2461",22-08-02,"40 - 1320",105,105,105,0,0,1
"2462",22-08-02,"40 - 1114",226,231,226,0,5,1
"2463",22-08-02,"53 - 1103",183,186,183,0,3,1
"2464",22-08-02,"2 - 1066",45,40,45,0,-5,1
"2465",22-08-02,"82 - 1163",142,178,126,16,36,0.887323943661972
"2466",22-08-03,"40 - 1320",105,105,105,0,0,1
"2467",22-08-03,"40 - 1114",223,231,223,0,8,1
"2468",22-08-03,"53 - 1103",183,186,183,0,3,1
"2469",22-08-03,"2 - 1066",45,40,45,0,-5,1
"2470",22-08-03,"82 - 1163",142,178,124,18,36,0.873239436619718
"2471",22-08-04,"40 - 1320",103,105,102,1,2,0.990291262135922
"2472",22-08-04,"40 - 1114",223,231,223,0,8,1
"2473",22-08-04,"53 - 1103",185,186,185,0,1,1
"2474",22-08-04,"2 - 1066",45,40,45,0,-5,1
"2475",22-08-04,"82 - 1163",142,178,126,16,36,0.887323943661972
"2476",22-08-05,"40 - 1320",104,105,103,1,1,0.990384615384615
"2477",22-08-05,"40 - 1114",223,231,223,0,8,1
"2478",22-08-05,"53 - 1103",181,186,181,0,5,1
"2479",22-08-05,"2 - 1066",44,40,44,0,-4,1
"2480",22-08-05,"82 - 1163",142,178,125,17,36,0.880281690140845
"2481",22-08-06,"40 - 1320",104,105,103,1,1,0.990384615384615
"2482",22-08-06,"40 - 1114",223,231,223,0,8,1
"2483",22-08-06,"53 - 1103",183,186,180,3,3,0.983606557377049
"2484",22-08-06,"2 - 1066",45,40,45,0,-5,1
"2485",22-08-06,"82 - 1163",143,178,118,25,35,0.825174825174825
"2486",22-08-07,"40 - 1320",105,105,104,1,0,0.990476190476191
"2487",22-08-07,"40 - 1114",223,231,222,1,8,0.995515695067265
"2488",22-08-07,"53 - 1103",182,186,181,1,4,0.994505494505495
"2489",22-08-07,"2 - 1066",45,40,45,0,-5,1
"2490",22-08-07,"82 - 1163",141,178,114,27,37,0.808510638297872
"2491",22-08-08,"40 - 1320",105,105,104,1,0,0.990476190476191
"2492",22-08-08,"40 - 1114",223,231,223,0,8,1
"2493",22-08-08,"53 - 1103",181,186,181,0,5,1
"2494",22-08-08,"2 - 1066",45,40,45,0,-5,1
"2495",22-08-08,"82 - 1163",141,178,115,26,37,0.815602836879433
"2496",22-08-09,"40 - 1320",105,105,104,1,0,0.990476190476191
"2497",22-08-09,"40 - 1114",223,231,223,0,8,1
"2498",22-08-09,"53 - 1103",183,186,183,0,3,1
"2499",22-08-09,"2 - 1066",45,40,45,0,-5,1
"2500",22-08-09,"82 - 1163",140,178,116,24,38,0.828571428571429
"2501",22-08-10,"40 - 1320",105,105,105,0,0,1
"2502",22-08-10,"40 - 1114",223,231,223,0,8,1
"2503",22-08-10,"53 - 1103",183,186,183,0,3,1
"2504",22-08-10,"2 - 1066",45,40,45,0,-5,1
"2505",22-08-10,"82 - 1163",115,178,115,0,63,1
"2506",22-08-11,"40 - 1320",105,105,104,1,0,0.990476190476191
"2507",22-08-11,"40 - 1114",224,231,224,0,7,1
"2508",22-08-11,"53 - 1103",183,186,183,0,3,1
"2509",22-08-11,"2 - 1066",45,40,45,0,-5,1
"2510",22-08-11,"82 - 1163",124,178,122,2,54,0.983870967741935
"2511",22-08-12,"40 - 1320",105,105,105,0,0,1
"2512",22-08-12,"40 - 1114",225,231,224,1,6,0.995555555555556
"2513",22-08-12,"53 - 1103",185,186,184,1,1,0.994594594594595
"2514",22-08-12,"2 - 1066",46,40,46,0,-6,1
"2515",22-08-12,"82 - 1163",132,178,127,5,46,0.962121212121212
"2516",22-08-13,"40 - 1320",104,105,104,0,1,1
"2517",22-08-13,"40 - 1114",225,231,224,1,6,0.995555555555556
"2518",22-08-13,"53 - 1103",182,186,182,0,4,1
"2519",22-08-13,"2 - 1066",46,40,46,0,-6,1
"2520",22-08-13,"82 - 1163",128,178,125,3,50,0.9765625
"2521",22-08-14,"40 - 1320",105,105,105,0,0,1
"2522",22-08-14,"40 - 1114",225,231,223,2,6,0.991111111111111
"2523",22-08-14,"53 - 1103",179,186,179,0,7,1
"2524",22-08-14,"2 - 1066",46,40,46,0,-6,1
"2525",22-08-14,"82 - 1163",128,178,125,3,50,0.9765625
"2526",22-08-15,"40 - 1320",105,105,105,0,0,1
"2527",22-08-15,"40 - 1114",223,231,223,0,8,1
"2528",22-08-15,"53 - 1103",180,186,179,1,6,0.994444444444444
"2529",22-08-15,"2 - 1066",45,40,44,1,-5,0.977777777777778
"2530",22-08-15,"82 - 1163",129,178,119,10,49,0.922480620155039
"2531",22-08-16,"40 - 1320",105,105,105,0,0,1
"2532",22-08-16,"40 - 1114",223,231,223,0,8,1
"2533",22-08-16,"53 - 1103",185,186,185,0,1,1
"2534",22-08-16,"2 - 1066",45,40,45,0,-5,1
"2535",22-08-16,"82 - 1163",121,178,121,0,57,1
"2536",22-08-17,"40 - 1320",105,105,105,0,0,1
"2537",22-08-17,"40 - 1114",223,231,222,1,8,0.995515695067265
"2538",22-08-17,"53 - 1103",185,186,183,2,1,0.989189189189189
"2539",22-08-17,"2 - 1066",45,40,45,0,-5,1
"2540",22-08-17,"82 - 1163",121,178,121,0,57,1
"2541",22-08-18,"40 - 1320",105,105,105,0,0,1
"2542",22-08-18,"40 - 1114",222,231,222,0,9,1
"2543",22-08-18,"53 - 1103",182,186,182,0,4,1
"2544",22-08-18,"2 - 1066",45,40,45,0,-5,1
"2545",22-08-18,"82 - 1163",126,178,126,0,52,1
"2546",22-08-19,"40 - 1320",105,105,105,0,0,1
"2547",22-08-19,"40 - 1114",225,231,225,0,6,1
"2548",22-08-19,"53 - 1103",182,186,181,1,4,0.994505494505495
"2549",22-08-19,"2 - 1066",44,40,44,0,-4,1
"2550",22-08-19,"82 - 1163",124,178,124,0,54,1
"2551",22-08-20,"40 - 1320",105,105,104,1,0,0.990476190476191
"2552",22-08-20,"40 - 1114",225,231,225,0,6,1
"2553",22-08-20,"53 - 1103",183,186,182,1,3,0.994535519125683
"2554",22-08-20,"2 - 1066",45,40,44,1,-5,0.977777777777778
"2555",22-08-20,"82 - 1163",124,178,124,0,54,1
"2556",22-08-21,"40 - 1320",105,105,104,1,0,0.990476190476191
"2557",22-08-21,"40 - 1114",224,231,224,0,7,1
"2558",22-08-21,"53 - 1103",182,186,181,1,4,0.994505494505495
"2559",22-08-21,"2 - 1066",45,40,44,1,-5,0.977777777777778
"2560",22-08-21,"82 - 1163",122,178,122,0,56,1
"2561",22-08-22,"40 - 1320",105,105,105,0,0,1
"2562",22-08-22,"40 - 1114",224,231,224,0,7,1
"2563",22-08-22,"53 - 1103",183,186,179,4,3,0.978142076502732
"2564",22-08-22,"2 - 1066",45,40,44,1,-5,0.977777777777778
"2565",22-08-22,"82 - 1163",118,178,118,0,60,1
"2566",22-08-23,"40 - 1320",105,105,105,0,0,1
"2567",22-08-23,"40 - 1114",224,231,224,0,7,1
"2568",22-08-23,"53 - 1103",181,186,180,1,5,0.994475138121547
"2569",22-08-23,"2 - 1066",45,40,44,1,-5,0.977777777777778
"2570",22-08-23,"82 - 1163",117,178,117,0,61,1
"2571",22-08-24,"40 - 1320",105,105,105,0,0,1
"2572",22-08-24,"40 - 1114",226,231,226,0,5,1
"2573",22-08-24,"53 - 1103",183,186,182,1,3,0.994535519125683
"2574",22-08-24,"2 - 1066",44,40,44,0,-4,1
"2575",22-08-24,"82 - 1163",114,178,114,0,64,1
"2576",22-08-25,"40 - 1320",105,105,105,0,0,1
"2577",22-08-25,"40 - 1114",226,231,226,0,5,1
"2578",22-08-25,"53 - 1103",185,186,184,1,1,0.994594594594595
"2579",22-08-25,"2 - 1066",44,40,44,0,-4,1
"2580",22-08-25,"82 - 1163",114,178,114,0,64,1
"2581",22-08-26,"40 - 1320",105,105,105,0,0,1
"2582",22-08-26,"40 - 1114",228,231,228,0,3,1
"2583",22-08-26,"53 - 1103",185,186,185,0,1,1
"2584",22-08-26,"2 - 1066",43,40,43,0,-3,1
"2585",22-08-26,"82 - 1163",112,178,112,0,66,1
"2586",22-08-27,"40 - 1320",105,105,105,0,0,1
"2587",22-08-27,"40 - 1114",228,231,228,0,3,1
"2588",22-08-27,"53 - 1103",185,186,185,0,1,1
"2589",22-08-27,"2 - 1066",43,40,43,0,-3,1
"2590",22-08-27,"82 - 1163",108,178,108,0,70,1
"2591",22-08-28,"40 - 1320",105,105,105,0,0,1
"2592",22-08-28,"40 - 1114",228,231,228,0,3,1
"2593",22-08-28,"53 - 1103",184,186,184,0,2,1
"2594",22-08-28,"2 - 1066",43,40,43,0,-3,1
"2595",22-08-28,"82 - 1163",105,178,105,0,73,1
"2596",22-08-29,"40 - 1320",105,105,105,0,0,1
"2597",22-08-29,"40 - 1114",227,231,227,0,4,1
"2598",22-08-29,"53 - 1103",183,186,182,1,3,0.994535519125683
"2599",22-08-29,"2 - 1066",44,40,44,0,-4,1
"2600",22-08-29,"82 - 1163",104,178,104,0,74,1
"2601",22-08-30,"40 - 1320",104,105,104,0,1,1
"2602",22-08-30,"40 - 1114",228,231,228,0,3,1
"2603",22-08-30,"53 - 1103",183,186,182,1,3,0.994535519125683
"2604",22-08-30,"2 - 1066",44,40,44,0,-4,1
"2605",22-08-30,"82 - 1163",111,178,111,0,67,1
"2606",22-08-31,"40 - 1320",105,105,104,1,0,0.990476190476191
"2607",22-08-31,"40 - 1114",227,231,227,0,4,1
"2608",22-08-31,"53 - 1103",183,186,183,0,3,1
"2609",22-08-31,"2 - 1066",44,40,44,0,-4,1
"2610",22-08-31,"82 - 1163",113,178,113,0,65,1
"2611",22-09-01,"40 - 1320",105,105,102,3,0,0.971428571428571
"2612",22-09-01,"40 - 1114",225,231,225,0,6,1
"2613",22-09-01,"53 - 1103",180,186,180,0,6,1
"2614",22-09-01,"2 - 1066",42,40,42,0,-2,1
"2615",22-09-01,"82 - 1163",114,178,113,1,64,0.991228070175439
"2616",22-09-02,"40 - 1320",105,105,104,1,0,0.990476190476191
"2617",22-09-02,"40 - 1114",227,231,225,2,4,0.991189427312775
"2618",22-09-02,"53 - 1103",181,186,181,0,5,1
"2619",22-09-02,"2 - 1066",40,40,40,0,0,1
"2620",22-09-02,"82 - 1163",115,178,115,0,63,1
"2621",22-09-03,"40 - 1320",105,105,105,0,0,1
"2622",22-09-03,"40 - 1114",227,231,227,0,4,1
"2623",22-09-03,"53 - 1103",181,186,180,1,5,0.994475138121547
"2624",22-09-03,"2 - 1066",40,40,40,0,0,1
"2625",22-09-03,"82 - 1163",115,178,115,0,63,1
"2626",22-09-04,"40 - 1320",105,105,105,0,0,1
"2627",22-09-04,"40 - 1114",226,231,225,1,5,0.995575221238938
"2628",22-09-04,"53 - 1103",182,186,180,2,4,0.989010989010989
"2629",22-09-04,"2 - 1066",40,40,40,0,0,1
"2630",22-09-04,"82 - 1163",114,178,114,0,64,1
"2631",22-09-05,"40 - 1320",105,105,105,0,0,1
"2632",22-09-05,"40 - 1114",226,231,226,0,5,1
"2633",22-09-05,"53 - 1103",183,186,183,0,3,1
"2634",22-09-05,"2 - 1066",40,40,40,0,0,1
"2635",22-09-05,"82 - 1163",112,178,112,0,66,1
"2636",22-09-06,"40 - 1320",105,105,105,0,0,1
"2637",22-09-06,"40 - 1114",225,231,225,0,6,1
"2638",22-09-06,"53 - 1103",183,186,183,0,3,1
"2639",22-09-06,"2 - 1066",40,40,40,0,0,1
"2640",22-09-06,"82 - 1163",110,178,110,0,68,1
"2641",22-09-07,"40 - 1320",105,105,105,0,0,1
"2642",22-09-07,"40 - 1114",224,231,224,0,7,1
"2643",22-09-07,"53 - 1103",182,186,181,1,4,0.994505494505495
"2644",22-09-07,"2 - 1066",40,40,40,0,0,1
"2645",22-09-07,"82 - 1163",110,178,110,0,68,1
"2646",22-09-08,"40 - 1320",105,105,105,0,0,1
"2647",22-09-08,"40 - 1114",224,231,224,0,7,1
"2648",22-09-08,"53 - 1103",182,186,182,0,4,1
"2649",22-09-08,"2 - 1066",39,40,39,0,1,1
"2650",22-09-08,"82 - 1163",109,178,109,0,69,1
"2651",22-09-09,"40 - 1320",105,105,105,0,0,1
"2652",22-09-09,"40 - 1114",225,231,225,0,6,1
"2653",22-09-09,"53 - 1103",183,186,180,3,3,0.983606557377049
"2654",22-09-09,"2 - 1066",37,40,37,0,3,1
"2655",22-09-09,"82 - 1163",105,178,105,0,73,1
"2656",22-09-10,"40 - 1320",105,105,105,0,0,1
"2657",22-09-10,"40 - 1114",227,231,227,0,4,1
"2658",22-09-10,"53 - 1103",183,186,180,3,3,0.983606557377049
"2659",22-09-10,"2 - 1066",36,40,36,0,4,1
"2660",22-09-10,"82 - 1163",105,178,105,0,73,1
"2661",22-09-11,"40 - 1320",105,105,105,0,0,1
"2662",22-09-11,"40 - 1114",227,231,227,0,4,1
"2663",22-09-11,"53 - 1103",183,186,182,1,3,0.994535519125683
"2664",22-09-11,"2 - 1066",36,40,36,0,4,1
"2665",22-09-11,"82 - 1163",105,178,105,0,73,1
"2666",22-09-12,"40 - 1320",105,105,105,0,0,1
"2667",22-09-12,"40 - 1114",227,231,227,0,4,1
"2668",22-09-12,"53 - 1103",183,186,182,1,3,0.994535519125683
"2669",22-09-12,"2 - 1066",36,40,36,0,4,1
"2670",22-09-12,"82 - 1163",105,178,105,0,73,1
"2671",22-09-13,"40 - 1320",105,105,104,1,0,0.990476190476191
"2672",22-09-13,"40 - 1114",226,231,225,1,5,0.995575221238938
"2673",22-09-13,"53 - 1103",182,186,181,1,4,0.994505494505495
"2674",22-09-13,"2 - 1066",36,40,36,0,4,1
"2675",22-09-13,"82 - 1163",104,178,104,0,74,1
"2676",22-09-14,"40 - 1320",105,105,105,0,0,1
"2677",22-09-14,"40 - 1114",226,231,226,0,5,1
"2678",22-09-14,"53 - 1103",185,186,184,1,1,0.994594594594595
"2679",22-09-14,"2 - 1066",36,40,36,0,4,1
"2680",22-09-14,"82 - 1163",104,178,104,0,74,1
"2681",22-09-15,"40 - 1320",105,105,105,0,0,1
"2682",22-09-15,"40 - 1114",224,231,224,0,7,1
"2683",22-09-15,"53 - 1103",185,186,185,0,1,1
"2684",22-09-15,"2 - 1066",38,40,38,0,2,1
"2685",22-09-15,"82 - 1163",106,178,106,0,72,1
"2686",22-09-16,"40 - 1320",105,105,105,0,0,1
"2687",22-09-16,"40 - 1114",225,231,225,0,6,1
"2688",22-09-16,"53 - 1103",185,186,183,2,1,0.989189189189189
"2689",22-09-16,"2 - 1066",39,40,39,0,1,1
"2690",22-09-16,"82 - 1163",108,178,108,0,70,1
"2691",22-09-17,"40 - 1320",105,105,105,0,0,1
"2692",22-09-17,"40 - 1114",226,231,226,0,5,1
"2693",22-09-17,"53 - 1103",185,186,183,2,1,0.989189189189189
"2694",22-09-17,"2 - 1066",38,40,38,0,2,1
"2695",22-09-17,"82 - 1163",107,178,107,0,71,1
"2696",22-09-18,"40 - 1320",105,105,105,0,0,1
"2697",22-09-18,"40 - 1114",227,231,227,0,4,1
"2698",22-09-18,"53 - 1103",185,186,184,1,1,0.994594594594595
"2699",22-09-18,"2 - 1066",39,40,39,0,1,1
"2700",22-09-18,"82 - 1163",107,178,107,0,71,1
"2701",22-09-19,"40 - 1320",105,105,105,0,0,1
"2702",22-09-19,"40 - 1114",229,231,229,0,2,1
"2703",22-09-19,"53 - 1103",185,186,184,1,1,0.994594594594595
"2704",22-09-19,"2 - 1066",39,40,39,0,1,1
"2705",22-09-19,"82 - 1163",107,178,107,0,71,1
"2706",22-09-20,"40 - 1320",105,105,105,0,0,1
"2707",22-09-20,"40 - 1114",229,231,228,1,2,0.995633187772926
"2708",22-09-20,"53 - 1103",184,186,184,0,2,1
"2709",22-09-20,"2 - 1066",40,40,40,0,0,1
"2710",22-09-20,"82 - 1163",108,178,107,1,70,0.990740740740741
"2711",22-09-21,"40 - 1320",105,105,105,0,0,1
"2712",22-09-21,"40 - 1114",230,231,230,0,1,1
"2713",22-09-21,"53 - 1103",184,186,183,1,2,0.994565217391304
"2714",22-09-21,"2 - 1066",40,40,40,0,0,1
"2715",22-09-21,"82 - 1163",120,178,111,9,58,0.925
"2716",22-09-22,"40 - 1320",105,105,105,0,0,1
"2717",22-09-22,"40 - 1114",230,231,230,0,1,1
"2718",22-09-22,"53 - 1103",185,186,185,0,1,1
"2719",22-09-22,"2 - 1066",42,40,42,0,-2,1
"2720",22-09-22,"82 - 1163",118,178,118,0,60,1
"2721",22-09-23,"40 - 1320",105,105,104,1,0,0.990476190476191
"2722",22-09-23,"40 - 1114",231,231,230,1,0,0.995670995670996
"2723",22-09-23,"53 - 1103",186,186,186,0,0,1
"2724",22-09-23,"2 - 1066",42,40,42,0,-2,1
"2725",22-09-23,"82 - 1163",119,178,119,0,59,1
"2726",22-09-24,"40 - 1320",105,105,104,1,0,0.990476190476191
"2727",22-09-24,"40 - 1114",230,231,229,1,1,0.995652173913044
"2728",22-09-24,"53 - 1103",185,186,185,0,1,1
"2729",22-09-24,"2 - 1066",42,40,42,0,-2,1
"2730",22-09-24,"82 - 1163",118,148,118,0,30,1
"2731",22-09-25,"40 - 1320",105,105,104,1,0,0.990476190476191
"2732",22-09-25,"40 - 1114",230,231,229,1,1,0.995652173913044
"2733",22-09-25,"53 - 1103",183,186,183,0,3,1
"2734",22-09-25,"2 - 1066",42,40,42,0,-2,1
"2735",22-09-25,"82 - 1163",117,148,117,0,31,1
"2736",22-09-26,"40 - 1320",105,105,104,1,0,0.990476190476191
"2737",22-09-26,"40 - 1114",230,231,230,0,1,1
"2738",22-09-26,"53 - 1103",184,186,184,0,2,1
"2739",22-09-26,"2 - 1066",42,40,42,0,-2,1
"2740",22-09-26,"82 - 1163",116,148,116,0,32,1
"2741",22-09-27,"40 - 1320",105,105,104,1,0,0.990476190476191
"2742",22-09-27,"40 - 1114",230,231,230,0,1,1
"2743",22-09-27,"53 - 1103",181,186,181,0,5,1
"2744",22-09-27,"2 - 1066",43,40,43,0,-3,1
"2745",22-09-27,"82 - 1163",118,148,118,0,30,1
"2746",22-09-28,"40 - 1320",105,105,104,1,0,0.990476190476191
"2747",22-09-28,"40 - 1114",230,231,230,0,1,1
"2748",22-09-28,"53 - 1103",185,186,184,1,1,0.994594594594595
"2749",22-09-28,"2 - 1066",45,40,45,0,-5,1
"2750",22-09-28,"82 - 1163",119,178,119,0,59,1
"2751",22-09-29,"40 - 1320",105,105,104,1,0,0.990476190476191
"2752",22-09-29,"40 - 1114",231,231,231,0,0,1
"2753",22-09-29,"53 - 1103",185,186,184,1,1,0.994594594594595
"2754",22-09-29,"2 - 1066",45,40,45,0,-5,1
"2755",22-09-29,"82 - 1163",119,178,119,0,59,1
"2756",22-09-30,"40 - 1320",105,105,104,1,0,0.990476190476191
"2757",22-09-30,"40 - 1114",230,231,230,0,1,1
"2758",22-09-30,"53 - 1103",186,186,185,1,0,0.994623655913978
"2759",22-09-30,"2 - 1066",45,40,45,0,-5,1
"2760",22-09-30,"82 - 1163",120,178,120,0,58,1
"2761",22-10-01,"40 - 1320",103,105,103,0,2,1
"2762",22-10-01,"40 - 1114",228,231,228,0,3,1
"2763",22-10-01,"53 - 1103",186,186,185,1,0,0.994623655913978
"2764",22-10-01,"2 - 1066",44,40,44,0,-4,1
"2765",22-10-01,"82 - 1163",120,178,120,0,58,1
"2766",22-10-02,"40 - 1320",104,105,104,0,1,1
"2767",22-10-02,"40 - 1114",226,231,226,0,5,1
"2768",22-10-02,"53 - 1103",186,186,183,3,0,0.983870967741935
"2769",22-10-02,"2 - 1066",44,40,44,0,-4,1
"2770",22-10-02,"82 - 1163",118,178,118,0,60,1
"2771",22-10-03,"40 - 1320",104,105,104,0,1,1
"2772",22-10-03,"40 - 1114",226,231,226,0,5,1
"2773",22-10-03,"53 - 1103",185,186,185,0,1,1
"2774",22-10-03,"2 - 1066",43,40,43,0,-3,1
"2775",22-10-03,"82 - 1163",116,178,116,0,62,1
"2776",22-10-04,"40 - 1320",104,105,104,0,1,1
"2777",22-10-04,"40 - 1114",228,231,228,0,3,1
"2778",22-10-04,"53 - 1103",185,186,183,2,1,0.989189189189189
"2779",22-10-04,"2 - 1066",44,40,44,0,-4,1
"2780",22-10-04,"82 - 1163",114,178,114,0,64,1
"2781",22-10-05,"40 - 1320",104,105,104,0,1,1
"2782",22-10-05,"40 - 1114",224,231,224,0,7,1
"2783",22-10-05,"53 - 1103",183,186,182,1,3,0.994535519125683
"2784",22-10-05,"2 - 1066",46,40,45,1,-6,0.978260869565217
"2785",22-10-05,"82 - 1163",116,178,115,1,62,0.991379310344828
"2786",22-10-06,"40 - 1320",104,105,104,0,1,1
"2787",22-10-06,"40 - 1114",224,231,223,1,7,0.995535714285714
"2788",22-10-06,"53 - 1103",182,186,182,0,4,1
"2789",22-10-06,"2 - 1066",46,40,46,0,-6,1
"2790",22-10-06,"82 - 1163",114,178,114,0,64,1
"2791",22-10-07,"40 - 1320",104,105,104,0,1,1
"2792",22-10-07,"40 - 1114",223,231,223,0,8,1
"2793",22-10-07,"53 - 1103",185,186,185,0,1,1
"2794",22-10-07,"2 - 1066",46,40,46,0,-6,1
"2795",22-10-07,"82 - 1163",118,178,118,0,60,1
"2796",22-10-08,"40 - 1320",104,105,104,0,1,1
"2797",22-10-08,"40 - 1114",221,231,221,0,10,1
"2798",22-10-08,"53 - 1103",185,186,185,0,1,1
"2799",22-10-08,"2 - 1066",46,40,46,0,-6,1
"2800",22-10-08,"82 - 1163",119,178,119,0,59,1
"2801",22-10-09,"40 - 1320",104,105,104,0,1,1
"2802",22-10-09,"40 - 1114",221,231,221,0,10,1
"2803",22-10-09,"53 - 1103",184,186,184,0,2,1
"2804",22-10-09,"2 - 1066",46,40,46,0,-6,1
"2805",22-10-09,"82 - 1163",117,178,116,1,61,0.991452991452991
"2806",22-10-10,"40 - 1320",104,105,104,0,1,1
"2807",22-10-10,"40 - 1114",221,231,221,0,10,1
"2808",22-10-10,"53 - 1103",183,186,183,0,3,1
"2809",22-10-10,"2 - 1066",46,40,46,0,-6,1
"2810",22-10-10,"82 - 1163",116,178,116,0,62,1
"2811",22-10-11,"40 - 1320",104,105,103,1,1,0.990384615384615
"2812",22-10-11,"40 - 1114",221,231,219,2,10,0.990950226244344
"2813",22-10-11,"53 - 1103",186,186,184,2,0,0.989247311827957
"2814",22-10-11,"2 - 1066",46,40,46,0,-6,1
"2815",22-10-11,"82 - 1163",112,148,112,0,36,1
"2816",22-10-12,"40 - 1320",105,105,104,1,0,0.990476190476191
"2817",22-10-12,"40 - 1114",221,231,220,1,10,0.995475113122172
"2818",22-10-12,"53 - 1103",186,186,185,1,0,0.994623655913978
"2819",22-10-12,"2 - 1066",46,40,46,0,-6,1
"2820",22-10-12,"82 - 1163",114,148,114,0,34,1
"2821",22-10-13,"40 - 1320",103,105,102,1,2,0.990291262135922
"2822",22-10-13,"40 - 1114",221,231,218,3,10,0.986425339366516
"2823",22-10-13,"53 - 1103",186,186,186,0,0,1
"2824",22-10-13,"2 - 1066",47,40,47,0,-7,1
"2825",22-10-13,"82 - 1163",117,148,117,0,31,1
"2826",22-10-14,"40 - 1320",103,105,103,0,2,1
"2827",22-10-14,"40 - 1114",219,231,219,0,12,1
"2828",22-10-14,"53 - 1103",185,186,185,0,1,1
"2829",22-10-14,"2 - 1066",47,40,47,0,-7,1
"2830",22-10-14,"82 - 1163",119,148,119,0,29,1
"2831",22-10-15,"40 - 1320",103,105,103,0,2,1
"2832",22-10-15,"40 - 1114",220,231,220,0,11,1
"2833",22-10-15,"53 - 1103",185,186,185,0,1,1
"2834",22-10-15,"2 - 1066",47,40,47,0,-7,1
"2835",22-10-15,"82 - 1163",120,148,120,0,28,1
"2836",22-10-16,"40 - 1320",103,105,103,0,2,1
"2837",22-10-16,"40 - 1114",219,231,219,0,12,1
"2838",22-10-16,"53 - 1103",185,186,185,0,1,1
"2839",22-10-16,"2 - 1066",47,40,47,0,-7,1
"2840",22-10-16,"82 - 1163",120,148,120,0,28,1
"2841",22-10-17,"40 - 1320",104,105,104,0,1,1
"2842",22-10-17,"40 - 1114",219,231,219,0,12,1
"2843",22-10-17,"53 - 1103",184,186,183,1,2,0.994565217391304
"2844",22-10-17,"2 - 1066",46,40,46,0,-6,1
"2845",22-10-17,"82 - 1163",119,148,119,0,29,1
"2846",22-10-18,"40 - 1320",104,105,104,0,1,1
"2847",22-10-18,"40 - 1114",219,231,219,0,12,1
"2848",22-10-18,"53 - 1103",185,186,185,0,1,1
"2849",22-10-18,"2 - 1066",46,40,46,0,-6,1
"2850",22-10-18,"82 - 1163",119,148,119,0,29,1
"2851",22-10-19,"40 - 1320",104,105,104,0,1,1
"2852",22-10-19,"40 - 1114",219,231,219,0,12,1
"2853",22-10-19,"53 - 1103",185,186,184,1,1,0.994594594594595
"2854",22-10-19,"2 - 1066",46,40,46,0,-6,1
"2855",22-10-19,"82 - 1163",120,178,120,0,58,1
"2856",22-10-20,"40 - 1320",103,105,103,0,2,1
"2857",22-10-20,"40 - 1114",219,231,219,0,12,1
"2858",22-10-20,"53 - 1103",184,186,183,1,2,0.994565217391304
"2859",22-10-20,"2 - 1066",46,40,46,0,-6,1
"2860",22-10-20,"82 - 1163",120,178,120,0,58,1
"2861",22-10-21,"40 - 1320",104,105,104,0,1,1
"2862",22-10-21,"40 - 1114",221,231,220,1,10,0.995475113122172
"2863",22-10-21,"53 - 1103",185,186,184,1,1,0.994594594594595
"2864",22-10-21,"2 - 1066",44,40,44,0,-4,1
"2865",22-10-21,"82 - 1163",118,148,118,0,30,1
"2866",22-10-22,"40 - 1320",105,105,105,0,0,1
"2867",22-10-22,"40 - 1114",222,231,222,0,9,1
"2868",22-10-22,"53 - 1103",186,186,185,1,0,0.994623655913978
"2869",22-10-22,"2 - 1066",46,40,46,0,-6,1
"2870",22-10-22,"82 - 1163",119,148,118,1,29,0.991596638655462
"2871",22-10-23,"40 - 1320",105,105,105,0,0,1
"2872",22-10-23,"40 - 1114",222,231,222,0,9,1
"2873",22-10-23,"53 - 1103",186,186,185,1,0,0.994623655913978
"2874",22-10-23,"2 - 1066",47,40,47,0,-7,1
"2875",22-10-23,"82 - 1163",118,148,118,0,30,1
"2876",22-10-24,"40 - 1320",105,105,105,0,0,1
"2877",22-10-24,"40 - 1114",218,231,218,0,13,1
"2878",22-10-24,"53 - 1103",186,186,185,1,0,0.994623655913978
"2879",22-10-24,"2 - 1066",47,40,47,0,-7,1
"2880",22-10-24,"82 - 1163",114,148,114,0,34,1
"2881",22-10-25,"40 - 1320",104,105,104,0,1,1
"2882",22-10-25,"40 - 1114",219,230,219,0,11,1
"2883",22-10-25,"53 - 1103",186,186,185,1,0,0.994623655913978
"2884",22-10-25,"2 - 1066",47,40,47,0,-7,1
"2885",22-10-25,"82 - 1163",112,148,112,0,36,1
"2886",22-10-26,"40 - 1320",104,105,103,1,1,0.990384615384615
"2887",22-10-26,"40 - 1114",222,230,222,0,8,1
"2888",22-10-26,"53 - 1103",184,186,183,1,2,0.994565217391304
"2889",22-10-26,"2 - 1066",48,40,48,0,-8,1
"2890",22-10-26,"82 - 1163",115,148,114,1,33,0.991304347826087
"2891",22-10-27,"40 - 1320",104,105,103,1,1,0.990384615384615
"2892",22-10-27,"40 - 1114",224,231,224,0,7,1
"2893",22-10-27,"53 - 1103",184,186,181,3,2,0.983695652173913
"2894",22-10-27,"2 - 1066",48,40,48,0,-8,1
"2895",22-10-27,"82 - 1163",115,148,115,0,33,1
"2896",22-10-28,"40 - 1320",104,105,104,0,1,1
"2897",22-10-28,"40 - 1114",224,231,222,2,7,0.991071428571429
"2898",22-10-28,"53 - 1103",184,186,183,1,2,0.994565217391304
"2899",22-10-28,"2 - 1066",48,40,48,0,-8,1
"2900",22-10-28,"82 - 1163",115,148,115,0,33,1
"2901",22-10-29,"40 - 1320",104,105,104,0,1,1
"2902",22-10-29,"40 - 1114",224,231,224,0,7,1
"2903",22-10-29,"53 - 1103",184,186,183,1,2,0.994565217391304
"2904",22-10-29,"2 - 1066",47,40,47,0,-7,1
"2905",22-10-29,"82 - 1163",114,148,114,0,34,1
"2906",22-10-30,"40 - 1320",105,105,105,0,0,1
"2907",22-10-30,"40 - 1114",224,231,224,0,7,1
"2908",22-10-30,"53 - 1103",185,186,184,1,1,0.994594594594595
"2909",22-10-30,"2 - 1066",47,40,47,0,-7,1
"2910",22-10-30,"82 - 1163",115,148,115,0,33,1
"2911",22-10-31,"40 - 1320",105,105,105,0,0,1
"2912",22-10-31,"40 - 1114",224,231,223,1,7,0.995535714285714
"2913",22-10-31,"53 - 1103",184,186,182,2,2,0.989130434782609
"2914",22-10-31,"2 - 1066",48,40,48,0,-8,1
"2915",22-10-31,"82 - 1163",115,148,115,0,33,1
"2916",22-11-01,"40 - 1320",104,105,104,0,1,1
"2917",22-11-01,"40 - 1114",222,231,222,0,9,1
"2918",22-11-01,"53 - 1103",185,186,184,1,1,0.994594594594595
"2919",22-11-01,"2 - 1066",48,40,48,0,-8,1
"2920",22-11-01,"82 - 1163",118,148,116,2,30,0.983050847457627
"2921",22-11-02,"40 - 1320",104,105,104,0,1,1
"2922",22-11-02,"40 - 1114",224,231,224,0,7,1
"2923",22-11-02,"53 - 1103",186,186,186,0,0,1
"2924",22-11-02,"2 - 1066",46,40,46,0,-6,1
"2925",22-11-02,"82 - 1163",120,148,120,0,28,1
"2926",22-11-03,"40 - 1320",104,105,104,0,1,1
"2927",22-11-03,"40 - 1114",222,231,221,1,9,0.995495495495496
"2928",22-11-03,"53 - 1103",185,186,185,0,1,1
"2929",22-11-03,"2 - 1066",47,40,47,0,-7,1
"2930",22-11-03,"82 - 1163",126,148,126,0,22,1
"2931",22-11-04,"40 - 1320",105,105,105,0,0,1
"2932",22-11-04,"40 - 1114",219,231,219,0,12,1
"2933",22-11-04,"53 - 1103",185,186,185,0,1,1
"2934",22-11-04,"2 - 1066",46,40,46,0,-6,1
"2935",22-11-04,"82 - 1163",126,148,126,0,22,1
"2936",22-11-05,"40 - 1320",105,105,105,0,0,1
"2937",22-11-05,"40 - 1114",219,231,219,0,12,1
"2938",22-11-05,"53 - 1103",186,186,185,1,0,0.994623655913978
"2939",22-11-05,"2 - 1066",46,40,46,0,-6,1
"2940",22-11-05,"82 - 1163",124,148,124,0,24,1
"2941",22-11-06,"40 - 1320",104,105,104,0,1,1
"2942",22-11-06,"40 - 1114",219,231,218,1,12,0.995433789954338
"2943",22-11-06,"53 - 1103",185,186,182,3,1,0.983783783783784
"2944",22-11-06,"2 - 1066",46,40,46,0,-6,1
"2945",22-11-06,"82 - 1163",124,148,124,0,24,1
"2946",22-11-07,"40 - 1320",105,105,105,0,0,1
"2947",22-11-07,"40 - 1114",219,231,219,0,12,1
"2948",22-11-07,"53 - 1103",185,186,183,2,1,0.989189189189189
"2949",22-11-07,"2 - 1066",47,40,47,0,-7,1
"2950",22-11-07,"82 - 1163",124,148,124,0,24,1
"2951",22-11-08,"40 - 1320",105,105,105,0,0,1
"2952",22-11-08,"40 - 1114",222,231,222,0,9,1
"2953",22-11-08,"53 - 1103",185,186,183,2,1,0.989189189189189
"2954",22-11-08,"2 - 1066",47,40,47,0,-7,1
"2955",22-11-08,"82 - 1163",123,148,123,0,25,1
"2956",22-11-09,"40 - 1320",105,105,105,0,0,1
"2957",22-11-09,"40 - 1114",220,231,220,0,11,1
"2958",22-11-09,"53 - 1103",186,186,185,1,0,0.994623655913978
"2959",22-11-09,"2 - 1066",47,40,47,0,-7,1
"2960",22-11-09,"82 - 1163",125,178,125,0,53,1
"2961",22-11-10,"40 - 1320",104,105,104,0,1,1
"2962",22-11-10,"40 - 1114",223,231,222,1,8,0.995515695067265
"2963",22-11-10,"53 - 1103",185,186,185,0,1,1
"2964",22-11-10,"2 - 1066",47,40,47,0,-7,1
"2965",22-11-10,"82 - 1163",126,178,126,0,52,1
"2966",22-11-11,"40 - 1320",104,105,104,0,1,1
"2967",22-11-11,"40 - 1114",225,231,223,2,6,0.991111111111111
"2968",22-11-11,"53 - 1103",186,186,186,0,0,1
"2969",22-11-11,"2 - 1066",47,40,47,0,-7,1
"2970",22-11-11,"82 - 1163",125,178,125,0,53,1
"2971",22-11-12,"40 - 1320",104,105,104,0,1,1
"2972",22-11-12,"40 - 1114",225,231,223,2,6,0.991111111111111
"2973",22-11-12,"53 - 1103",185,186,185,0,1,1
"2974",22-11-12,"2 - 1066",47,40,47,0,-7,1
"2975",22-11-12,"82 - 1163",126,178,126,0,52,1
"2976",22-11-13,"40 - 1320",105,105,104,1,0,0.990476190476191
"2977",22-11-13,"40 - 1114",222,231,222,0,9,1
"2978",22-11-13,"53 - 1103",185,186,183,2,1,0.989189189189189
"2979",22-11-13,"2 - 1066",47,40,47,0,-7,1
"2980",22-11-13,"82 - 1163",123,178,123,0,55,1
"2981",22-11-14,"40 - 1320",105,105,105,0,0,1
"2982",22-11-14,"40 - 1114",223,231,223,0,8,1
"2983",22-11-14,"53 - 1103",185,186,185,0,1,1
"2984",22-11-14,"2 - 1066",47,40,47,0,-7,1
"2985",22-11-14,"82 - 1163",119,178,119,0,59,1
"2986",22-11-15,"40 - 1320",105,105,105,0,0,1
"2987",22-11-15,"40 - 1114",223,231,223,0,8,1
"2988",22-11-15,"53 - 1103",185,186,184,1,1,0.994594594594595
"2989",22-11-15,"2 - 1066",47,40,47,0,-7,1
"2990",22-11-15,"82 - 1163",117,178,117,0,61,1
"2991",22-11-16,"40 - 1320",105,105,105,0,0,1
"2992",22-11-16,"40 - 1114",225,231,223,2,6,0.991111111111111
"2993",22-11-16,"53 - 1103",185,186,184,1,1,0.994594594594595
"2994",22-11-16,"2 - 1066",47,40,47,0,-7,1
"2995",22-11-16,"82 - 1163",118,178,118,0,60,1
"2996",22-11-17,"40 - 1320",105,105,105,0,0,1
"2997",22-11-17,"40 - 1114",225,231,224,1,6,0.995555555555556
"2998",22-11-17,"53 - 1103",186,186,185,1,0,0.994623655913978
"2999",22-11-17,"2 - 1066",47,40,47,0,-7,1
"3000",22-11-17,"82 - 1163",117,178,116,1,61,0.991452991452991
"3001",22-11-18,"40 - 1320",105,105,105,0,0,1
"3002",22-11-18,"40 - 1114",224,231,224,0,7,1
"3003",22-11-18,"53 - 1103",185,186,184,1,1,0.994594594594595
"3004",22-11-18,"2 - 1066",47,40,47,0,-7,1
"3005",22-11-18,"82 - 1163",116,178,116,0,62,1
"3006",22-11-19,"40 - 1320",105,105,105,0,0,1
"3007",22-11-19,"40 - 1114",226,231,225,1,5,0.995575221238938
"3008",22-11-19,"53 - 1103",184,186,183,1,2,0.994565217391304
"3009",22-11-19,"2 - 1066",47,40,47,0,-7,1
"3010",22-11-19,"82 - 1163",114,178,114,0,64,1
"3011",22-11-20,"40 - 1320",105,105,105,0,0,1
"3012",22-11-20,"40 - 1114",226,231,226,0,5,1
"3013",22-11-20,"53 - 1103",183,186,183,0,3,1
"3014",22-11-20,"2 - 1066",47,40,47,0,-7,1
"3015",22-11-20,"82 - 1163",115,178,114,1,63,0.991304347826087
"3016",22-11-21,"40 - 1320",109,118,109,0,9,1
"3017",22-11-21,"40 - 1114",224,231,224,0,7,1
"3018",22-11-21,"53 - 1103",183,186,183,0,3,1
"3019",22-11-21,"2 - 1066",47,40,47,0,-7,1
"3020",22-11-21,"82 - 1163",118,178,118,0,60,1
"3021",22-11-22,"40 - 1320",110,118,110,0,8,1
"3022",22-11-22,"40 - 1114",223,231,223,0,8,1
"3023",22-11-22,"53 - 1103",182,186,182,0,4,1
"3024",22-11-22,"2 - 1066",46,40,46,0,-6,1
"3025",22-11-22,"82 - 1163",118,178,118,0,60,1
"3026",22-11-23,"40 - 1320",114,118,114,0,4,1
"3027",22-11-23,"40 - 1114",223,231,221,2,8,0.991031390134529
"3028",22-11-23,"53 - 1103",184,186,183,1,2,0.994565217391304
"3029",22-11-23,"2 - 1066",46,40,46,0,-6,1
"3030",22-11-23,"82 - 1163",120,178,120,0,58,1
"3031",22-11-24,"40 - 1320",118,118,118,0,0,1
"3032",22-11-24,"40 - 1114",224,231,223,1,7,0.995535714285714
"3033",22-11-24,"53 - 1103",182,186,181,1,4,0.994505494505495
"3034",22-11-24,"2 - 1066",46,40,46,0,-6,1
"3035",22-11-24,"82 - 1163",118,178,118,0,60,1
"3036",22-11-25,"40 - 1320",121,130,121,0,9,1
"3037",22-11-25,"40 - 1114",225,231,225,0,6,1
"3038",22-11-25,"53 - 1103",184,186,182,2,2,0.989130434782609
"3039",22-11-25,"2 - 1066",46,40,46,0,-6,1
"3040",22-11-25,"82 - 1163",117,178,117,0,61,1
"3041",22-11-26,"40 - 1320",121,130,121,0,9,1
"3042",22-11-26,"40 - 1114",226,231,225,1,5,0.995575221238938
"3043",22-11-26,"53 - 1103",185,186,182,3,1,0.983783783783784
"3044",22-11-26,"2 - 1066",46,40,46,0,-6,1
"3045",22-11-26,"82 - 1163",115,178,115,0,63,1
"3046",22-11-27,"40 - 1320",122,130,122,0,8,1
"3047",22-11-27,"40 - 1114",225,231,223,2,6,0.991111111111111
"3048",22-11-27,"53 - 1103",184,186,182,2,2,0.989130434782609
"3049",22-11-27,"2 - 1066",46,40,46,0,-6,1
"3050",22-11-27,"82 - 1163",111,178,110,1,67,0.990990990990991
"3051",22-11-28,"40 - 1320",124,130,124,0,6,1
"3052",22-11-28,"40 - 1114",224,229,224,0,5,1
"3053",22-11-28,"53 - 1103",185,186,184,1,1,0.994594594594595
"3054",22-11-28,"2 - 1066",46,40,46,0,-6,1
"3055",22-11-28,"82 - 1163",111,178,111,0,67,1
"3056",22-11-29,"40 - 1320",127,130,127,0,3,1
"3057",22-11-29,"40 - 1114",226,229,226,0,3,1
"3058",22-11-29,"53 - 1103",185,186,184,1,1,0.994594594594595
"3059",22-11-29,"2 - 1066",46,40,46,0,-6,1
"3060",22-11-29,"82 - 1163",112,178,112,0,66,1
"3061",22-11-30,"40 - 1320",130,130,130,0,0,1
"3062",22-11-30,"40 - 1114",226,229,225,1,3,0.995575221238938
"3063",22-11-30,"53 - 1103",185,186,183,2,1,0.989189189189189
"3064",22-11-30,"2 - 1066",45,40,45,0,-5,1
"3065",22-11-30,"82 - 1163",109,148,109,0,39,1
"3066",22-12-01,"40 - 1320",129,155,129,0,26,1
"3067",22-12-01,"40 - 1114",227,229,221,6,2,0.973568281938326
"3068",22-12-01,"53 - 1103",183,186,183,0,3,1
"3069",22-12-01,"2 - 1066",43,40,43,0,-3,1
"3070",22-12-01,"82 - 1163",109,178,109,0,69,1
"3071",22-12-02,"40 - 1320",132,156,131,1,24,0.992424242424242
"3072",22-12-02,"40 - 1114",223,229,222,1,6,0.995515695067265
"3073",22-12-02,"53 - 1103",184,186,182,2,2,0.989130434782609
"3074",22-12-02,"2 - 1066",43,40,43,0,-3,1
"3075",22-12-02,"82 - 1163",111,178,111,0,67,1
"3076",22-12-03,"40 - 1320",135,156,135,0,21,1
"3077",22-12-03,"40 - 1114",218,229,217,1,11,0.995412844036697
"3078",22-12-03,"53 - 1103",182,186,181,1,4,0.994505494505495
"3079",22-12-03,"2 - 1066",42,40,42,0,-2,1
"3080",22-12-03,"82 - 1163",112,178,112,0,66,1
"3081",22-12-04,"40 - 1320",137,156,137,0,19,1
"3082",22-12-04,"40 - 1114",221,229,219,2,8,0.990950226244344
"3083",22-12-04,"53 - 1103",185,186,181,4,1,0.978378378378378
"3084",22-12-04,"2 - 1066",42,40,42,0,-2,1
"3085",22-12-04,"82 - 1163",110,178,110,0,68,1
"3086",22-12-05,"40 - 1320",136,156,136,0,20,1
"3087",22-12-05,"40 - 1114",218,229,218,0,11,1
"3088",22-12-05,"53 - 1103",185,186,183,2,1,0.989189189189189
"3089",22-12-05,"2 - 1066",41,40,41,0,-1,1
"3090",22-12-05,"82 - 1163",113,178,113,0,65,1
"3091",22-12-06,"40 - 1320",141,156,141,0,15,1
"3092",22-12-06,"40 - 1114",221,229,221,0,8,1
"3093",22-12-06,"53 - 1103",185,186,184,1,1,0.994594594594595
"3094",22-12-06,"2 - 1066",41,40,41,0,-1,1
"3095",22-12-06,"82 - 1163",114,178,114,0,64,1
"3096",22-12-07,"40 - 1320",146,156,146,0,10,1
"3097",22-12-07,"40 - 1114",222,229,222,0,7,1
"3098",22-12-07,"53 - 1103",186,186,185,1,0,0.994623655913978
"3099",22-12-07,"2 - 1066",41,40,41,0,-1,1
"3100",22-12-07,"82 - 1163",112,178,112,0,66,1
"3101",22-12-08,"40 - 1320",150,181,150,0,31,1
"3102",22-12-08,"40 - 1114",226,229,225,1,3,0.995575221238938
"3103",22-12-08,"53 - 1103",185,186,185,0,1,1
"3104",22-12-08,"2 - 1066",40,40,40,0,0,1
"3105",22-12-08,"82 - 1163",119,178,119,0,59,1
"3106",22-12-09,"40 - 1320",152,181,152,0,29,1
"3107",22-12-09,"40 - 1114",227,229,226,1,2,0.995594713656388
"3108",22-12-09,"53 - 1103",185,186,185,0,1,1
"3109",22-12-09,"2 - 1066",39,40,39,0,1,1
"3110",22-12-09,"82 - 1163",128,148,124,4,20,0.96875
"3111",22-12-10,"40 - 1320",154,181,154,0,27,1
"3112",22-12-10,"40 - 1114",227,229,225,2,2,0.991189427312775
"3113",22-12-10,"53 - 1103",186,186,186,0,0,1
"3114",22-12-10,"2 - 1066",39,40,39,0,1,1
"3115",22-12-10,"82 - 1163",135,148,130,5,13,0.962962962962963
"3116",22-12-11,"40 - 1320",157,181,157,0,24,1
"3117",22-12-11,"40 - 1114",224,229,224,0,5,1
"3118",22-12-11,"53 - 1103",185,186,185,0,1,1
"3119",22-12-11,"2 - 1066",39,40,39,0,1,1
"3120",22-12-11,"82 - 1163",131,148,131,0,17,1
"3121",22-12-12,"40 - 1320",159,181,159,0,22,1
"3122",22-12-12,"40 - 1114",225,229,225,0,4,1
"3123",22-12-12,"53 - 1103",186,186,186,0,0,1
"3124",22-12-12,"2 - 1066",39,40,38,1,1,0.974358974358974
"3125",22-12-12,"82 - 1163",131,148,131,0,17,1
"3126",22-12-13,"40 - 1320",164,181,163,1,17,0.99390243902439
"3127",22-12-13,"40 - 1114",225,229,225,0,4,1
"3128",22-12-13,"53 - 1103",186,186,186,0,0,1
"3129",22-12-13,"2 - 1066",33,58,33,0,25,1
"3130",22-12-13,"82 - 1163",133,148,133,0,15,1
"3131",22-12-14,"40 - 1320",171,186,171,0,15,1
"3132",22-12-14,"40 - 1114",226,227,226,0,1,1
"3133",22-12-14,"53 - 1103",186,186,186,0,0,1
"3134",22-12-14,"2 - 1066",32,58,32,0,26,1
"3135",22-12-14,"82 - 1163",133,148,131,2,15,0.984962406015038
"3136",22-12-15,"40 - 1320",171,206,171,0,35,1
"3137",22-12-15,"40 - 1114",225,227,225,0,2,1
"3138",22-12-15,"53 - 1103",185,186,185,0,1,1
"3139",22-12-15,"2 - 1066",32,58,32,0,26,1
"3140",22-12-15,"82 - 1163",127,148,127,0,21,1
"3141",22-12-16,"40 - 1320",171,206,171,0,35,1
"3142",22-12-16,"40 - 1114",224,229,223,1,5,0.995535714285714
"3143",22-12-16,"53 - 1103",184,186,184,0,2,1
"3144",22-12-16,"2 - 1066",33,58,33,0,25,1
"3145",22-12-16,"82 - 1163",121,148,121,0,27,1
"3146",22-12-17,"40 - 1320",173,206,172,1,33,0.994219653179191
"3147",22-12-17,"40 - 1114",224,229,224,0,5,1
"3148",22-12-17,"53 - 1103",186,186,183,3,0,0.983870967741935
"3149",22-12-17,"2 - 1066",34,58,34,0,24,1
"3150",22-12-17,"82 - 1163",124,148,124,0,24,1
"3151",22-12-18,"40 - 1320",173,206,173,0,33,1
"3152",22-12-18,"40 - 1114",224,229,222,2,5,0.991071428571429
"3153",22-12-18,"53 - 1103",186,186,183,3,0,0.983870967741935
"3154",22-12-18,"2 - 1066",35,58,34,1,23,0.971428571428571
"3155",22-12-18,"82 - 1163",124,148,124,0,24,1
"3156",22-12-19,"40 - 1320",174,206,174,0,32,1
"3157",22-12-19,"40 - 1114",220,229,220,0,9,1
"3158",22-12-19,"53 - 1103",185,186,185,0,1,1
"3159",22-12-19,"2 - 1066",35,58,35,0,23,1
"3160",22-12-19,"82 - 1163",125,148,125,0,23,1
"3161",22-12-20,"40 - 1320",175,206,175,0,31,1
"3162",22-12-20,"40 - 1114",218,229,218,0,11,1
"3163",22-12-20,"53 - 1103",186,186,185,1,0,0.994623655913978
"3164",22-12-20,"2 - 1066",38,58,37,1,20,0.973684210526316
"3165",22-12-20,"82 - 1163",128,148,128,0,20,1
"3166",22-12-21,"40 - 1320",178,206,178,0,28,1
"3167",22-12-21,"40 - 1114",221,229,219,2,8,0.990950226244344
"3168",22-12-21,"53 - 1103",186,186,186,0,0,1
"3169",22-12-21,"2 - 1066",38,58,37,1,20,0.973684210526316
"3170",22-12-21,"82 - 1163",129,148,128,1,19,0.992248062015504
"3171",22-12-22,"40 - 1320",182,206,182,0,24,1
"3172",22-12-22,"40 - 1114",216,229,216,0,13,1
"3173",22-12-22,"53 - 1103",186,186,185,1,0,0.994623655913978
"3174",22-12-22,"2 - 1066",39,58,39,0,19,1
"3175",22-12-22,"82 - 1163",133,148,133,0,15,1
"3176",22-12-23,"40 - 1320",187,206,187,0,19,1
"3177",22-12-23,"40 - 1114",215,229,215,0,14,1
"3178",22-12-23,"53 - 1103",186,186,186,0,0,1
"3179",22-12-23,"2 - 1066",39,58,39,0,19,1
"3180",22-12-23,"82 - 1163",140,148,137,3,8,0.978571428571429
"3181",22-12-24,"40 - 1320",190,206,190,0,16,1
"3182",22-12-24,"40 - 1114",218,229,216,2,11,0.990825688073395
"3183",22-12-24,"53 - 1103",186,186,186,0,0,1
"3184",22-12-24,"2 - 1066",39,58,39,0,19,1
"3185",22-12-24,"82 - 1163",135,148,135,0,13,1
"3186",22-12-25,"40 - 1320",194,206,194,0,12,1
"3187",22-12-25,"40 - 1114",218,228,217,1,10,0.995412844036697
"3188",22-12-25,"53 - 1103",186,186,186,0,0,1
"3189",22-12-25,"2 - 1066",39,58,39,0,19,1
"3190",22-12-25,"82 - 1163",133,148,133,0,15,1
"3191",22-12-26,"40 - 1320",196,206,196,0,10,1
"3192",22-12-26,"40 - 1114",218,228,218,0,10,1
"3193",22-12-26,"53 - 1103",186,186,186,0,0,1
"3194",22-12-26,"2 - 1066",40,58,39,1,18,0.975
"3195",22-12-26,"82 - 1163",136,148,136,0,12,1
"3196",22-12-27,"40 - 1320",199,206,199,0,7,1
"3197",22-12-27,"40 - 1114",220,228,219,1,8,0.995454545454545
"3198",22-12-27,"53 - 1103",182,186,182,0,4,1
"3199",22-12-27,"2 - 1066",41,58,39,2,17,0.951219512195122
"3200",22-12-27,"82 - 1163",142,148,142,0,6,1
"3201",22-12-28,"40 - 1320",201,206,201,0,5,1
"3202",22-12-28,"40 - 1114",219,228,219,0,9,1
"3203",22-12-28,"53 - 1103",186,186,181,5,0,0.973118279569892
"3204",22-12-28,"2 - 1066",42,58,40,2,16,0.952380952380952
"3205",22-12-28,"82 - 1163",144,148,144,0,4,1
"3206",22-12-29,"40 - 1320",204,206,204,0,2,1
"3207",22-12-29,"40 - 1114",221,228,221,0,7,1
"3208",22-12-29,"53 - 1103",186,186,183,3,0,0.983870967741935
"3209",22-12-29,"2 - 1066",43,58,40,3,15,0.930232558139535
"3210",22-12-29,"82 - 1163",143,148,143,0,5,1
"3211",22-12-30,"40 - 1320",205,206,205,0,1,1
"3212",22-12-30,"40 - 1114",222,231,221,1,9,0.995495495495496
"3213",22-12-30,"53 - 1103",186,186,186,0,0,1
"3214",22-12-30,"2 - 1066",43,58,42,1,15,0.976744186046512
"3215",22-12-30,"82 - 1163",143,148,142,1,5,0.993006993006993
"3216",22-12-31,"40 - 1320",205,206,205,0,1,1
"3217",22-12-31,"40 - 1114",224,231,224,0,7,1
"3218",22-12-31,"53 - 1103",186,186,186,0,0,1
"3219",22-12-31,"2 - 1066",43,58,43,0,15,1
"3220",22-12-31,"82 - 1163",142,148,142,0,6,1
"3221",2023-01-01,"40 - 1320",204,206,204,0,2,1
"3222",2023-01-01,"40 - 1114",224,231,224,0,7,1
"3223",2023-01-01,"53 - 1103",186,186,186,0,0,1
"3224",2023-01-01,"2 - 1066",43,58,43,0,15,1
"3225",2023-01-01,"82 - 1163",141,148,141,0,7,1
"3226",2023-01-02,"40 - 1320",204,206,204,0,2,1
"3227",2023-01-02,"40 - 1114",225,231,225,0,6,1
"3228",2023-01-02,"53 - 1103",186,186,186,0,0,1
"3229",2023-01-02,"2 - 1066",42,58,42,0,16,1
"3230",2023-01-02,"82 - 1163",139,148,139,0,9,1
"3231",2023-01-03,"40 - 1320",205,206,205,0,1,1
"3232",2023-01-03,"40 - 1114",224,231,223,1,7,0.995535714285714
"3233",2023-01-03,"53 - 1103",185,186,184,1,1,0.994594594594595
"3234",2023-01-03,"2 - 1066",42,58,42,0,16,1
"3235",2023-01-03,"82 - 1163",139,148,138,1,9,0.992805755395683
"3236",2023-01-04,"40 - 1320",207,207,207,0,0,1
"3237",2023-01-04,"40 - 1114",221,231,221,0,10,1
"3238",2023-01-04,"53 - 1103",183,186,183,0,3,1
"3239",2023-01-04,"2 - 1066",44,58,43,1,14,0.977272727272727
"3240",2023-01-04,"82 - 1163",137,148,137,0,11,1
"3241",2023-01-05,"40 - 1320",207,207,207,0,0,1
"3242",2023-01-05,"40 - 1114",222,231,222,0,9,1
"3243",2023-01-05,"53 - 1103",184,186,184,0,2,1
"3244",2023-01-05,"2 - 1066",44,58,44,0,14,1
"3245",2023-01-05,"82 - 1163",137,148,137,0,11,1
"3246",2023-01-06,"40 - 1320",207,207,207,0,0,1
"3247",2023-01-06,"40 - 1114",221,231,221,0,10,1
"3248",2023-01-06,"53 - 1103",184,186,183,1,2,0.994565217391304
"3249",2023-01-06,"2 - 1066",46,58,45,1,12,0.978260869565217
"3250",2023-01-06,"82 - 1163",131,148,129,2,17,0.984732824427481
"3251",2023-01-07,"40 - 1320",207,207,207,0,0,1
"3252",2023-01-07,"40 - 1114",221,231,221,0,10,1
"3253",2023-01-07,"53 - 1103",184,186,183,1,2,0.994565217391304
"3254",2023-01-07,"2 - 1066",47,58,47,0,11,1
"3255",2023-01-07,"82 - 1163",130,148,126,4,18,0.969230769230769
"3256",2023-01-08,"40 - 1320",207,207,207,0,0,1
"3257",2023-01-08,"40 - 1114",221,231,220,1,10,0.995475113122172
"3258",2023-01-08,"53 - 1103",184,186,182,2,2,0.989130434782609
"3259",2023-01-08,"2 - 1066",47,58,47,0,11,1
"3260",2023-01-08,"82 - 1163",125,148,125,0,23,1
"3261",2023-01-09,"40 - 1320",207,207,207,0,0,1
"3262",2023-01-09,"40 - 1114",222,231,222,0,9,1
"3263",2023-01-09,"53 - 1103",184,186,182,2,2,0.989130434782609
"3264",2023-01-09,"2 - 1066",47,58,47,0,11,1
"3265",2023-01-09,"82 - 1163",128,148,128,0,20,1
"3266",2023-01-10,"40 - 1320",207,207,207,0,0,1
"3267",2023-01-10,"40 - 1114",221,231,221,0,10,1
"3268",2023-01-10,"53 - 1103",184,186,184,0,2,1
"3269",2023-01-10,"2 - 1066",46,58,46,0,12,1
"3270",2023-01-10,"82 - 1163",127,148,127,0,21,1
"3271",2023-01-11,"40 - 1320",207,207,207,0,0,1
"3272",2023-01-11,"40 - 1114",223,231,223,0,8,1
"3273",2023-01-11,"53 - 1103",185,186,185,0,1,1
"3274",2023-01-11,"2 - 1066",46,58,46,0,12,1
"3275",2023-01-11,"82 - 1163",126,148,126,0,22,1
"3276",2023-01-12,"40 - 1320",207,207,207,0,0,1
"3277",2023-01-12,"40 - 1114",222,231,221,1,9,0.995495495495496
"3278",2023-01-12,"53 - 1103",185,186,185,0,1,1
"3279",2023-01-12,"2 - 1066",46,58,46,0,12,1
"3280",2023-01-12,"82 - 1163",127,148,127,0,21,1
"3281",2023-01-13,"40 - 1320",207,207,207,0,0,1
"3282",2023-01-13,"40 - 1114",222,231,222,0,9,1
"3283",2023-01-13,"53 - 1103",185,186,184,1,1,0.994594594594595
"3284",2023-01-13,"2 - 1066",45,58,45,0,13,1
"3285",2023-01-13,"82 - 1163",131,148,131,0,17,1
"3286",2023-01-14,"40 - 1320",207,207,207,0,0,1
"3287",2023-01-14,"40 - 1114",223,231,223,0,8,1
"3288",2023-01-14,"53 - 1103",185,186,184,1,1,0.994594594594595
"3289",2023-01-14,"2 - 1066",45,58,45,0,13,1
"3290",2023-01-14,"82 - 1163",128,148,128,0,20,1
"3291",2023-01-15,"40 - 1320",207,207,207,0,0,1
"3292",2023-01-15,"40 - 1114",224,231,223,1,7,0.995535714285714
"3293",2023-01-15,"53 - 1103",186,186,186,0,0,1
"3294",2023-01-15,"2 - 1066",45,58,45,0,13,1
"3295",2023-01-15,"82 - 1163",124,148,123,1,24,0.991935483870968
"3296",2023-01-16,"40 - 1320",207,207,207,0,0,1
"3297",2023-01-16,"40 - 1114",220,231,220,0,11,1
"3298",2023-01-16,"53 - 1103",185,186,183,2,1,0.989189189189189
"3299",2023-01-16,"2 - 1066",45,58,45,0,13,1
"3300",2023-01-16,"82 - 1163",120,148,120,0,28,1
"3301",2023-01-17,"40 - 1320",207,207,207,0,0,1
"3302",2023-01-17,"40 - 1114",222,231,222,0,9,1
"3303",2023-01-17,"53 - 1103",186,186,183,3,0,0.983870967741935
"3304",2023-01-17,"2 - 1066",45,58,44,1,13,0.977777777777778
"3305",2023-01-17,"82 - 1163",121,148,121,0,27,1
"3306",2023-01-18,"40 - 1320",207,207,207,0,0,1
"3307",2023-01-18,"40 - 1114",222,231,222,0,9,1
"3308",2023-01-18,"53 - 1103",186,186,183,3,0,0.983870967741935
"3309",2023-01-18,"2 - 1066",44,58,44,0,14,1
"3310",2023-01-18,"82 - 1163",127,148,127,0,21,1
"3311",2023-01-19,"40 - 1320",206,207,206,0,1,1
"3312",2023-01-19,"40 - 1114",224,232,223,1,8,0.995535714285714
"3313",2023-01-19,"53 - 1103",186,186,184,2,0,0.989247311827957
"3314",2023-01-19,"2 - 1066",45,58,43,2,13,0.955555555555556
"3315",2023-01-19,"82 - 1163",123,148,123,0,25,1
"3316",2023-01-20,"40 - 1320",206,207,206,0,1,1
"3317",2023-01-20,"40 - 1114",223,232,222,1,9,0.995515695067265
"3318",2023-01-20,"53 - 1103",186,186,182,4,0,0.978494623655914
"3319",2023-01-20,"2 - 1066",45,58,43,2,13,0.955555555555556
"3320",2023-01-20,"82 - 1163",130,148,122,8,18,0.938461538461538
"3321",2023-01-21,"40 - 1320",207,207,206,1,0,0.995169082125604
"3322",2023-01-21,"40 - 1114",223,232,223,0,9,1
"3323",2023-01-21,"53 - 1103",186,186,182,4,0,0.978494623655914
"3324",2023-01-21,"2 - 1066",46,58,44,2,12,0.956521739130435
"3325",2023-01-21,"82 - 1163",122,148,122,0,26,1
"3326",2023-01-22,"40 - 1320",207,207,207,0,0,1
"3327",2023-01-22,"40 - 1114",223,232,223,0,9,1
"3328",2023-01-22,"53 - 1103",186,186,182,4,0,0.978494623655914
"3329",2023-01-22,"2 - 1066",46,58,44,2,12,0.956521739130435
"3330",2023-01-22,"82 - 1163",119,148,119,0,29,1
"3331",2023-01-23,"40 - 1320",206,207,206,0,1,1
"3332",2023-01-23,"40 - 1114",224,232,224,0,8,1
"3333",2023-01-23,"53 - 1103",186,186,183,3,0,0.983870967741935
"3334",2023-01-23,"2 - 1066",46,58,44,2,12,0.956521739130435
"3335",2023-01-23,"82 - 1163",116,148,116,0,32,1
"3336",2023-01-24,"40 - 1320",207,207,207,0,0,1
"3337",2023-01-24,"40 - 1114",224,232,224,0,8,1
"3338",2023-01-24,"53 - 1103",185,186,183,2,1,0.989189189189189
"3339",2023-01-24,"2 - 1066",46,58,44,2,12,0.956521739130435
"3340",2023-01-24,"82 - 1163",116,148,115,1,32,0.991379310344828
"3341",2023-01-25,"40 - 1320",207,207,207,0,0,1
"3342",2023-01-25,"40 - 1114",227,232,225,2,5,0.991189427312775
"3343",2023-01-25,"53 - 1103",185,186,184,1,1,0.994594594594595
"3344",2023-01-25,"2 - 1066",47,58,44,3,11,0.936170212765957
"3345",2023-01-25,"82 - 1163",116,148,116,0,32,1
"3346",2023-01-26,"40 - 1320",207,207,207,0,0,1
"3347",2023-01-26,"40 - 1114",227,232,226,1,5,0.995594713656388
"3348",2023-01-26,"53 - 1103",184,186,183,1,2,0.994565217391304
"3349",2023-01-26,"2 - 1066",47,58,46,1,11,0.978723404255319
"3350",2023-01-26,"82 - 1163",118,148,118,0,30,1
"3351",2023-01-27,"40 - 1320",207,207,207,0,0,1
"3352",2023-01-27,"40 - 1114",225,232,225,0,7,1
"3353",2023-01-27,"53 - 1103",184,186,183,1,2,0.994565217391304
"3354",2023-01-27,"2 - 1066",48,58,46,2,10,0.958333333333333
"3355",2023-01-27,"82 - 1163",114,148,114,0,34,1
"3356",2023-01-28,"40 - 1320",207,207,207,0,0,1
"3357",2023-01-28,"40 - 1114",225,232,225,0,7,1
"3358",2023-01-28,"53 - 1103",184,186,183,1,2,0.994565217391304
"3359",2023-01-28,"2 - 1066",49,58,46,3,9,0.938775510204082
"3360",2023-01-28,"82 - 1163",113,148,113,0,35,1
"3361",2023-01-29,"40 - 1320",207,207,207,0,0,1
"3362",2023-01-29,"40 - 1114",225,232,225,0,7,1
"3363",2023-01-29,"53 - 1103",184,186,183,1,2,0.994565217391304
"3364",2023-01-29,"2 - 1066",49,58,46,3,9,0.938775510204082
"3365",2023-01-29,"82 - 1163",110,148,110,0,38,1
"3366",2023-01-30,"40 - 1320",206,207,206,0,1,1
"3367",2023-01-30,"40 - 1114",225,232,225,0,7,1
"3368",2023-01-30,"53 - 1103",184,186,183,1,2,0.994565217391304
"3369",2023-01-30,"2 - 1066",48,58,46,2,10,0.958333333333333
"3370",2023-01-30,"82 - 1163",113,148,113,0,35,1
"3371",2023-01-31,"40 - 1320",207,207,207,0,0,1
"3372",2023-01-31,"40 - 1114",225,232,225,0,7,1
"3373",2023-01-31,"53 - 1103",185,186,184,1,1,0.994594594594595
"3374",2023-01-31,"2 - 1066",48,58,46,2,10,0.958333333333333
"3375",2023-01-31,"82 - 1163",114,148,112,2,34,0.982456140350877
"3376",2023-02-01,"40 - 1320",201,207,201,0,6,1
"3377",2023-02-01,"40 - 1114",222,232,222,0,10,1
"3378",2023-02-01,"53 - 1103",184,186,184,0,2,1
"3379",2023-02-01,"2 - 1066",48,58,46,2,10,0.958333333333333
"3380",2023-02-01,"82 - 1163",116,148,117,-1,32,1.00862068965517
"3381",2023-02-02,"40 - 1320",202,207,202,0,5,1
"3382",2023-02-02,"40 - 1114",223,232,222,1,9,0.995515695067265
"3383",2023-02-02,"53 - 1103",184,186,184,0,2,1
"3384",2023-02-02,"2 - 1066",46,58,44,2,12,0.956521739130435
"3385",2023-02-02,"82 - 1163",123,148,123,0,25,1
"3386",2023-02-03,"40 - 1320",205,207,203,2,2,0.990243902439024
"3387",2023-02-03,"40 - 1114",223,232,222,1,9,0.995515695067265
"3388",2023-02-03,"53 - 1103",184,186,184,0,2,1
"3389",2023-02-03,"2 - 1066",45,58,43,2,13,0.955555555555556
"3390",2023-02-03,"82 - 1163",125,148,126,-1,23,1.008
"3391",2023-02-04,"40 - 1320",206,207,206,0,1,1
"3392",2023-02-04,"40 - 1114",222,232,221,1,10,0.995495495495496
"3393",2023-02-04,"53 - 1103",185,186,183,2,1,0.989189189189189
"3394",2023-02-04,"2 - 1066",45,58,43,2,13,0.955555555555556
"3395",2023-02-04,"82 - 1163",123,148,124,-1,25,1.00813008130081
"3396",2023-02-05,"40 - 1320",206,207,206,0,1,1
"3397",2023-02-05,"40 - 1114",222,232,221,1,10,0.995495495495496
"3398",2023-02-05,"53 - 1103",185,186,181,4,1,0.978378378378378
"3399",2023-02-05,"2 - 1066",45,58,43,2,13,0.955555555555556
"3400",2023-02-05,"82 - 1163",125,148,125,0,23,1
"3401",2023-02-06,"40 - 1320",206,207,206,0,1,1
"3402",2023-02-06,"40 - 1114",217,232,217,0,15,1
"3403",2023-02-06,"53 - 1103",184,186,180,4,2,0.978260869565217
"3404",2023-02-06,"2 - 1066",50,58,43,7,8,0.86
"3405",2023-02-06,"82 - 1163",124,148,125,-1,24,1.00806451612903
"3406",2023-02-07,"40 - 1320",206,207,206,0,1,1
"3407",2023-02-07,"40 - 1114",215,232,215,0,17,1
"3408",2023-02-07,"53 - 1103",184,186,180,4,2,0.978260869565217
"3409",2023-02-07,"2 - 1066",45,58,42,3,13,0.933333333333333
"3410",2023-02-07,"82 - 1163",123,148,123,0,25,1
"3411",2023-02-08,"40 - 1320",205,207,205,0,2,1
"3412",2023-02-08,"40 - 1114",215,232,215,0,17,1
"3413",2023-02-08,"53 - 1103",183,186,179,4,3,0.978142076502732
"3414",2023-02-08,"2 - 1066",44,58,42,2,14,0.954545454545455
"3415",2023-02-08,"82 - 1163",122,148,121,1,26,0.991803278688525
"3416",2023-02-09,"40 - 1320",205,207,205,0,2,1
"3417",2023-02-09,"40 - 1114",217,232,217,0,15,1
"3418",2023-02-09,"53 - 1103",185,186,181,4,1,0.978378378378378
"3419",2023-02-09,"2 - 1066",44,58,43,1,14,0.977272727272727
"3420",2023-02-09,"82 - 1163",120,148,121,-1,28,1.00833333333333
"3421",2023-02-10,"40 - 1320",206,207,206,0,1,1
"3422",2023-02-10,"40 - 1114",220,232,220,0,12,1
"3423",2023-02-10,"53 - 1103",185,186,181,4,1,0.978378378378378
"3424",2023-02-10,"2 - 1066",43,58,43,0,15,1
"3425",2023-02-10,"82 - 1163",121,148,122,-1,27,1.00826446280992
"3426",2023-02-11,"40 - 1320",206,207,206,0,1,1
"3427",2023-02-11,"40 - 1114",218,232,218,0,14,1
"3428",2023-02-11,"53 - 1103",185,186,180,5,1,0.972972972972973
"3429",2023-02-11,"2 - 1066",44,58,44,0,14,1
"3430",2023-02-11,"82 - 1163",120,148,121,-1,28,1.00833333333333
"3431",2023-02-12,"40 - 1320",206,207,206,0,1,1
"3432",2023-02-12,"40 - 1114",216,232,216,0,16,1
"3433",2023-02-12,"53 - 1103",184,186,180,4,2,0.978260869565217
"3434",2023-02-12,"2 - 1066",44,58,44,0,14,1
"3435",2023-02-12,"82 - 1163",120,148,121,-1,28,1.00833333333333
"3436",2023-02-13,"40 - 1320",204,207,204,0,3,1
"3437",2023-02-13,"40 - 1114",217,232,217,0,15,1
"3438",2023-02-13,"53 - 1103",184,186,184,0,2,1
"3439",2023-02-13,"2 - 1066",44,58,44,0,14,1
"3440",2023-02-13,"82 - 1163",117,148,118,-1,31,1.00854700854701
"3441",2023-02-14,"40 - 1320",205,207,205,0,2,1
"3442",2023-02-14,"40 - 1114",218,232,218,0,14,1
"3443",2023-02-14,"53 - 1103",185,186,184,1,1,0.994594594594595
"3444",2023-02-14,"2 - 1066",44,58,44,0,14,1
"3445",2023-02-14,"82 - 1163",118,148,119,-1,30,1.00847457627119
"3446",2023-02-15,"40 - 1320",205,207,205,0,2,1
"3447",2023-02-15,"40 - 1114",221,232,221,0,11,1
"3448",2023-02-15,"53 - 1103",185,186,183,2,1,0.989189189189189
"3449",2023-02-15,"2 - 1066",44,58,43,1,14,0.977272727272727
"3450",2023-02-15,"82 - 1163",117,148,118,-1,31,1.00854700854701
"3451",2023-02-16,"40 - 1320",206,207,206,0,1,1
"3452",2023-02-16,"40 - 1114",224,232,223,1,8,0.995535714285714
"3453",2023-02-16,"53 - 1103",186,186,183,3,0,0.983870967741935
"3454",2023-02-16,"2 - 1066",43,58,43,0,15,1
"3455",2023-02-16,"82 - 1163",117,148,118,-1,31,1.00854700854701
"3456",2023-02-17,"40 - 1320",205,207,205,0,2,1
"3457",2023-02-17,"40 - 1114",225,232,225,0,7,1
"3458",2023-02-17,"53 - 1103",186,186,183,3,0,0.983870967741935
"3459",2023-02-17,"2 - 1066",45,58,44,1,13,0.977777777777778
"3460",2023-02-17,"82 - 1163",120,148,119,1,28,0.991666666666667
"3461",2023-02-18,"40 - 1320",205,207,205,0,2,1
"3462",2023-02-18,"40 - 1114",225,232,225,0,7,1
"3463",2023-02-18,"53 - 1103",186,186,180,6,0,0.967741935483871
"3464",2023-02-18,"2 - 1066",45,58,44,1,13,0.977777777777778
"3465",2023-02-18,"82 - 1163",123,148,124,-1,25,1.00813008130081
"3466",2023-02-19,"40 - 1320",205,207,205,0,2,1
"3467",2023-02-19,"40 - 1114",225,232,225,0,7,1
"3468",2023-02-19,"53 - 1103",186,186,180,6,0,0.967741935483871
"3469",2023-02-19,"2 - 1066",45,58,44,1,13,0.977777777777778
"3470",2023-02-19,"82 - 1163",125,148,126,-1,23,1.008
"3471",2023-02-20,"40 - 1320",206,207,206,0,1,1
"3472",2023-02-20,"40 - 1114",226,232,225,1,6,0.995575221238938
"3473",2023-02-20,"53 - 1103",186,186,183,3,0,0.983870967741935
"3474",2023-02-20,"2 - 1066",45,58,44,1,13,0.977777777777778
"3475",2023-02-20,"82 - 1163",129,148,130,-1,19,1.0077519379845
"3476",2023-02-21,"40 - 1320",206,207,206,0,1,1
"3477",2023-02-21,"40 - 1114",226,232,226,0,6,1
"3478",2023-02-21,"53 - 1103",186,186,183,3,0,0.983870967741935
"3479",2023-02-21,"2 - 1066",46,58,45,1,12,0.978260869565217
"3480",2023-02-21,"82 - 1163",134,148,135,-1,14,1.00746268656716
"3481",2023-02-22,"40 - 1320",206,207,206,0,1,1
"3482",2023-02-22,"40 - 1114",224,232,224,0,8,1
"3483",2023-02-22,"53 - 1103",186,186,184,2,0,0.989247311827957
"3484",2023-02-22,"2 - 1066",46,58,45,1,12,0.978260869565217
"3485",2023-02-22,"82 - 1163",134,148,135,-1,14,1.00746268656716
"3486",2023-02-23,"40 - 1320",206,207,206,0,1,1
"3487",2023-02-23,"40 - 1114",225,232,225,0,7,1
"3488",2023-02-23,"53 - 1103",186,186,186,0,0,1
"3489",2023-02-23,"2 - 1066",46,58,45,1,12,0.978260869565217
"3490",2023-02-23,"82 - 1163",134,148,135,-1,14,1.00746268656716
"3491",2023-02-24,"40 - 1320",207,207,207,0,0,1
"3492",2023-02-24,"40 - 1114",224,232,224,0,8,1
"3493",2023-02-24,"53 - 1103",186,186,185,1,0,0.994623655913978
"3494",2023-02-24,"2 - 1066",46,58,45,1,12,0.978260869565217
"3495",2023-02-24,"82 - 1163",135,148,136,-1,13,1.00740740740741
"3496",2023-02-25,"40 - 1320",207,207,207,0,0,1
"3497",2023-02-25,"40 - 1114",224,232,224,0,8,1
"3498",2023-02-25,"53 - 1103",186,186,184,2,0,0.989247311827957
"3499",2023-02-25,"2 - 1066",46,58,44,2,12,0.956521739130435
"3500",2023-02-25,"82 - 1163",136,148,137,-1,12,1.00735294117647
"3501",2023-02-26,"40 - 1320",207,207,207,0,0,1
"3502",2023-02-26,"40 - 1114",224,232,224,0,8,1
"3503",2023-02-26,"53 - 1103",184,186,184,0,2,1
"3504",2023-02-26,"2 - 1066",46,58,45,1,12,0.978260869565217
"3505",2023-02-26,"82 - 1163",137,148,138,-1,11,1.00729927007299
"3506",2023-02-27,"40 - 1320",207,207,207,0,0,1
"3507",2023-02-27,"40 - 1114",224,232,223,1,8,0.995535714285714
"3508",2023-02-27,"53 - 1103",184,186,184,0,2,1
"3509",2023-02-27,"2 - 1066",46,58,45,1,12,0.978260869565217
"3510",2023-02-27,"82 - 1163",137,148,138,-1,11,1.00729927007299
"3511",2023-02-28,"40 - 1320",207,207,207,0,0,1
"3512",2023-02-28,"40 - 1114",223,232,222,1,9,0.995515695067265
"3513",2023-02-28,"53 - 1103",185,186,183,2,1,0.989189189189189
"3514",2023-02-28,"2 - 1066",47,58,45,2,11,0.957446808510638
"3515",2023-02-28,"82 - 1163",137,148,138,-1,11,1.00729927007299
"3516",2023-03-01,"40 - 1320",202,207,202,0,5,1
"3517",2023-03-01,"40 - 1114",222,232,222,0,10,1
"3518",2023-03-01,"53 - 1103",184,186,184,0,2,1
"3519",2023-03-01,"2 - 1066",43,58,41,2,15,0.953488372093023
"3520",2023-03-01,"82 - 1163",134,148,135,-1,14,1.00746268656716
"3521",2023-03-02,"40 - 1320",206,207,205,1,1,0.995145631067961
"3522",2023-03-02,"40 - 1114",221,232,221,0,11,1
"3523",2023-03-02,"53 - 1103",184,186,184,0,2,1
"3524",2023-03-02,"2 - 1066",43,58,42,1,15,0.976744186046512
"3525",2023-03-02,"82 - 1163",137,148,138,-1,11,1.00729927007299
"3526",2023-03-03,"40 - 1320",205,207,205,0,2,1
"3527",2023-03-03,"40 - 1114",222,232,221,1,10,0.995495495495496
"3528",2023-03-03,"53 - 1103",183,186,181,2,3,0.989071038251366
"3529",2023-03-03,"2 - 1066",44,58,42,2,14,0.954545454545455
"3530",2023-03-03,"82 - 1163",132,148,133,-1,16,1.00757575757576
"3531",2023-03-04,"40 - 1320",204,207,204,0,3,1
"3532",2023-03-04,"40 - 1114",222,232,221,1,10,0.995495495495496
"3533",2023-03-04,"53 - 1103",184,186,181,3,2,0.983695652173913
"3534",2023-03-04,"2 - 1066",43,58,42,1,15,0.976744186046512
"3535",2023-03-04,"82 - 1163",131,148,132,-1,17,1.00763358778626
"3536",2023-03-05,"40 - 1320",203,207,203,0,4,1
"3537",2023-03-05,"40 - 1114",223,232,223,0,9,1
"3538",2023-03-05,"53 - 1103",184,186,180,4,2,0.978260869565217
"3539",2023-03-05,"2 - 1066",42,58,42,0,16,1
"3540",2023-03-05,"82 - 1163",131,148,132,-1,17,1.00763358778626
"3541",2023-03-06,"40 - 1320",204,207,204,0,3,1
"3542",2023-03-06,"40 - 1114",222,232,221,1,10,0.995495495495496
"3543",2023-03-06,"53 - 1103",183,186,182,1,3,0.994535519125683
"3544",2023-03-06,"2 - 1066",44,58,44,0,14,1
"3545",2023-03-06,"82 - 1163",131,148,132,-1,17,1.00763358778626
"3546",2023-03-07,"40 - 1320",205,207,205,0,2,1
"3547",2023-03-07,"40 - 1114",222,232,222,0,10,1
"3548",2023-03-07,"53 - 1103",183,186,183,0,3,1
"3549",2023-03-07,"2 - 1066",44,58,44,0,14,1
"3550",2023-03-07,"82 - 1163",131,148,132,-1,17,1.00763358778626
"3551",2023-03-08,"40 - 1320",205,207,205,0,2,1
"3552",2023-03-08,"40 - 1114",222,232,220,2,10,0.990990990990991
"3553",2023-03-08,"53 - 1103",184,186,184,0,2,1
"3554",2023-03-08,"2 - 1066",43,58,42,1,15,0.976744186046512
"3555",2023-03-08,"82 - 1163",131,148,131,0,17,1
"3556",2023-03-09,"40 - 1320",202,207,202,0,5,1
"3557",2023-03-09,"40 - 1114",223,232,223,0,9,1
"3558",2023-03-09,"53 - 1103",181,186,181,0,5,1
"3559",2023-03-09,"2 - 1066",44,58,43,1,14,0.977272727272727
"3560",2023-03-09,"82 - 1163",127,148,127,0,21,1
"3561",2023-03-10,"40 - 1320",202,207,202,0,5,1
"3562",2023-03-10,"40 - 1114",224,232,222,2,8,0.991071428571429
"3563",2023-03-10,"53 - 1103",184,186,181,3,2,0.983695652173913
"3564",2023-03-10,"2 - 1066",44,58,44,0,14,1
"3565",2023-03-10,"82 - 1163",125,148,125,0,23,1
"3566",2023-03-11,"40 - 1320",205,207,205,0,2,1
"3567",2023-03-11,"40 - 1114",225,232,225,0,7,1
"3568",2023-03-11,"53 - 1103",181,186,178,3,5,0.983425414364641
"3569",2023-03-11,"2 - 1066",44,58,44,0,14,1
"3570",2023-03-11,"82 - 1163",125,148,125,0,23,1
"3571",2023-03-12,"40 - 1320",206,207,206,0,1,1
"3572",2023-03-12,"40 - 1114",226,232,225,1,6,0.995575221238938
"3573",2023-03-12,"53 - 1103",183,186,177,6,3,0.967213114754098
"3574",2023-03-12,"2 - 1066",44,58,44,0,14,1
"3575",2023-03-12,"82 - 1163",127,148,127,0,21,1
"3576",2023-03-13,"40 - 1320",206,207,206,0,1,1
"3577",2023-03-13,"40 - 1114",227,232,226,1,5,0.995594713656388
"3578",2023-03-13,"53 - 1103",183,186,180,3,3,0.983606557377049
"3579",2023-03-13,"2 - 1066",43,58,43,0,15,1
"3580",2023-03-13,"82 - 1163",126,148,126,0,22,1
"3581",2023-03-14,"40 - 1320",207,207,207,0,0,1
"3582",2023-03-14,"40 - 1114",226,232,226,0,6,1
"3583",2023-03-14,"53 - 1103",184,186,181,3,2,0.983695652173913
"3584",2023-03-14,"2 - 1066",43,58,43,0,15,1
"3585",2023-03-14,"82 - 1163",128,148,128,0,20,1
"3586",2023-03-15,"40 - 1320",207,207,207,0,0,1
"3587",2023-03-15,"40 - 1114",226,232,226,0,6,1
"3588",2023-03-15,"53 - 1103",185,186,177,8,1,0.956756756756757
"3589",2023-03-15,"2 - 1066",43,58,43,0,15,1
"3590",2023-03-15,"82 - 1163",129,148,129,0,19,1
"3591",2023-03-16,"40 - 1320",206,207,206,0,1,1
"3592",2023-03-16,"40 - 1114",226,232,226,0,6,1
"3593",2023-03-16,"53 - 1103",184,186,181,3,2,0.983695652173913
"3594",2023-03-16,"2 - 1066",45,58,45,0,13,1
"3595",2023-03-16,"82 - 1163",129,148,129,0,19,1
"3596",2023-03-17,"40 - 1320",205,207,205,0,2,1
"3597",2023-03-17,"40 - 1114",225,232,225,0,7,1
"3598",2023-03-17,"53 - 1103",185,186,185,0,1,1
"3599",2023-03-17,"2 - 1066",45,58,45,0,13,1
"3600",2023-03-17,"82 - 1163",127,148,127,0,21,1
"3601",2023-03-18,"40 - 1320",206,207,206,0,1,1
"3602",2023-03-18,"40 - 1114",225,232,224,1,7,0.995555555555556
"3603",2023-03-18,"53 - 1103",184,186,184,0,2,1
"3604",2023-03-18,"2 - 1066",45,58,45,0,13,1
"3605",2023-03-18,"82 - 1163",128,148,128,0,20,1
"3606",2023-03-19,"40 - 1320",206,207,206,0,1,1
"3607",2023-03-19,"40 - 1114",225,232,224,1,7,0.995555555555556
"3608",2023-03-19,"53 - 1103",182,186,181,1,4,0.994505494505495
"3609",2023-03-19,"2 - 1066",45,58,45,0,13,1
"3610",2023-03-19,"82 - 1163",129,148,129,0,19,1
"3611",2023-03-20,"40 - 1320",207,207,207,0,0,1
"3612",2023-03-20,"40 - 1114",223,232,223,0,9,1
"3613",2023-03-20,"53 - 1103",184,186,183,1,2,0.994565217391304
"3614",2023-03-20,"2 - 1066",45,58,45,0,13,1
"3615",2023-03-20,"82 - 1163",126,148,126,0,22,1
"3616",2023-03-21,"40 - 1320",207,207,207,0,0,1
"3617",2023-03-21,"40 - 1114",223,232,223,0,9,1
"3618",2023-03-21,"53 - 1103",182,186,180,2,4,0.989010989010989
"3619",2023-03-21,"2 - 1066",45,58,45,0,13,1
"3620",2023-03-21,"82 - 1163",127,148,127,0,21,1
"3621",2023-03-22,"40 - 1320",207,207,207,0,0,1
"3622",2023-03-22,"40 - 1114",222,232,221,1,10,0.995495495495496
"3623",2023-03-22,"53 - 1103",183,186,181,2,3,0.989071038251366
"3624",2023-03-22,"2 - 1066",45,58,45,0,13,1
"3625",2023-03-22,"82 - 1163",131,148,130,1,17,0.99236641221374
"3626",2023-03-23,"40 - 1320",207,207,207,0,0,1
"3627",2023-03-23,"40 - 1114",220,232,220,0,12,1
"3628",2023-03-23,"53 - 1103",182,186,180,2,4,0.989010989010989
"3629",2023-03-23,"2 - 1066",46,58,46,0,12,1
"3630",2023-03-23,"82 - 1163",134,148,134,0,14,1
"3631",2023-03-24,"40 - 1320",206,207,206,0,1,1
"3632",2023-03-24,"40 - 1114",216,232,216,0,16,1
"3633",2023-03-24,"53 - 1103",182,186,180,2,4,0.989010989010989
"3634",2023-03-24,"2 - 1066",47,58,47,0,11,1
"3635",2023-03-24,"82 - 1163",132,148,132,0,16,1
"3636",2023-03-25,"40 - 1320",206,207,206,0,1,1
"3637",2023-03-25,"40 - 1114",216,232,216,0,16,1
"3638",2023-03-25,"53 - 1103",183,186,181,2,3,0.989071038251366
"3639",2023-03-25,"2 - 1066",47,58,47,0,11,1
"3640",2023-03-25,"82 - 1163",131,148,131,0,17,1
"3641",2023-03-26,"40 - 1320",207,207,207,0,0,1
"3642",2023-03-26,"40 - 1114",216,232,216,0,16,1
"3643",2023-03-26,"53 - 1103",184,186,182,2,2,0.989130434782609
"3644",2023-03-26,"2 - 1066",47,58,46,1,11,0.978723404255319
"3645",2023-03-26,"82 - 1163",132,148,132,0,16,1
"3646",2023-03-27,"40 - 1320",206,207,206,0,1,1
"3647",2023-03-27,"40 - 1114",215,231,215,0,16,1
"3648",2023-03-27,"53 - 1103",184,186,183,1,2,0.994565217391304
"3649",2023-03-27,"2 - 1066",46,58,46,0,12,1
"3650",2023-03-27,"82 - 1163",132,148,132,0,16,1
"3651",2023-03-28,"40 - 1320",207,207,207,0,0,1
"3652",2023-03-28,"40 - 1114",215,231,215,0,16,1
"3653",2023-03-28,"53 - 1103",184,186,183,1,2,0.994565217391304
"3654",2023-03-28,"2 - 1066",48,58,46,2,10,0.958333333333333
"3655",2023-03-28,"82 - 1163",135,148,135,0,13,1
"3656",2023-03-29,"40 - 1320",207,207,207,0,0,1
"3657",2023-03-29,"40 - 1114",217,231,217,0,14,1
"3658",2023-03-29,"53 - 1103",185,186,184,1,1,0.994594594594595
"3659",2023-03-29,"2 - 1066",48,58,48,0,10,1
"3660",2023-03-29,"82 - 1163",135,148,135,0,13,1
"3661",2023-03-30,"40 - 1320",207,207,207,0,0,1
"3662",2023-03-30,"40 - 1114",216,231,216,0,15,1
"3663",2023-03-30,"53 - 1103",185,186,185,0,1,1
"3664",2023-03-30,"2 - 1066",47,58,47,0,11,1
"3665",2023-03-30,"82 - 1163",134,148,134,0,14,1
"3666",2023-03-31,"40 - 1320",205,207,205,0,2,1
"3667",2023-03-31,"40 - 1114",213,231,213,0,18,1
"3668",2023-03-31,"53 - 1103",185,186,185,0,1,1
"3669",2023-03-31,"2 - 1066",47,58,47,0,11,1
"3670",2023-03-31,"82 - 1163",135,148,135,0,13,1
"3671",2023-04-01,"40 - 1320",205,207,205,0,2,1
"3672",2023-04-01,"40 - 1114",211,231,211,0,20,1
"3673",2023-04-01,"53 - 1103",185,186,183,2,1,0.989189189189189
"3674",2023-04-01,"2 - 1066",44,58,44,0,14,1
"3675",2023-04-01,"82 - 1163",130,148,130,0,18,1
"3676",2023-04-02,"40 - 1320",206,207,206,0,1,1
"3677",2023-04-02,"40 - 1114",211,231,211,0,20,1
"3678",2023-04-02,"53 - 1103",183,186,183,0,3,1
"3679",2023-04-02,"2 - 1066",44,58,44,0,14,1
"3680",2023-04-02,"82 - 1163",131,148,131,0,17,1
"3681",2023-04-03,"40 - 1320",207,207,207,0,0,1
"3682",2023-04-03,"40 - 1114",212,231,212,0,19,1
"3683",2023-04-03,"53 - 1103",184,186,181,3,2,0.983695652173913
"3684",2023-04-03,"2 - 1066",44,58,43,1,14,0.977272727272727
"3685",2023-04-03,"82 - 1163",132,148,132,0,16,1
"3686",2023-04-04,"40 - 1320",207,207,207,0,0,1
"3687",2023-04-04,"40 - 1114",213,231,213,0,18,1
"3688",2023-04-04,"53 - 1103",184,186,183,1,2,0.994565217391304
"3689",2023-04-04,"2 - 1066",45,58,44,1,13,0.977777777777778
"3690",2023-04-04,"82 - 1163",132,148,132,0,16,1
"3691",2023-04-05,"40 - 1320",204,207,204,0,3,1
"3692",2023-04-05,"40 - 1114",214,231,214,0,17,1
"3693",2023-04-05,"53 - 1103",185,186,182,3,1,0.983783783783784
"3694",2023-04-05,"2 - 1066",45,58,45,0,13,1
"3695",2023-04-05,"82 - 1163",131,148,131,0,17,1
"3696",2023-04-06,"40 - 1320",206,207,205,1,1,0.995145631067961
"3697",2023-04-06,"40 - 1114",215,232,215,0,17,1
"3698",2023-04-06,"53 - 1103",186,186,185,1,0,0.994623655913978
"3699",2023-04-06,"2 - 1066",45,58,45,0,13,1
"3700",2023-04-06,"82 - 1163",136,148,133,3,12,0.977941176470588
"3701",2023-04-07,"40 - 1320",206,207,206,0,1,1
"3702",2023-04-07,"40 - 1114",217,232,215,2,15,0.990783410138249
"3703",2023-04-07,"53 - 1103",185,186,183,2,1,0.989189189189189
"3704",2023-04-07,"2 - 1066",47,58,46,1,11,0.978723404255319
"3705",2023-04-07,"82 - 1163",133,148,133,0,15,1
"3706",2023-04-08,"40 - 1320",207,207,207,0,0,1
"3707",2023-04-08,"40 - 1114",217,232,215,2,15,0.990783410138249
"3708",2023-04-08,"53 - 1103",185,186,183,2,1,0.989189189189189
"3709",2023-04-08,"2 - 1066",47,58,47,0,11,1
"3710",2023-04-08,"82 - 1163",134,148,134,0,14,1
"3711",2023-04-09,"40 - 1320",207,207,207,0,0,1
"3712",2023-04-09,"40 - 1114",217,232,215,2,15,0.990783410138249
"3713",2023-04-09,"53 - 1103",186,186,183,3,0,0.983870967741935
"3714",2023-04-09,"2 - 1066",46,58,46,0,12,1
"3715",2023-04-09,"82 - 1163",134,148,134,0,14,1
"3716",2023-04-10,"40 - 1320",207,207,207,0,0,1
"3717",2023-04-10,"40 - 1114",216,232,214,2,16,0.990740740740741
"3718",2023-04-10,"53 - 1103",186,186,185,1,0,0.994623655913978
"3719",2023-04-10,"2 - 1066",47,58,46,1,11,0.978723404255319
"3720",2023-04-10,"82 - 1163",131,134,130,1,3,0.99236641221374
"3721",2023-04-11,"40 - 1320",206,207,206,0,1,1
"3722",2023-04-11,"40 - 1114",212,232,211,1,20,0.995283018867924
"3723",2023-04-11,"53 - 1103",185,186,185,0,1,1
"3724",2023-04-11,"2 - 1066",47,58,47,0,11,1
"3725",2023-04-11,"82 - 1163",134,134,134,0,0,1
"3726",2023-04-12,"40 - 1320",206,207,206,0,1,1
"3727",2023-04-12,"40 - 1114",213,232,213,0,19,1
"3728",2023-04-12,"53 - 1103",186,186,183,3,0,0.983870967741935
"3729",2023-04-12,"2 - 1066",46,58,46,0,12,1
"3730",2023-04-12,"82 - 1163",135,134,135,0,-1,1
"3731",2023-04-13,"40 - 1320",206,207,206,0,1,1
"3732",2023-04-13,"40 - 1114",215,232,214,1,17,0.995348837209302
"3733",2023-04-13,"53 - 1103",186,186,182,4,0,0.978494623655914
"3734",2023-04-13,"2 - 1066",46,58,46,0,12,1
"3735",2023-04-13,"82 - 1163",137,148,137,0,11,1
"3736",2023-04-14,"40 - 1320",204,207,204,0,3,1
"3737",2023-04-14,"40 - 1114",213,232,213,0,19,1
"3738",2023-04-14,"53 - 1103",184,186,182,2,2,0.989130434782609
"3739",2023-04-14,"2 - 1066",46,58,46,0,12,1
"3740",2023-04-14,"82 - 1163",139,148,139,0,9,1
"3741",2023-04-15,"40 - 1320",205,207,205,0,2,1
"3742",2023-04-15,"40 - 1114",214,232,213,1,18,0.995327102803738
"3743",2023-04-15,"53 - 1103",184,186,182,2,2,0.989130434782609
"3744",2023-04-15,"2 - 1066",46,58,46,0,12,1
"3745",2023-04-15,"82 - 1163",140,148,140,0,8,1
"3746",2023-04-16,"40 - 1320",205,207,205,0,2,1
"3747",2023-04-16,"40 - 1114",214,232,213,1,18,0.995327102803738
"3748",2023-04-16,"53 - 1103",183,186,180,3,3,0.983606557377049
"3749",2023-04-16,"2 - 1066",46,58,46,0,12,1
"3750",2023-04-16,"82 - 1163",138,148,136,2,10,0.985507246376812
"3751",2023-04-17,"40 - 1320",206,207,206,0,1,1
"3752",2023-04-17,"40 - 1114",213,232,213,0,19,1
"3753",2023-04-17,"53 - 1103",184,186,182,2,2,0.989130434782609
"3754",2023-04-17,"2 - 1066",46,58,46,0,12,1
"3755",2023-04-17,"82 - 1163",140,148,140,0,8,1
"3756",2023-04-18,"40 - 1320",205,207,205,0,2,1
"3757",2023-04-18,"40 - 1114",213,232,213,0,19,1
"3758",2023-04-18,"53 - 1103",184,186,183,1,2,0.994565217391304
"3759",2023-04-18,"2 - 1066",46,58,46,0,12,1
"3760",2023-04-18,"82 - 1163",138,148,138,0,10,1
"3761",2023-04-19,"40 - 1320",206,207,206,0,1,1
"3762",2023-04-19,"40 - 1114",210,232,210,0,22,1
"3763",2023-04-19,"53 - 1103",184,186,184,0,2,1
"3764",2023-04-19,"2 - 1066",46,58,46,0,12,1
"3765",2023-04-19,"82 - 1163",141,148,141,0,7,1
"3766",2023-04-20,"40 - 1320",206,207,206,0,1,1
"3767",2023-04-20,"40 - 1114",209,232,209,0,23,1
"3768",2023-04-20,"53 - 1103",183,186,183,0,3,1
"3769",2023-04-20,"2 - 1066",46,58,46,0,12,1
"3770",2023-04-20,"82 - 1163",140,148,140,0,8,1
"3771",2023-04-21,"40 - 1320",206,207,206,0,1,1
"3772",2023-04-21,"40 - 1114",209,232,209,0,23,1
"3773",2023-04-21,"53 - 1103",183,186,181,2,3,0.989071038251366
"3774",2023-04-21,"2 - 1066",45,58,45,0,13,1
"3775",2023-04-21,"82 - 1163",142,148,142,0,6,1
"3776",2023-04-22,"40 - 1320",207,207,206,1,0,0.995169082125604
"3777",2023-04-22,"40 - 1114",209,232,209,0,23,1
"3778",2023-04-22,"53 - 1103",182,186,180,2,4,0.989010989010989
"3779",2023-04-22,"2 - 1066",45,58,45,0,13,1
"3780",2023-04-22,"82 - 1163",143,148,143,0,5,1
"3781",2023-04-23,"40 - 1320",207,207,206,1,0,0.995169082125604
"3782",2023-04-23,"40 - 1114",209,232,209,0,23,1
"3783",2023-04-23,"53 - 1103",182,186,179,3,4,0.983516483516483
"3784",2023-04-23,"2 - 1066",45,58,45,0,13,1
"3785",2023-04-23,"82 - 1163",142,148,142,0,6,1
"3786",2023-04-24,"40 - 1320",207,207,206,1,0,0.995169082125604
"3787",2023-04-24,"40 - 1114",207,232,206,1,25,0.995169082125604
"3788",2023-04-24,"53 - 1103",184,186,183,1,2,0.994565217391304
"3789",2023-04-24,"2 - 1066",46,58,45,1,12,0.978260869565217
"3790",2023-04-24,"82 - 1163",144,148,144,0,4,1
"3791",2023-04-25,"40 - 1320",206,207,205,1,1,0.995145631067961
"3792",2023-04-25,"40 - 1114",207,232,205,2,25,0.990338164251208
"3793",2023-04-25,"53 - 1103",184,186,183,1,2,0.994565217391304
"3794",2023-04-25,"2 - 1066",46,58,45,1,12,0.978260869565217
"3795",2023-04-25,"82 - 1163",145,148,145,0,3,1
"3796",2023-04-26,"40 - 1320",206,207,205,1,1,0.995145631067961
"3797",2023-04-26,"40 - 1114",206,232,205,1,26,0.995145631067961
"3798",2023-04-26,"53 - 1103",185,186,184,1,1,0.994594594594595
"3799",2023-04-26,"2 - 1066",46,58,46,0,12,1
"3800",2023-04-26,"82 - 1163",145,148,145,0,3,1
"3801",2023-04-27,"40 - 1320",206,207,205,1,1,0.995145631067961
"3802",2023-04-27,"40 - 1114",205,232,205,0,27,1
"3803",2023-04-27,"53 - 1103",185,186,185,0,1,1
"3804",2023-04-27,"2 - 1066",46,58,46,0,12,1
"3805",2023-04-27,"82 - 1163",142,148,142,0,6,1
"3806",2023-04-28,"40 - 1320",206,207,206,0,1,1
"3807",2023-04-28,"40 - 1114",205,232,204,1,27,0.995121951219512
"3808",2023-04-28,"53 - 1103",186,186,185,1,0,0.994623655913978
"3809",2023-04-28,"2 - 1066",47,58,47,0,11,1
"3810",2023-04-28,"82 - 1163",139,148,139,0,9,1
"3811",2023-04-29,"40 - 1320",205,207,205,0,2,1
"3812",2023-04-29,"40 - 1114",207,232,206,1,25,0.995169082125604
"3813",2023-04-29,"53 - 1103",185,186,183,2,1,0.989189189189189
"3814",2023-04-29,"2 - 1066",47,58,47,0,11,1
"3815",2023-04-29,"82 - 1163",140,148,140,0,8,1
"3816",2023-04-30,"40 - 1320",206,207,206,0,1,1
"3817",2023-04-30,"40 - 1114",207,232,205,2,25,0.990338164251208
"3818",2023-04-30,"53 - 1103",183,186,182,1,3,0.994535519125683
"3819",2023-04-30,"2 - 1066",47,58,46,1,11,0.978723404255319
"3820",2023-04-30,"82 - 1163",136,148,136,0,12,1
"3821",2023-05-01,"40 - 1320",205,207,205,0,2,1
"3822",2023-05-01,"40 - 1114",205,232,204,1,27,0.995121951219512
"3823",2023-05-01,"53 - 1103",185,186,183,2,1,0.989189189189189
"3824",2023-05-01,"2 - 1066",46,58,46,0,12,1
"3825",2023-05-01,"82 - 1163",140,148,140,0,8,1
"3826",2023-05-02,"40 - 1320",204,207,204,0,3,1
"3827",2023-05-02,"40 - 1114",201,232,200,1,31,0.995024875621891
"3828",2023-05-02,"53 - 1103",182,186,182,0,4,1
"3829",2023-05-02,"2 - 1066",45,58,45,0,13,1
"3830",2023-05-02,"82 - 1163",140,148,140,0,8,1
"3831",2023-05-03,"40 - 1320",202,207,201,1,5,0.995049504950495
"3832",2023-05-03,"40 - 1114",200,232,198,2,32,0.99
"3833",2023-05-03,"53 - 1103",183,186,183,0,3,1
"3834",2023-05-03,"2 - 1066",45,58,45,0,13,1
"3835",2023-05-03,"82 - 1163",140,148,140,0,8,1
"3836",2023-05-04,"40 - 1320",204,207,204,0,3,1
"3837",2023-05-04,"40 - 1114",201,232,201,0,31,1
"3838",2023-05-04,"53 - 1103",185,186,185,0,1,1
"3839",2023-05-04,"2 - 1066",45,58,45,0,13,1
"3840",2023-05-04,"82 - 1163",136,134,136,0,-2,1
"3841",2023-05-05,"40 - 1320",205,207,204,1,2,0.995121951219512
"3842",2023-05-05,"40 - 1114",204,232,204,0,28,1
"3843",2023-05-05,"53 - 1103",183,186,183,0,3,1
"3844",2023-05-05,"2 - 1066",44,58,44,0,14,1
"3845",2023-05-05,"82 - 1163",140,148,140,0,8,1
"3846",2023-05-06,"40 - 1320",202,207,202,0,5,1
"3847",2023-05-06,"40 - 1114",209,232,209,0,23,1
"3848",2023-05-06,"53 - 1103",184,186,183,1,2,0.994565217391304
"3849",2023-05-06,"2 - 1066",43,58,43,0,15,1
"3850",2023-05-06,"82 - 1163",140,148,140,0,8,1
"3851",2023-05-07,"40 - 1320",205,207,205,0,2,1
"3852",2023-05-07,"40 - 1114",211,232,211,0,21,1
"3853",2023-05-07,"53 - 1103",183,186,183,0,3,1
"3854",2023-05-07,"2 - 1066",45,58,45,0,13,1
"3855",2023-05-07,"82 - 1163",140,148,139,1,8,0.992857142857143
"3856",2023-05-08,"40 - 1320",206,207,206,0,1,1
"3857",2023-05-08,"40 - 1114",212,232,212,0,20,1
"3858",2023-05-08,"53 - 1103",184,186,184,0,2,1
"3859",2023-05-08,"2 - 1066",45,58,45,0,13,1
"3860",2023-05-08,"82 - 1163",140,148,140,0,8,1
"3861",2023-05-09,"40 - 1320",206,207,206,0,1,1
"3862",2023-05-09,"40 - 1114",211,232,211,0,21,1
"3863",2023-05-09,"53 - 1103",185,186,185,0,1,1
"3864",2023-05-09,"2 - 1066",43,58,43,0,15,1
"3865",2023-05-09,"82 - 1163",138,148,138,0,10,1
"3866",2023-05-10,"40 - 1320",207,207,207,0,0,1
"3867",2023-05-10,"40 - 1114",209,232,208,1,23,0.995215311004785
"3868",2023-05-10,"53 - 1103",184,186,184,0,2,1
"3869",2023-05-10,"2 - 1066",43,58,43,0,15,1
"3870",2023-05-10,"82 - 1163",137,148,137,0,11,1
"3871",2023-05-11,"40 - 1320",207,207,207,0,0,1
"3872",2023-05-11,"40 - 1114",211,232,210,1,21,0.995260663507109
"3873",2023-05-11,"53 - 1103",185,186,185,0,1,1
"3874",2023-05-11,"2 - 1066",44,58,43,1,14,0.977272727272727
"3875",2023-05-11,"82 - 1163",138,148,138,0,10,1
"3876",2023-05-12,"40 - 1320",205,207,205,0,2,1
"3877",2023-05-12,"40 - 1114",210,232,210,0,22,1
"3878",2023-05-12,"53 - 1103",185,186,185,0,1,1
"3879",2023-05-12,"2 - 1066",49,58,44,5,9,0.897959183673469
"3880",2023-05-12,"82 - 1163",142,148,142,0,6,1
"3881",2023-05-13,"40 - 1320",205,207,205,0,2,1
"3882",2023-05-13,"40 - 1114",209,232,209,0,23,1
"3883",2023-05-13,"53 - 1103",183,186,183,0,3,1
"3884",2023-05-13,"2 - 1066",49,58,46,3,9,0.938775510204082
"3885",2023-05-13,"82 - 1163",140,148,140,0,8,1
"3886",2023-05-14,"40 - 1320",207,207,207,0,0,1
"3887",2023-05-14,"40 - 1114",213,232,211,2,19,0.990610328638498
"3888",2023-05-14,"53 - 1103",184,186,183,1,2,0.994565217391304
"3889",2023-05-14,"2 - 1066",48,58,46,2,10,0.958333333333333
"3890",2023-05-14,"82 - 1163",142,148,142,0,6,1
"3891",2023-05-15,"40 - 1320",207,207,204,3,0,0.985507246376812
"3892",2023-05-15,"40 - 1114",212,232,212,0,20,1
"3893",2023-05-15,"53 - 1103",185,186,183,2,1,0.989189189189189
"3894",2023-05-15,"2 - 1066",48,58,48,0,10,1
"3895",2023-05-15,"82 - 1163",143,148,143,0,5,1
"3896",2023-05-16,"40 - 1320",205,207,205,0,2,1
"3897",2023-05-16,"40 - 1114",211,232,209,2,21,0.990521327014218
"3898",2023-05-16,"53 - 1103",182,186,182,0,4,1
"3899",2023-05-16,"2 - 1066",48,58,47,1,10,0.979166666666667
"3900",2023-05-16,"82 - 1163",146,148,146,0,2,1
"3901",2023-05-17,"40 - 1320",206,207,205,1,1,0.995145631067961
"3902",2023-05-17,"40 - 1114",208,232,208,0,24,1
"3903",2023-05-17,"53 - 1103",182,186,179,3,4,0.983516483516483
"3904",2023-05-17,"2 - 1066",48,58,48,0,10,1
"3905",2023-05-17,"82 - 1163",145,148,145,0,3,1
"3906",2023-05-18,"40 - 1320",207,207,207,0,0,1
"3907",2023-05-18,"40 - 1114",207,232,207,0,25,1
"3908",2023-05-18,"53 - 1103",181,186,181,0,5,1
"3909",2023-05-18,"2 - 1066",47,58,47,0,11,1
"3910",2023-05-18,"82 - 1163",145,148,145,0,3,1
"3911",2023-05-19,"40 - 1320",207,207,207,0,0,1
"3912",2023-05-19,"40 - 1114",209,232,208,1,23,0.995215311004785
"3913",2023-05-19,"53 - 1103",182,186,181,1,4,0.994505494505495
"3914",2023-05-19,"2 - 1066",47,58,47,0,11,1
"3915",2023-05-19,"82 - 1163",145,148,145,0,3,1
"3916",2023-05-20,"40 - 1320",207,207,207,0,0,1
"3917",2023-05-20,"40 - 1114",210,232,210,0,22,1
"3918",2023-05-20,"53 - 1103",185,186,183,2,1,0.989189189189189
"3919",2023-05-20,"2 - 1066",49,58,48,1,9,0.979591836734694
"3920",2023-05-20,"82 - 1163",145,148,145,0,3,1
"3921",2023-05-21,"40 - 1320",207,207,207,0,0,1
"3922",2023-05-21,"40 - 1114",212,232,212,0,20,1
"3923",2023-05-21,"53 - 1103",185,186,185,0,1,1
"3924",2023-05-21,"2 - 1066",49,58,48,1,9,0.979591836734694
"3925",2023-05-21,"82 - 1163",144,148,144,0,4,1
"3926",2023-05-22,"40 - 1320",207,207,207,0,0,1
"3927",2023-05-22,"40 - 1114",212,232,212,0,20,1
"3928",2023-05-22,"53 - 1103",186,186,185,1,0,0.994623655913978
"3929",2023-05-22,"2 - 1066",49,58,49,0,9,1
"3930",2023-05-22,"82 - 1163",142,148,142,0,6,1
"3931",2023-05-23,"40 - 1320",206,207,206,0,1,1
"3932",2023-05-23,"40 - 1114",211,232,211,0,21,1
"3933",2023-05-23,"53 - 1103",185,186,183,2,1,0.989189189189189
"3934",2023-05-23,"2 - 1066",49,58,49,0,9,1
"3935",2023-05-23,"82 - 1163",143,148,142,1,5,0.993006993006993
"3936",2023-05-24,"40 - 1320",207,207,206,1,0,0.995169082125604
"3937",2023-05-24,"40 - 1114",211,232,210,1,21,0.995260663507109
"3938",2023-05-24,"53 - 1103",185,186,183,2,1,0.989189189189189
"3939",2023-05-24,"2 - 1066",49,58,49,0,9,1
"3940",2023-05-24,"82 - 1163",144,148,144,0,4,1
"3941",2023-05-25,"40 - 1320",207,207,207,0,0,1
"3942",2023-05-25,"40 - 1114",212,232,211,1,20,0.995283018867924
"3943",2023-05-25,"53 - 1103",185,186,184,1,1,0.994594594594595
"3944",2023-05-25,"2 - 1066",47,58,47,0,11,1
"3945",2023-05-25,"82 - 1163",143,148,143,0,5,1
"3946",2023-05-26,"40 - 1320",207,207,207,0,0,1
"3947",2023-05-26,"40 - 1114",213,232,213,0,19,1
"3948",2023-05-26,"53 - 1103",185,186,184,1,1,0.994594594594595
"3949",2023-05-26,"2 - 1066",47,58,47,0,11,1
"3950",2023-05-26,"82 - 1163",146,148,146,0,2,1
"3951",2023-05-27,"40 - 1320",207,207,207,0,0,1
"3952",2023-05-27,"40 - 1114",213,232,213,0,19,1
"3953",2023-05-27,"53 - 1103",185,186,185,0,1,1
"3954",2023-05-27,"2 - 1066",48,58,47,1,10,0.979166666666667
"3955",2023-05-27,"82 - 1163",144,148,144,0,4,1
"3956",2023-05-28,"40 - 1320",206,207,206,0,1,1
"3957",2023-05-28,"40 - 1114",213,232,213,0,19,1
"3958",2023-05-28,"53 - 1103",184,186,184,0,2,1
"3959",2023-05-28,"2 - 1066",48,58,47,1,10,0.979166666666667
"3960",2023-05-28,"82 - 1163",143,148,143,0,5,1
"3961",2023-05-29,"40 - 1320",206,207,206,0,1,1
"3962",2023-05-29,"40 - 1114",214,232,214,0,18,1
"3963",2023-05-29,"53 - 1103",185,186,184,1,1,0.994594594594595
"3964",2023-05-29,"2 - 1066",48,58,47,1,10,0.979166666666667
"3965",2023-05-29,"82 - 1163",143,148,142,1,5,0.993006993006993
"3966",2023-05-30,"40 - 1320",206,207,206,0,1,1
"3967",2023-05-30,"40 - 1114",216,232,215,1,16,0.99537037037037
"3968",2023-05-30,"53 - 1103",185,186,184,1,1,0.994594594594595
"3969",2023-05-30,"2 - 1066",48,58,47,1,10,0.979166666666667
"3970",2023-05-30,"82 - 1163",143,148,143,0,5,1
"3971",2023-05-31,"40 - 1320",206,207,206,0,1,1
"3972",2023-05-31,"40 - 1114",213,232,213,0,19,1
"3973",2023-05-31,"53 - 1103",185,186,184,1,1,0.994594594594595
"3974",2023-05-31,"2 - 1066",47,58,47,0,11,1
"3975",2023-05-31,"82 - 1163",142,148,142,0,6,1
"3976",2023-06-01,"40 - 1320",205,207,205,0,2,1
"3977",2023-06-01,"40 - 1114",214,232,212,2,18,0.990654205607477
"3978",2023-06-01,"53 - 1103",182,186,181,1,4,0.994505494505495
"3979",2023-06-01,"2 - 1066",48,58,48,0,10,1
"3980",2023-06-01,"82 - 1163",143,148,143,0,5,1
"3981",2023-06-02,"40 - 1320",203,207,203,0,4,1
"3982",2023-06-02,"40 - 1114",212,232,212,0,20,1
"3983",2023-06-02,"53 - 1103",180,186,177,3,6,0.983333333333333
"3984",2023-06-02,"2 - 1066",48,58,48,0,10,1
"3985",2023-06-02,"82 - 1163",142,148,142,0,6,1
"3986",2023-06-03,"40 - 1320",203,207,202,1,4,0.995073891625616
"3987",2023-06-03,"40 - 1114",214,232,213,1,18,0.995327102803738
"3988",2023-06-03,"53 - 1103",184,186,179,5,2,0.972826086956522
"3989",2023-06-03,"2 - 1066",49,58,48,1,9,0.979591836734694
"3990",2023-06-03,"82 - 1163",142,148,142,0,6,1
"3991",2023-06-04,"40 - 1320",205,207,205,0,2,1
"3992",2023-06-04,"40 - 1114",215,232,215,0,17,1
"3993",2023-06-04,"53 - 1103",184,186,181,3,2,0.983695652173913
"3994",2023-06-04,"2 - 1066",48,58,47,1,10,0.979166666666667
"3995",2023-06-04,"82 - 1163",143,148,143,0,5,1
"3996",2023-06-05,"40 - 1320",205,207,205,0,2,1
"3997",2023-06-05,"40 - 1114",219,232,218,1,13,0.995433789954338
"3998",2023-06-05,"53 - 1103",183,186,182,1,3,0.994535519125683
"3999",2023-06-05,"2 - 1066",48,58,48,0,10,1
"4000",2023-06-05,"82 - 1163",141,148,141,0,7,1
"4001",2023-06-06,"40 - 1320",205,207,205,0,2,1
"4002",2023-06-06,"40 - 1114",219,232,218,1,13,0.995433789954338
"4003",2023-06-06,"53 - 1103",184,186,183,1,2,0.994565217391304
"4004",2023-06-06,"2 - 1066",48,58,47,1,10,0.979166666666667
"4005",2023-06-06,"82 - 1163",139,148,139,0,9,1
"4006",2023-06-07,"40 - 1320",205,207,205,0,2,1
"4007",2023-06-07,"40 - 1114",221,232,220,1,11,0.995475113122172
"4008",2023-06-07,"53 - 1103",184,186,183,1,2,0.994565217391304
"4009",2023-06-07,"2 - 1066",48,58,48,0,10,1
"4010",2023-06-07,"82 - 1163",145,148,145,0,3,1
"4011",2023-06-08,"40 - 1320",205,207,205,0,2,1
"4012",2023-06-08,"40 - 1114",224,232,223,1,8,0.995535714285714
"4013",2023-06-08,"53 - 1103",184,186,184,0,2,1
"4014",2023-06-08,"2 - 1066",48,58,48,0,10,1
"4015",2023-06-08,"82 - 1163",145,148,145,0,3,1
"4016",2023-06-09,"40 - 1320",205,207,205,0,2,1
"4017",2023-06-09,"40 - 1114",225,232,225,0,7,1
"4018",2023-06-09,"53 - 1103",183,186,181,2,3,0.989071038251366
"4019",2023-06-09,"2 - 1066",48,58,48,0,10,1
"4020",2023-06-09,"82 - 1163",145,148,145,0,3,1
"4021",2023-06-10,"40 - 1320",205,207,205,0,2,1
"4022",2023-06-10,"40 - 1114",226,232,225,1,6,0.995575221238938
"4023",2023-06-10,"53 - 1103",182,186,181,1,4,0.994505494505495
"4024",2023-06-10,"2 - 1066",48,58,48,0,10,1
"4025",2023-06-10,"82 - 1163",144,134,144,0,-10,1
"4026",2023-06-11,"40 - 1320",205,207,205,0,2,1
"4027",2023-06-11,"40 - 1114",225,232,225,0,7,1
"4028",2023-06-11,"53 - 1103",183,186,183,0,3,1
"4029",2023-06-11,"2 - 1066",48,58,48,0,10,1
"4030",2023-06-11,"82 - 1163",146,134,146,0,-12,1
"4031",2023-06-12,"40 - 1320",205,207,205,0,2,1
"4032",2023-06-12,"40 - 1114",225,232,223,2,7,0.991111111111111
"4033",2023-06-12,"53 - 1103",186,186,185,1,0,0.994623655913978
"4034",2023-06-12,"2 - 1066",48,58,48,0,10,1
"4035",2023-06-12,"82 - 1163",144,134,144,0,-10,1
"4036",2023-06-13,"40 - 1320",206,207,206,0,1,1
"4037",2023-06-13,"40 - 1114",223,232,222,1,9,0.995515695067265
"4038",2023-06-13,"53 - 1103",186,186,185,1,0,0.994623655913978
"4039",2023-06-13,"2 - 1066",48,58,48,0,10,1
"4040",2023-06-13,"82 - 1163",143,134,143,0,-9,1
"4041",2023-06-14,"40 - 1320",206,207,206,0,1,1
"4042",2023-06-14,"40 - 1114",221,232,221,0,11,1
"4043",2023-06-14,"53 - 1103",186,186,185,1,0,0.994623655913978
"4044",2023-06-14,"2 - 1066",48,58,48,0,10,1
"4045",2023-06-14,"82 - 1163",141,134,141,0,-7,1
"4046",2023-06-15,"40 - 1320",206,207,206,0,1,1
"4047",2023-06-15,"40 - 1114",223,232,222,1,9,0.995515695067265
"4048",2023-06-15,"53 - 1103",186,186,186,0,0,1
"4049",2023-06-15,"2 - 1066",47,58,47,0,11,1
"4050",2023-06-15,"82 - 1163",144,134,143,1,-10,0.993055555555556
"4051",2023-06-16,"40 - 1320",206,207,206,0,1,1
"4052",2023-06-16,"40 - 1114",224,232,223,1,8,0.995535714285714
"4053",2023-06-16,"53 - 1103",186,186,186,0,0,1
"4054",2023-06-16,"2 - 1066",49,58,48,1,9,0.979591836734694
"4055",2023-06-16,"82 - 1163",145,134,145,0,-11,1
"4056",2023-06-17,"40 - 1320",206,207,206,0,1,1
"4057",2023-06-17,"40 - 1114",222,232,222,0,10,1
"4058",2023-06-17,"53 - 1103",186,186,186,0,0,1
"4059",2023-06-17,"2 - 1066",49,58,49,0,9,1
"4060",2023-06-17,"82 - 1163",145,134,145,0,-11,1
"4061",2023-06-18,"40 - 1320",206,207,206,0,1,1
"4062",2023-06-18,"40 - 1114",223,232,223,0,9,1
"4063",2023-06-18,"53 - 1103",185,186,185,0,1,1
"4064",2023-06-18,"2 - 1066",49,58,49,0,9,1
"4065",2023-06-18,"82 - 1163",143,134,143,0,-9,1
"4066",2023-06-19,"40 - 1320",206,207,206,0,1,1
"4067",2023-06-19,"40 - 1114",224,231,224,0,7,1
"4068",2023-06-19,"53 - 1103",186,186,186,0,0,1
"4069",2023-06-19,"2 - 1066",49,58,49,0,9,1
"4070",2023-06-19,"82 - 1163",144,134,144,0,-10,1
"4071",2023-06-20,"40 - 1320",206,207,206,0,1,1
"4072",2023-06-20,"40 - 1114",225,232,224,1,7,0.995555555555556
"4073",2023-06-20,"53 - 1103",187,186,186,1,-1,0.994652406417112
"4074",2023-06-20,"2 - 1066",48,58,48,0,10,1
"4075",2023-06-20,"82 - 1163",144,134,144,0,-10,1
"4076",2023-06-21,"40 - 1320",206,207,206,0,1,1
"4077",2023-06-21,"40 - 1114",225,232,225,0,7,1
"4078",2023-06-21,"53 - 1103",187,186,185,2,-1,0.989304812834225
"4079",2023-06-21,"2 - 1066",48,58,48,0,10,1
"4080",2023-06-21,"82 - 1163",144,134,144,0,-10,1
"4081",2023-06-22,"40 - 1320",206,207,206,0,1,1
"4082",2023-06-22,"40 - 1114",225,232,225,0,7,1
"4083",2023-06-22,"53 - 1103",186,186,184,2,0,0.989247311827957
"4084",2023-06-22,"2 - 1066",47,58,47,0,11,1
"4085",2023-06-22,"82 - 1163",146,148,146,0,2,1
"4086",2023-06-23,"40 - 1320",206,207,206,0,1,1
"4087",2023-06-23,"40 - 1114",227,232,227,0,5,1
"4088",2023-06-23,"53 - 1103",187,186,184,3,-1,0.983957219251337
"4089",2023-06-23,"2 - 1066",47,58,47,0,11,1
"4090",2023-06-23,"82 - 1163",148,148,147,1,0,0.993243243243243
"4091",2023-06-24,"40 - 1320",205,207,205,0,2,1
"4092",2023-06-24,"40 - 1114",227,232,227,0,5,1
"4093",2023-06-24,"53 - 1103",186,186,186,0,0,1
"4094",2023-06-24,"2 - 1066",46,58,46,0,12,1
"4095",2023-06-24,"82 - 1163",148,148,148,0,0,1
"4096",2023-06-25,"40 - 1320",204,207,204,0,3,1
"4097",2023-06-25,"40 - 1114",227,232,227,0,5,1
"4098",2023-06-25,"53 - 1103",186,186,186,0,0,1
"4099",2023-06-25,"2 - 1066",46,58,46,0,12,1
"4100",2023-06-25,"82 - 1163",148,148,148,0,0,1
"4101",2023-06-26,"40 - 1320",205,207,205,0,2,1
"4102",2023-06-26,"40 - 1114",227,232,227,0,5,1
"4103",2023-06-26,"53 - 1103",187,186,187,0,-1,1
"4104",2023-06-26,"2 - 1066",47,58,47,0,11,1
"4105",2023-06-26,"82 - 1163",147,148,147,0,1,1
"4106",2023-06-27,"40 - 1320",205,207,205,0,2,1
"4107",2023-06-27,"40 - 1114",226,232,225,1,6,0.995575221238938
"4108",2023-06-27,"53 - 1103",187,186,187,0,-1,1
"4109",2023-06-27,"2 - 1066",48,58,47,1,10,0.979166666666667
"4110",2023-06-27,"82 - 1163",146,148,146,0,2,1
"4111",2023-06-28,"40 - 1320",204,207,204,0,3,1
"4112",2023-06-28,"40 - 1114",229,232,228,1,3,0.995633187772926
"4113",2023-06-28,"53 - 1103",186,186,186,0,0,1
"4114",2023-06-28,"2 - 1066",49,58,47,2,9,0.959183673469388
"4115",2023-06-28,"82 - 1163",147,148,147,0,1,1
"4116",2023-06-29,"40 - 1320",204,207,204,0,3,1
"4117",2023-06-29,"40 - 1114",229,232,229,0,3,1
"4118",2023-06-29,"53 - 1103",184,186,182,2,2,0.989130434782609
"4119",2023-06-29,"2 - 1066",49,58,49,0,9,1
"4120",2023-06-29,"82 - 1163",147,148,147,0,1,1
"4121",2023-06-30,"40 - 1320",204,207,204,0,3,1
"4122",2023-06-30,"40 - 1114",229,232,229,0,3,1
"4123",2023-06-30,"53 - 1103",186,186,184,2,0,0.989247311827957
"4124",2023-06-30,"2 - 1066",49,58,49,0,9,1
"4125",2023-06-30,"82 - 1163",147,148,147,0,1,1
"4126",2023-07-01,"40 - 1320",204,207,204,0,3,1
"4127",2023-07-01,"40 - 1114",227,232,227,0,5,1
"4128",2023-07-01,"53 - 1103",186,186,184,2,0,0.989247311827957
"4129",2023-07-01,"2 - 1066",48,58,48,0,10,1
"4130",2023-07-01,"82 - 1163",146,148,146,0,2,1
"4131",2023-07-02,"40 - 1320",205,207,205,0,2,1
"4132",2023-07-02,"40 - 1114",228,232,228,0,4,1
"4133",2023-07-02,"53 - 1103",186,186,184,2,0,0.989247311827957
"4134",2023-07-02,"2 - 1066",48,58,48,0,10,1
"4135",2023-07-02,"82 - 1163",146,148,145,1,2,0.993150684931507
"4136",2023-07-03,"40 - 1320",205,207,205,0,2,1
"4137",2023-07-03,"40 - 1114",228,232,228,0,4,1
"4138",2023-07-03,"53 - 1103",186,186,184,2,0,0.989247311827957
"4139",2023-07-03,"2 - 1066",49,58,49,0,9,1
"4140",2023-07-03,"82 - 1163",143,148,143,0,5,1
"4141",2023-07-04,"40 - 1320",204,207,204,0,3,1
"4142",2023-07-04,"40 - 1114",228,232,228,0,4,1
"4143",2023-07-04,"53 - 1103",186,186,185,1,0,0.994623655913978
"4144",2023-07-04,"2 - 1066",49,58,49,0,9,1
"4145",2023-07-04,"82 - 1163",143,148,143,0,5,1
"4146",2023-07-05,"40 - 1320",205,207,205,0,2,1
"4147",2023-07-05,"40 - 1114",228,232,228,0,4,1
"4148",2023-07-05,"53 - 1103",186,186,185,1,0,0.994623655913978
"4149",2023-07-05,"2 - 1066",49,58,49,0,9,1
"4150",2023-07-05,"82 - 1163",142,148,142,0,6,1
"4151",2023-07-06,"40 - 1320",205,207,205,0,2,1
"4152",2023-07-06,"40 - 1114",229,232,229,0,3,1
"4153",2023-07-06,"53 - 1103",186,186,185,1,0,0.994623655913978
"4154",2023-07-06,"2 - 1066",49,58,49,0,9,1
"4155",2023-07-06,"82 - 1163",144,148,144,0,4,1
"4156",2023-07-07,"40 - 1320",206,207,206,0,1,1
"4157",2023-07-07,"40 - 1114",226,232,226,0,6,1
"4158",2023-07-07,"53 - 1103",185,186,185,0,1,1
"4159",2023-07-07,"2 - 1066",48,58,48,0,10,1
"4160",2023-07-07,"82 - 1163",141,134,141,0,-7,1
"4161",2023-07-08,"40 - 1320",207,207,207,0,0,1
"4162",2023-07-08,"40 - 1114",226,232,226,0,6,1
"4163",2023-07-08,"53 - 1103",184,186,184,0,2,1
"4164",2023-07-08,"2 - 1066",48,58,48,0,10,1
"4165",2023-07-08,"82 - 1163",141,148,140,1,7,0.99290780141844
"4166",2023-07-09,"40 - 1320",207,207,207,0,0,1
"4167",2023-07-09,"40 - 1114",226,232,226,0,6,1
"4168",2023-07-09,"53 - 1103",186,186,186,0,0,1
"4169",2023-07-09,"2 - 1066",48,58,48,0,10,1
"4170",2023-07-09,"82 - 1163",140,148,140,0,8,1
"4171",2023-07-10,"40 - 1320",207,207,207,0,0,1
"4172",2023-07-10,"40 - 1114",226,232,225,1,6,0.995575221238938
"4173",2023-07-10,"53 - 1103",187,186,187,0,-1,1
"4174",2023-07-10,"2 - 1066",48,58,48,0,10,1
"4175",2023-07-10,"82 - 1163",143,148,143,0,5,1
"4176",2023-07-11,"40 - 1320",207,207,207,0,0,1
"4177",2023-07-11,"40 - 1114",228,232,228,0,4,1
"4178",2023-07-11,"53 - 1103",186,186,186,0,0,1
"4179",2023-07-11,"2 - 1066",48,58,48,0,10,1
"4180",2023-07-11,"82 - 1163",151,148,150,1,-3,0.993377483443709
"4181",2023-07-12,"40 - 1320",207,207,206,1,0,0.995169082125604
"4182",2023-07-12,"40 - 1114",230,232,229,1,2,0.995652173913044
"4183",2023-07-12,"53 - 1103",187,186,187,0,-1,1
"4184",2023-07-12,"2 - 1066",48,58,48,0,10,1
"4185",2023-07-12,"82 - 1163",150,148,150,0,-2,1
"4186",2023-07-13,"40 - 1320",207,207,206,1,0,0.995169082125604
"4187",2023-07-13,"40 - 1114",231,232,230,1,1,0.995670995670996
"4188",2023-07-13,"53 - 1103",186,186,186,0,0,1
"4189",2023-07-13,"2 - 1066",48,58,48,0,10,1
"4190",2023-07-13,"82 - 1163",150,148,150,0,-2,1
"4191",2023-07-14,"40 - 1320",207,207,206,1,0,0.995169082125604
"4192",2023-07-14,"40 - 1114",230,232,229,1,2,0.995652173913044
"4193",2023-07-14,"53 - 1103",187,186,187,0,-1,1
"4194",2023-07-14,"2 - 1066",48,58,48,0,10,1
"4195",2023-07-14,"82 - 1163",151,148,151,0,-3,1
"4196",2023-07-15,"40 - 1320",206,207,206,0,1,1
"4197",2023-07-15,"40 - 1114",231,232,230,1,1,0.995670995670996
"4198",2023-07-15,"53 - 1103",186,186,186,0,0,1
"4199",2023-07-15,"2 - 1066",47,58,47,0,11,1
"4200",2023-07-15,"82 - 1163",151,148,151,0,-3,1
"4201",2023-07-16,"40 - 1320",206,207,206,0,1,1
"4202",2023-07-16,"40 - 1114",231,232,230,1,1,0.995670995670996
"4203",2023-07-16,"53 - 1103",186,186,186,0,0,1
"4204",2023-07-16,"2 - 1066",47,58,47,0,11,1
"4205",2023-07-16,"82 - 1163",148,148,148,0,0,1
"4206",2023-07-17,"40 - 1320",207,207,206,1,0,0.995169082125604
"4207",2023-07-17,"40 - 1114",231,232,231,0,1,1
"4208",2023-07-17,"53 - 1103",185,186,185,0,1,1
"4209",2023-07-17,"2 - 1066",47,58,47,0,11,1
"4210",2023-07-17,"82 - 1163",147,148,147,0,1,1
"4211",2023-07-18,"40 - 1320",207,207,206,1,0,0.995169082125604
"4212",2023-07-18,"40 - 1114",232,232,232,0,0,1
"4213",2023-07-18,"53 - 1103",187,186,187,0,-1,1
"4214",2023-07-18,"2 - 1066",47,58,47,0,11,1
"4215",2023-07-18,"82 - 1163",146,148,145,1,2,0.993150684931507
"4216",2023-07-19,"40 - 1320",207,207,207,0,0,1
"4217",2023-07-19,"40 - 1114",232,232,232,0,0,1
"4218",2023-07-19,"53 - 1103",187,186,187,0,-1,1
"4219",2023-07-19,"2 - 1066",47,58,47,0,11,1
"4220",2023-07-19,"82 - 1163",146,148,146,0,2,1
"4221",2023-07-20,"40 - 1320",208,207,208,0,-1,1
"4222",2023-07-20,"40 - 1114",232,232,231,1,0,0.995689655172414
"4223",2023-07-20,"53 - 1103",187,186,187,0,-1,1
"4224",2023-07-20,"2 - 1066",47,58,47,0,11,1
"4225",2023-07-20,"82 - 1163",147,148,147,0,1,1
"4226",2023-07-21,"40 - 1320",207,207,207,0,0,1
"4227",2023-07-21,"40 - 1114",230,232,230,0,2,1
"4228",2023-07-21,"53 - 1103",187,186,187,0,-1,1
"4229",2023-07-21,"2 - 1066",47,58,47,0,11,1
"4230",2023-07-21,"82 - 1163",151,148,151,0,-3,1
"4231",2023-07-22,"40 - 1320",207,207,207,0,0,1
"4232",2023-07-22,"40 - 1114",230,232,230,0,2,1
"4233",2023-07-22,"53 - 1103",187,186,187,0,-1,1
"4234",2023-07-22,"2 - 1066",47,58,47,0,11,1
"4235",2023-07-22,"82 - 1163",151,148,151,0,-3,1
"4236",2023-07-23,"40 - 1320",207,207,207,0,0,1
"4237",2023-07-23,"40 - 1114",230,232,230,0,2,1
"4238",2023-07-23,"53 - 1103",187,186,187,0,-1,1
"4239",2023-07-23,"2 - 1066",47,58,47,0,11,1
"4240",2023-07-23,"82 - 1163",151,148,151,0,-3,1
"4241",2023-07-24,"40 - 1320",208,207,207,1,-1,0.995192307692308
"4242",2023-07-24,"40 - 1114",230,232,230,0,2,1
"4243",2023-07-24,"53 - 1103",187,186,187,0,-1,1
"4244",2023-07-24,"2 - 1066",47,58,47,0,11,1
"4245",2023-07-24,"82 - 1163",151,148,151,0,-3,1
"4246",2023-07-25,"40 - 1320",208,207,207,1,-1,0.995192307692308
"4247",2023-07-25,"40 - 1114",230,232,230,0,2,1
"4248",2023-07-25,"53 - 1103",187,186,187,0,-1,1
"4249",2023-07-25,"2 - 1066",47,58,47,0,11,1
"4250",2023-07-25,"82 - 1163",151,148,151,0,-3,1
"4251",2023-07-26,"40 - 1320",208,207,207,1,-1,0.995192307692308
"4252",2023-07-26,"40 - 1114",230,232,230,0,2,1
"4253",2023-07-26,"53 - 1103",185,186,185,0,1,1
"4254",2023-07-26,"2 - 1066",47,58,47,0,11,1
"4255",2023-07-26,"82 - 1163",147,148,147,0,1,1
"4256",2023-07-27,"40 - 1320",207,207,207,0,0,1
"4257",2023-07-27,"40 - 1114",230,232,230,0,2,1
"4258",2023-07-27,"53 - 1103",186,186,184,2,0,0.989247311827957
"4259",2023-07-27,"2 - 1066",47,58,47,0,11,1
"4260",2023-07-27,"82 - 1163",148,148,148,0,0,1
"4261",2023-07-28,"40 - 1320",207,207,207,0,0,1
"4262",2023-07-28,"40 - 1114",230,232,230,0,2,1
"4263",2023-07-28,"53 - 1103",186,186,184,2,0,0.989247311827957
"4264",2023-07-28,"2 - 1066",47,58,47,0,11,1
"4265",2023-07-28,"82 - 1163",149,148,149,0,-1,1
"4266",2023-07-29,"40 - 1320",207,207,207,0,0,1
"4267",2023-07-29,"40 - 1114",229,232,229,0,3,1
"4268",2023-07-29,"53 - 1103",184,186,184,0,2,1
"4269",2023-07-29,"2 - 1066",47,58,47,0,11,1
"4270",2023-07-29,"82 - 1163",149,148,149,0,-1,1
"4271",2023-07-30,"40 - 1320",207,207,207,0,0,1
"4272",2023-07-30,"40 - 1114",229,232,229,0,3,1
"4273",2023-07-30,"53 - 1103",183,186,182,1,3,0.994535519125683
"4274",2023-07-30,"2 - 1066",48,58,47,1,10,0.979166666666667
"4275",2023-07-30,"82 - 1163",147,148,147,0,1,1
"4276",2023-07-31,"40 - 1320",208,207,208,0,-1,1
"4277",2023-07-31,"40 - 1114",230,232,230,0,2,1
"4278",2023-07-31,"53 - 1103",182,186,180,2,4,0.989010989010989
"4279",2023-07-31,"2 - 1066",48,58,48,0,10,1
"4280",2023-07-31,"82 - 1163",148,148,148,0,0,1
"4281",2023-08-01,"40 - 1320",208,207,208,0,-1,1
"4282",2023-08-01,"40 - 1114",230,232,229,1,2,0.995652173913044
"4283",2023-08-01,"53 - 1103",184,186,183,1,2,0.994565217391304
"4284",2023-08-01,"2 - 1066",48,58,48,0,10,1
"4285",2023-08-01,"82 - 1163",149,148,149,0,-1,1
"4286",2023-08-02,"40 - 1320",208,207,208,0,-1,1
"4287",2023-08-02,"40 - 1114",230,232,229,1,2,0.995652173913044
"4288",2023-08-02,"53 - 1103",183,186,181,2,3,0.989071038251366
"4289",2023-08-02,"2 - 1066",48,58,48,0,10,1
"4290",2023-08-02,"82 - 1163",149,148,148,1,-1,0.993288590604027
"4291",2023-08-03,"40 - 1320",208,207,208,0,-1,1
"4292",2023-08-03,"40 - 1114",230,232,229,1,2,0.995652173913044
"4293",2023-08-03,"53 - 1103",186,186,185,1,0,0.994623655913978
"4294",2023-08-03,"2 - 1066",47,58,47,0,11,1
"4295",2023-08-03,"82 - 1163",148,148,148,0,0,1
"4296",2023-08-04,"40 - 1320",208,207,208,0,-1,1
"4297",2023-08-04,"40 - 1114",230,232,228,2,2,0.991304347826087
"4298",2023-08-04,"53 - 1103",184,186,184,0,2,1
"4299",2023-08-04,"2 - 1066",46,58,46,0,12,1
"4300",2023-08-04,"82 - 1163",147,148,147,0,1,1
"4301",2023-08-05,"40 - 1320",207,207,207,0,0,1
"4302",2023-08-05,"40 - 1114",229,232,229,0,3,1
"4303",2023-08-05,"53 - 1103",184,186,184,0,2,1
"4304",2023-08-05,"2 - 1066",45,58,45,0,13,1
"4305",2023-08-05,"82 - 1163",147,148,147,0,1,1
"4306",2023-08-06,"40 - 1320",208,207,208,0,-1,1
"4307",2023-08-06,"40 - 1114",229,232,228,1,3,0.995633187772926
"4308",2023-08-06,"53 - 1103",185,186,185,0,1,1
"4309",2023-08-06,"2 - 1066",45,58,45,0,13,1
"4310",2023-08-06,"82 - 1163",142,148,142,0,6,1
"4311",2023-08-07,"40 - 1320",208,207,208,0,-1,1
"4312",2023-08-07,"40 - 1114",229,232,228,1,3,0.995633187772926
"4313",2023-08-07,"53 - 1103",185,186,185,0,1,1
"4314",2023-08-07,"2 - 1066",44,58,44,0,14,1
"4315",2023-08-07,"82 - 1163",143,148,143,0,5,1
"4316",2023-08-08,"40 - 1320",208,207,208,0,-1,1
"4317",2023-08-08,"40 - 1114",229,232,228,1,3,0.995633187772926
"4318",2023-08-08,"53 - 1103",184,186,182,2,2,0.989130434782609
"4319",2023-08-08,"2 - 1066",44,58,44,0,14,1
"4320",2023-08-08,"82 - 1163",141,148,141,0,7,1
"4321",2023-08-09,"40 - 1320",207,207,207,0,0,1
"4322",2023-08-09,"40 - 1114",228,232,228,0,4,1
"4323",2023-08-09,"53 - 1103",184,186,184,0,2,1
"4324",2023-08-09,"2 - 1066",46,58,44,2,12,0.956521739130435
"4325",2023-08-09,"82 - 1163",144,148,144,0,4,1
"4326",2023-08-10,"40 - 1320",208,207,207,1,-1,0.995192307692308
"4327",2023-08-10,"40 - 1114",229,231,229,0,2,1
"4328",2023-08-10,"53 - 1103",184,186,184,0,2,1
"4329",2023-08-10,"2 - 1066",45,58,43,2,13,0.955555555555556
"4330",2023-08-10,"82 - 1163",148,148,148,0,0,1
"4331",2023-08-11,"40 - 1320",207,207,207,0,0,1
"4332",2023-08-11,"40 - 1114",230,232,228,2,2,0.991304347826087
"4333",2023-08-11,"53 - 1103",184,186,183,1,2,0.994565217391304
"4334",2023-08-11,"2 - 1066",46,58,44,2,12,0.956521739130435
"4335",2023-08-11,"82 - 1163",150,148,150,0,-2,1
"4336",2023-08-12,"40 - 1320",208,207,208,0,-1,1
"4337",2023-08-12,"40 - 1114",227,232,227,0,5,1
"4338",2023-08-12,"53 - 1103",184,186,182,2,2,0.989130434782609
"4339",2023-08-12,"2 - 1066",46,58,45,1,12,0.978260869565217
"4340",2023-08-12,"82 - 1163",148,148,147,1,0,0.993243243243243
"4341",2023-08-13,"40 - 1320",208,207,208,0,-1,1
"4342",2023-08-13,"40 - 1114",227,232,227,0,5,1
"4343",2023-08-13,"53 - 1103",184,186,182,2,2,0.989130434782609
"4344",2023-08-13,"2 - 1066",46,58,45,1,12,0.978260869565217
"4345",2023-08-13,"82 - 1163",147,148,147,0,1,1
"4346",2023-08-14,"40 - 1320",208,207,208,0,-1,1
"4347",2023-08-14,"40 - 1114",227,232,226,1,5,0.995594713656388
"4348",2023-08-14,"53 - 1103",184,186,182,2,2,0.989130434782609
"4349",2023-08-14,"2 - 1066",46,58,46,0,12,1
"4350",2023-08-14,"82 - 1163",148,148,148,0,0,1
"4351",2023-08-15,"40 - 1320",208,207,208,0,-1,1
"4352",2023-08-15,"40 - 1114",227,232,227,0,5,1
"4353",2023-08-15,"53 - 1103",185,186,185,0,1,1
"4354",2023-08-15,"2 - 1066",46,58,46,0,12,1
"4355",2023-08-15,"82 - 1163",147,148,147,0,1,1
"4356",2023-08-16,"40 - 1320",208,207,208,0,-1,1
"4357",2023-08-16,"40 - 1114",229,232,229,0,3,1
"4358",2023-08-16,"53 - 1103",186,186,186,0,0,1
"4359",2023-08-16,"2 - 1066",46,58,46,0,12,1
"4360",2023-08-16,"82 - 1163",144,148,144,0,4,1
"4361",2023-08-17,"40 - 1320",208,207,208,0,-1,1
"4362",2023-08-17,"40 - 1114",229,232,228,1,3,0.995633187772926
"4363",2023-08-17,"53 - 1103",186,186,186,0,0,1
"4364",2023-08-17,"2 - 1066",46,58,46,0,12,1
"4365",2023-08-17,"82 - 1163",144,148,144,0,4,1
"4366",2023-08-18,"40 - 1320",208,207,208,0,-1,1
"4367",2023-08-18,"40 - 1114",228,232,228,0,4,1
"4368",2023-08-18,"53 - 1103",186,186,186,0,0,1
"4369",2023-08-18,"2 - 1066",46,58,46,0,12,1
"4370",2023-08-18,"82 - 1163",147,148,147,0,1,1
"4371",2023-08-19,"40 - 1320",208,207,208,0,-1,1
"4372",2023-08-19,"40 - 1114",228,232,228,0,4,1
"4373",2023-08-19,"53 - 1103",186,186,186,0,0,1
"4374",2023-08-19,"2 - 1066",46,58,46,0,12,1
"4375",2023-08-19,"82 - 1163",146,148,145,1,2,0.993150684931507
"4376",2023-08-20,"40 - 1320",208,207,208,0,-1,1
"4377",2023-08-20,"40 - 1114",228,232,228,0,4,1
"4378",2023-08-20,"53 - 1103",186,186,186,0,0,1
"4379",2023-08-20,"2 - 1066",45,58,45,0,13,1
"4380",2023-08-20,"82 - 1163",145,148,145,0,3,1
"4381",2023-08-21,"40 - 1320",208,207,208,0,-1,1
"4382",2023-08-21,"40 - 1114",230,232,230,0,2,1
"4383",2023-08-21,"53 - 1103",186,186,185,1,0,0.994623655913978
"4384",2023-08-21,"2 - 1066",45,58,45,0,13,1
"4385",2023-08-21,"82 - 1163",147,148,147,0,1,1
"4386",2023-08-22,"40 - 1320",208,207,208,0,-1,1
"4387",2023-08-22,"40 - 1114",230,232,230,0,2,1
"4388",2023-08-22,"53 - 1103",185,186,184,1,1,0.994594594594595
"4389",2023-08-22,"2 - 1066",45,58,45,0,13,1
"4390",2023-08-22,"82 - 1163",144,148,144,0,4,1
"4391",2023-08-23,"40 - 1320",208,207,208,0,-1,1
"4392",2023-08-23,"40 - 1114",230,232,230,0,2,1
"4393",2023-08-23,"53 - 1103",185,186,184,1,1,0.994594594594595
"4394",2023-08-23,"2 - 1066",44,58,44,0,14,1
"4395",2023-08-23,"82 - 1163",145,148,145,0,3,1
"4396",2023-08-24,"40 - 1320",208,207,208,0,-1,1
"4397",2023-08-24,"40 - 1114",230,232,230,0,2,1
"4398",2023-08-24,"53 - 1103",183,186,183,0,3,1
"4399",2023-08-24,"2 - 1066",44,58,44,0,14,1
"4400",2023-08-24,"82 - 1163",143,148,143,0,5,1
"4401",2023-08-25,"40 - 1320",208,207,207,1,-1,0.995192307692308
"4402",2023-08-25,"40 - 1114",231,232,230,1,1,0.995670995670996
"4403",2023-08-25,"53 - 1103",184,186,184,0,2,1
"4404",2023-08-25,"2 - 1066",44,58,44,0,14,1
"4405",2023-08-25,"82 - 1163",145,148,145,0,3,1
"4406",2023-08-26,"40 - 1320",208,207,207,1,-1,0.995192307692308
"4407",2023-08-26,"40 - 1114",231,232,230,1,1,0.995670995670996
"4408",2023-08-26,"53 - 1103",184,186,183,1,2,0.994565217391304
"4409",2023-08-26,"2 - 1066",44,58,44,0,14,1
"4410",2023-08-26,"82 - 1163",146,148,146,0,2,1
"4411",2023-08-27,"40 - 1320",208,207,207,1,-1,0.995192307692308
"4412",2023-08-27,"40 - 1114",231,232,230,1,1,0.995670995670996
"4413",2023-08-27,"53 - 1103",184,186,183,1,2,0.994565217391304
"4414",2023-08-27,"2 - 1066",44,58,44,0,14,1
"4415",2023-08-27,"82 - 1163",145,148,145,0,3,1
"4416",2023-08-28,"40 - 1320",207,207,207,0,0,1
"4417",2023-08-28,"40 - 1114",230,232,230,0,2,1
"4418",2023-08-28,"53 - 1103",183,186,182,1,3,0.994535519125683
"4419",2023-08-28,"2 - 1066",44,58,44,0,14,1
"4420",2023-08-28,"82 - 1163",143,148,143,0,5,1
"4421",2023-08-29,"40 - 1320",207,207,207,0,0,1
"4422",2023-08-29,"40 - 1114",231,232,231,0,1,1
"4423",2023-08-29,"53 - 1103",184,186,184,0,2,1
"4424",2023-08-29,"2 - 1066",44,58,44,0,14,1
"4425",2023-08-29,"82 - 1163",143,148,143,0,5,1
"4426",2023-08-30,"40 - 1320",207,207,207,0,0,1
"4427",2023-08-30,"40 - 1114",232,232,231,1,0,0.995689655172414
"4428",2023-08-30,"53 - 1103",185,186,185,0,1,1
"4429",2023-08-30,"2 - 1066",43,58,43,0,15,1
"4430",2023-08-30,"82 - 1163",144,148,144,0,4,1
"4431",2023-08-31,"40 - 1320",207,207,207,0,0,1
"4432",2023-08-31,"40 - 1114",231,232,231,0,1,1
"4433",2023-08-31,"53 - 1103",184,186,184,0,2,1
"4434",2023-08-31,"2 - 1066",44,58,44,0,14,1
"4435",2023-08-31,"82 - 1163",141,148,141,0,7,1
"4436",2023-09-01,"40 - 1320",207,207,207,0,0,1
"4437",2023-09-01,"40 - 1114",229,232,229,0,3,1
"4438",2023-09-01,"53 - 1103",183,186,183,0,3,1
"4439",2023-09-01,"2 - 1066",45,58,44,1,13,0.977777777777778
"4440",2023-09-01,"82 - 1163",140,148,140,0,8,1
"4441",2023-09-02,"40 - 1320",206,207,206,0,1,1
"4442",2023-09-02,"40 - 1114",229,232,229,0,3,1
"4443",2023-09-02,"53 - 1103",183,186,183,0,3,1
"4444",2023-09-02,"2 - 1066",45,58,45,0,13,1
"4445",2023-09-02,"82 - 1163",140,148,140,0,8,1
"4446",2023-09-03,"40 - 1320",207,207,207,0,0,1
"4447",2023-09-03,"40 - 1114",229,232,229,0,3,1
"4448",2023-09-03,"53 - 1103",183,186,183,0,3,1
"4449",2023-09-03,"2 - 1066",45,58,45,0,13,1
"4450",2023-09-03,"82 - 1163",141,148,141,0,7,1
"4451",2023-09-04,"40 - 1320",207,207,207,0,0,1
"4452",2023-09-04,"40 - 1114",229,232,229,0,3,1
"4453",2023-09-04,"53 - 1103",183,186,183,0,3,1
"4454",2023-09-04,"2 - 1066",45,58,45,0,13,1
"4455",2023-09-04,"82 - 1163",141,148,141,0,7,1
"4456",2023-09-05,"40 - 1320",207,207,207,0,0,1
"4457",2023-09-05,"40 - 1114",229,232,227,2,3,0.991266375545852
"4458",2023-09-05,"53 - 1103",183,186,181,2,3,0.989071038251366
"4459",2023-09-05,"2 - 1066",45,58,45,0,13,1
"4460",2023-09-05,"82 - 1163",144,148,142,2,4,0.986111111111111
"4461",2023-09-06,"40 - 1320",207,207,207,0,0,1
"4462",2023-09-06,"40 - 1114",229,232,228,1,3,0.995633187772926
"4463",2023-09-06,"53 - 1103",183,186,181,2,3,0.989071038251366
"4464",2023-09-06,"2 - 1066",47,58,46,1,11,0.978723404255319
"4465",2023-09-06,"82 - 1163",145,148,145,0,3,1
"4466",2023-09-07,"40 - 1320",207,207,207,0,0,1
"4467",2023-09-07,"40 - 1114",228,232,227,1,4,0.995614035087719
"4468",2023-09-07,"53 - 1103",182,186,180,2,4,0.989010989010989
"4469",2023-09-07,"2 - 1066",48,58,47,1,10,0.979166666666667
"4470",2023-09-07,"82 - 1163",145,148,145,0,3,1
"4471",2023-09-08,"40 - 1320",207,207,207,0,0,1
"4472",2023-09-08,"40 - 1114",227,232,226,1,5,0.995594713656388
"4473",2023-09-08,"53 - 1103",181,186,179,2,5,0.988950276243094
"4474",2023-09-08,"2 - 1066",48,58,48,0,10,1
"4475",2023-09-08,"82 - 1163",147,148,147,0,1,1
"4476",2023-09-09,"40 - 1320",206,207,206,0,1,1
"4477",2023-09-09,"40 - 1114",227,232,227,0,5,1
"4478",2023-09-09,"53 - 1103",179,186,178,1,7,0.994413407821229
"4479",2023-09-09,"2 - 1066",47,58,47,0,11,1
"4480",2023-09-09,"82 - 1163",146,148,146,0,2,1
"4481",2023-09-10,"40 - 1320",207,207,207,0,0,1
"4482",2023-09-10,"40 - 1114",228,232,228,0,4,1
"4483",2023-09-10,"53 - 1103",179,186,178,1,7,0.994413407821229
"4484",2023-09-10,"2 - 1066",48,58,48,0,10,1
"4485",2023-09-10,"82 - 1163",145,148,145,0,3,1
"4486",2023-09-11,"40 - 1320",207,207,207,0,0,1
"4487",2023-09-11,"40 - 1114",230,231,229,1,1,0.995652173913044
"4488",2023-09-11,"53 - 1103",179,186,179,0,7,1
"4489",2023-09-11,"2 - 1066",48,58,48,0,10,1
"4490",2023-09-11,"82 - 1163",144,148,144,0,4,1
"4491",2023-09-12,"40 - 1320",207,207,207,0,0,1
"4492",2023-09-12,"40 - 1114",227,231,226,1,4,0.995594713656388
"4493",2023-09-12,"53 - 1103",180,186,180,0,6,1
"4494",2023-09-12,"2 - 1066",47,58,47,0,11,1
"4495",2023-09-12,"82 - 1163",146,148,146,0,2,1
"4496",2023-09-13,"40 - 1320",207,207,207,0,0,1
"4497",2023-09-13,"40 - 1114",227,231,227,0,4,1
"4498",2023-09-13,"53 - 1103",182,186,181,1,4,0.994505494505495
"4499",2023-09-13,"2 - 1066",45,58,45,0,13,1
"4500",2023-09-13,"82 - 1163",147,148,147,0,1,1
"4501",2023-09-14,"40 - 1320",207,207,207,0,0,1
"4502",2023-09-14,"40 - 1114",227,231,226,1,4,0.995594713656388
"4503",2023-09-14,"53 - 1103",183,186,182,1,3,0.994535519125683
"4504",2023-09-14,"2 - 1066",45,58,45,0,13,1
"4505",2023-09-14,"82 - 1163",147,148,147,0,1,1
"4506",2023-09-15,"40 - 1320",205,207,205,0,2,1
"4507",2023-09-15,"40 - 1114",228,231,227,1,3,0.995614035087719
"4508",2023-09-15,"53 - 1103",184,186,184,0,2,1
"4509",2023-09-15,"2 - 1066",45,58,45,0,13,1
"4510",2023-09-15,"82 - 1163",153,148,153,0,-5,1
"4511",2023-09-16,"40 - 1320",205,207,205,0,2,1
"4512",2023-09-16,"40 - 1114",228,231,227,1,3,0.995614035087719
"4513",2023-09-16,"53 - 1103",184,186,184,0,2,1
"4514",2023-09-16,"2 - 1066",45,58,45,0,13,1
"4515",2023-09-16,"82 - 1163",152,148,152,0,-4,1
"4516",2023-09-17,"40 - 1320",206,207,206,0,1,1
"4517",2023-09-17,"40 - 1114",226,231,226,0,5,1
"4518",2023-09-17,"53 - 1103",184,186,184,0,2,1
"4519",2023-09-17,"2 - 1066",48,58,48,0,10,1
"4520",2023-09-17,"82 - 1163",149,148,149,0,-1,1
"4521",2023-09-18,"40 - 1320",206,207,205,1,1,0.995145631067961
"4522",2023-09-18,"40 - 1114",229,232,229,0,3,1
"4523",2023-09-18,"53 - 1103",183,186,183,0,3,1
"4524",2023-09-18,"2 - 1066",48,58,48,0,10,1
"4525",2023-09-18,"82 - 1163",155,148,155,0,-7,1
"4526",2023-09-19,"40 - 1320",207,207,206,1,0,0.995169082125604
"4527",2023-09-19,"40 - 1114",229,232,229,0,3,1
"4528",2023-09-19,"53 - 1103",183,186,182,1,3,0.994535519125683
"4529",2023-09-19,"2 - 1066",48,58,48,0,10,1
"4530",2023-09-19,"82 - 1163",159,148,159,0,-11,1
"4531",2023-09-20,"40 - 1320",207,207,207,0,0,1
"4532",2023-09-20,"40 - 1114",229,232,229,0,3,1
"4533",2023-09-20,"53 - 1103",183,186,182,1,3,0.994535519125683
"4534",2023-09-20,"2 - 1066",47,58,47,0,11,1
"4535",2023-09-20,"82 - 1163",163,148,163,0,-15,1
"4536",2023-09-21,"40 - 1320",207,207,207,0,0,1
"4537",2023-09-21,"40 - 1114",229,232,229,0,3,1
"4538",2023-09-21,"53 - 1103",184,186,182,2,2,0.989130434782609
"4539",2023-09-21,"2 - 1066",47,58,47,0,11,1
"4540",2023-09-21,"82 - 1163",163,148,163,0,-15,1
"4541",2023-09-22,"40 - 1320",206,207,206,0,1,1
"4542",2023-09-22,"40 - 1114",229,232,228,1,3,0.995633187772926
"4543",2023-09-22,"53 - 1103",182,186,182,0,4,1
"4544",2023-09-22,"2 - 1066",48,58,48,0,10,1
"4545",2023-09-22,"82 - 1163",163,148,163,0,-15,1
"4546",2023-09-23,"40 - 1320",206,207,206,0,1,1
"4547",2023-09-23,"40 - 1114",228,232,228,0,4,1
"4548",2023-09-23,"53 - 1103",182,186,182,0,4,1
"4549",2023-09-23,"2 - 1066",48,58,48,0,10,1
"4550",2023-09-23,"82 - 1163",160,148,160,0,-12,1
"4551",2023-09-24,"40 - 1320",206,207,206,0,1,1
"4552",2023-09-24,"40 - 1114",228,232,228,0,4,1
"4553",2023-09-24,"53 - 1103",183,186,183,0,3,1
"4554",2023-09-24,"2 - 1066",48,58,48,0,10,1
"4555",2023-09-24,"82 - 1163",161,148,161,0,-13,1
"4556",2023-09-25,"40 - 1320",206,207,206,0,1,1
"4557",2023-09-25,"40 - 1114",228,232,228,0,4,1
"4558",2023-09-25,"53 - 1103",185,186,184,1,1,0.994594594594595
"4559",2023-09-25,"2 - 1066",48,58,48,0,10,1
"4560",2023-09-25,"82 - 1163",164,148,164,0,-16,1
"4561",2023-09-26,"40 - 1320",207,207,206,1,0,0.995169082125604
"4562",2023-09-26,"40 - 1114",228,232,228,0,4,1
"4563",2023-09-26,"53 - 1103",185,186,184,1,1,0.994594594594595
"4564",2023-09-26,"2 - 1066",48,58,48,0,10,1
"4565",2023-09-26,"82 - 1163",164,148,164,0,-16,1
"4566",2023-09-27,"40 - 1320",207,207,207,0,0,1
"4567",2023-09-27,"40 - 1114",229,232,227,2,3,0.991266375545852
"4568",2023-09-27,"53 - 1103",185,186,185,0,1,1
"4569",2023-09-27,"2 - 1066",48,58,48,0,10,1
"4570",2023-09-27,"82 - 1163",165,148,165,0,-17,1
"4571",2023-09-28,"40 - 1320",208,207,207,1,-1,0.995192307692308
"4572",2023-09-28,"40 - 1114",227,232,227,0,5,1
"4573",2023-09-28,"53 - 1103",185,186,185,0,1,1
"4574",2023-09-28,"2 - 1066",48,58,48,0,10,1
"4575",2023-09-28,"82 - 1163",162,148,162,0,-14,1
"4576",2023-09-29,"40 - 1320",208,207,208,0,-1,1
"4577",2023-09-29,"40 - 1114",228,232,228,0,4,1
"4578",2023-09-29,"53 - 1103",185,186,185,0,1,1
"4579",2023-09-29,"2 - 1066",47,58,47,0,11,1
"4580",2023-09-29,"82 - 1163",167,148,167,0,-19,1
"4581",2023-09-30,"40 - 1320",207,207,207,0,0,1
"4582",2023-09-30,"40 - 1114",228,232,228,0,4,1
"4583",2023-09-30,"53 - 1103",185,186,185,0,1,1
"4584",2023-09-30,"2 - 1066",47,58,47,0,11,1
"4585",2023-09-30,"82 - 1163",166,148,166,0,-18,1
"4586",2023-10-01,"40 - 1320",207,207,207,0,0,1
"4587",2023-10-01,"40 - 1114",228,232,227,1,4,0.995614035087719
"4588",2023-10-01,"53 - 1103",183,186,183,0,3,1
"4589",2023-10-01,"2 - 1066",47,58,47,0,11,1
"4590",2023-10-01,"82 - 1163",165,148,165,0,-17,1
"4591",2023-10-02,"40 - 1320",207,207,207,0,0,1
"4592",2023-10-02,"40 - 1114",227,232,225,2,5,0.991189427312775
"4593",2023-10-02,"53 - 1103",184,186,184,0,2,1
"4594",2023-10-02,"2 - 1066",46,40,46,0,-6,1
"4595",2023-10-02,"82 - 1163",164,148,164,0,-16,1
"4596",2023-10-03,"40 - 1320",208,207,208,0,-1,1
"4597",2023-10-03,"40 - 1114",222,232,222,0,10,1
"4598",2023-10-03,"53 - 1103",183,186,183,0,3,1
"4599",2023-10-03,"2 - 1066",46,40,46,0,-6,1
"4600",2023-10-03,"82 - 1163",162,148,162,0,-14,1
"4601",2023-10-04,"40 - 1320",208,207,208,0,-1,1
"4602",2023-10-04,"40 - 1114",222,232,222,0,10,1
"4603",2023-10-04,"53 - 1103",186,186,185,1,0,0.994623655913978
"4604",2023-10-04,"2 - 1066",46,40,46,0,-6,1
"4605",2023-10-04,"82 - 1163",162,148,162,0,-14,1
"4606",2023-10-05,"40 - 1320",207,207,207,0,0,1
"4607",2023-10-05,"40 - 1114",223,232,222,1,9,0.995515695067265
"4608",2023-10-05,"53 - 1103",185,186,185,0,1,1
"4609",2023-10-05,"2 - 1066",46,40,46,0,-6,1
"4610",2023-10-05,"82 - 1163",162,148,162,0,-14,1
"4611",2023-10-06,"40 - 1320",207,207,207,0,0,1
"4612",2023-10-06,"40 - 1114",223,232,220,3,9,0.986547085201794
"4613",2023-10-06,"53 - 1103",185,186,185,0,1,1
"4614",2023-10-06,"2 - 1066",45,40,45,0,-5,1
"4615",2023-10-06,"82 - 1163",162,148,162,0,-14,1
"4616",2023-10-07,"40 - 1320",205,207,205,0,2,1
"4617",2023-10-07,"40 - 1114",218,232,218,0,14,1
"4618",2023-10-07,"53 - 1103",185,186,185,0,1,1
"4619",2023-10-07,"2 - 1066",45,40,45,0,-5,1
"4620",2023-10-07,"82 - 1163",162,148,161,1,-14,0.993827160493827
"4621",2023-10-08,"40 - 1320",206,207,206,0,1,1
"4622",2023-10-08,"40 - 1114",219,232,219,0,13,1
"4623",2023-10-08,"53 - 1103",185,186,185,0,1,1
"4624",2023-10-08,"2 - 1066",44,40,44,0,-4,1
"4625",2023-10-08,"82 - 1163",162,148,162,0,-14,1
"4626",2023-10-09,"40 - 1320",207,207,207,0,0,1
"4627",2023-10-09,"40 - 1114",220,232,220,0,12,1
"4628",2023-10-09,"53 - 1103",185,186,185,0,1,1
"4629",2023-10-09,"2 - 1066",44,40,44,0,-4,1
"4630",2023-10-09,"82 - 1163",160,148,160,0,-12,1
"4631",2023-10-10,"40 - 1320",207,207,207,0,0,1
"4632",2023-10-10,"40 - 1114",220,232,220,0,12,1
"4633",2023-10-10,"53 - 1103",184,186,184,0,2,1
"4634",2023-10-10,"2 - 1066",44,40,44,0,-4,1
"4635",2023-10-10,"82 - 1163",159,148,159,0,-11,1
"4636",2023-10-11,"40 - 1320",206,207,206,0,1,1
"4637",2023-10-11,"40 - 1114",222,232,222,0,10,1
"4638",2023-10-11,"53 - 1103",184,186,184,0,2,1
"4639",2023-10-11,"2 - 1066",45,40,45,0,-5,1
"4640",2023-10-11,"82 - 1163",160,148,160,0,-12,1
"4641",2023-10-12,"40 - 1320",205,207,203,2,2,0.990243902439024
"4642",2023-10-12,"40 - 1114",221,232,221,0,11,1
"4643",2023-10-12,"53 - 1103",185,186,184,1,1,0.994594594594595
"4644",2023-10-12,"2 - 1066",44,40,44,0,-4,1
"4645",2023-10-12,"82 - 1163",159,148,159,0,-11,1
"4646",2023-10-13,"40 - 1320",204,207,202,2,3,0.990196078431373
"4647",2023-10-13,"40 - 1114",222,232,219,3,10,0.986486486486487
"4648",2023-10-13,"53 - 1103",185,186,183,2,1,0.989189189189189
"4649",2023-10-13,"2 - 1066",44,40,44,0,-4,1
"4650",2023-10-13,"82 - 1163",160,148,160,0,-12,1
"4651",2023-10-14,"40 - 1320",200,207,200,0,7,1
"4652",2023-10-14,"40 - 1114",221,232,221,0,11,1
"4653",2023-10-14,"53 - 1103",185,186,183,2,1,0.989189189189189
"4654",2023-10-14,"2 - 1066",43,40,43,0,-3,1
"4655",2023-10-14,"82 - 1163",162,148,161,1,-14,0.993827160493827
"4656",2023-10-15,"40 - 1320",203,207,203,0,4,1
"4657",2023-10-15,"40 - 1114",222,232,222,0,10,1
"4658",2023-10-15,"53 - 1103",185,186,183,2,1,0.989189189189189
"4659",2023-10-15,"2 - 1066",43,40,43,0,-3,1
"4660",2023-10-15,"82 - 1163",160,148,160,0,-12,1
"4661",2023-10-16,"40 - 1320",205,207,205,0,2,1
"4662",2023-10-16,"40 - 1114",222,232,221,1,10,0.995495495495496
"4663",2023-10-16,"53 - 1103",185,186,184,1,1,0.994594594594595
"4664",2023-10-16,"2 - 1066",44,40,44,0,-4,1
"4665",2023-10-16,"82 - 1163",160,148,160,0,-12,1
"4666",2023-10-17,"40 - 1320",205,207,205,0,2,1
"4667",2023-10-17,"40 - 1114",223,232,223,0,9,1
"4668",2023-10-17,"53 - 1103",184,186,184,0,2,1
"4669",2023-10-17,"2 - 1066",44,40,44,0,-4,1
"4670",2023-10-17,"82 - 1163",161,148,160,1,-13,0.993788819875776
"4671",2023-10-18,"40 - 1320",207,207,205,2,0,0.990338164251208
"4672",2023-10-18,"40 - 1114",225,232,225,0,7,1
"4673",2023-10-18,"53 - 1103",184,186,184,0,2,1
"4674",2023-10-18,"2 - 1066",44,40,44,0,-4,1
"4675",2023-10-18,"82 - 1163",162,148,162,0,-14,1
"4676",2023-10-19,"40 - 1320",208,207,208,0,-1,1
"4677",2023-10-19,"40 - 1114",225,232,225,0,7,1
"4678",2023-10-19,"53 - 1103",184,186,184,0,2,1
"4679",2023-10-19,"2 - 1066",44,40,44,0,-4,1
"4680",2023-10-19,"82 - 1163",161,148,161,0,-13,1
"4681",2023-10-20,"40 - 1320",208,207,207,1,-1,0.995192307692308
"4682",2023-10-20,"40 - 1114",222,232,221,1,10,0.995495495495496
"4683",2023-10-20,"53 - 1103",184,186,184,0,2,1
"4684",2023-10-20,"2 - 1066",44,40,44,0,-4,1
"4685",2023-10-20,"82 - 1163",160,148,159,1,-12,0.99375
"4686",2023-10-21,"40 - 1320",207,207,207,0,0,1
"4687",2023-10-21,"40 - 1114",219,232,219,0,13,1
"4688",2023-10-21,"53 - 1103",186,186,186,0,0,1
"4689",2023-10-21,"2 - 1066",44,40,44,0,-4,1
"4690",2023-10-21,"82 - 1163",156,148,156,0,-8,1
"4691",2023-10-22,"40 - 1320",207,207,207,0,0,1
"4692",2023-10-22,"40 - 1114",220,232,220,0,12,1
"4693",2023-10-22,"53 - 1103",186,186,186,0,0,1
"4694",2023-10-22,"2 - 1066",44,40,44,0,-4,1
"4695",2023-10-22,"82 - 1163",156,148,156,0,-8,1
"4696",2023-10-23,"40 - 1320",207,207,207,0,0,1
"4697",2023-10-23,"40 - 1114",220,232,220,0,12,1
"4698",2023-10-23,"53 - 1103",186,186,186,0,0,1
"4699",2023-10-23,"2 - 1066",44,40,44,0,-4,1
"4700",2023-10-23,"82 - 1163",155,148,155,0,-7,1
"4701",2023-10-24,"40 - 1320",207,207,207,0,0,1
"4702",2023-10-24,"40 - 1114",221,232,221,0,11,1
"4703",2023-10-24,"53 - 1103",185,186,185,0,1,1
"4704",2023-10-24,"2 - 1066",44,40,44,0,-4,1
"4705",2023-10-24,"82 - 1163",157,148,157,0,-9,1
"4706",2023-10-25,"40 - 1320",207,207,207,0,0,1
"4707",2023-10-25,"40 - 1114",222,232,222,0,10,1
"4708",2023-10-25,"53 - 1103",185,186,185,0,1,1
"4709",2023-10-25,"2 - 1066",44,40,44,0,-4,1
"4710",2023-10-25,"82 - 1163",154,148,154,0,-6,1
"4711",2023-10-26,"40 - 1320",207,207,207,0,0,1
"4712",2023-10-26,"40 - 1114",222,232,222,0,10,1
"4713",2023-10-26,"53 - 1103",187,186,186,1,-1,0.994652406417112
"4714",2023-10-26,"2 - 1066",44,40,44,0,-4,1
"4715",2023-10-26,"82 - 1163",153,148,153,0,-5,1
"4716",2023-10-27,"40 - 1320",207,207,206,1,0,0.995169082125604
"4717",2023-10-27,"40 - 1114",221,232,221,0,11,1
"4718",2023-10-27,"53 - 1103",187,186,186,1,-1,0.994652406417112
"4719",2023-10-27,"2 - 1066",45,40,43,2,-5,0.955555555555556
"4720",2023-10-27,"82 - 1163",154,148,154,0,-6,1
"4721",2023-10-28,"40 - 1320",206,207,206,0,1,1
"4722",2023-10-28,"40 - 1114",221,232,221,0,11,1
"4723",2023-10-28,"53 - 1103",186,186,186,0,0,1
"4724",2023-10-28,"2 - 1066",44,40,42,2,-4,0.954545454545455
"4725",2023-10-28,"82 - 1163",156,148,155,1,-8,0.993589743589744
"4726",2023-10-29,"40 - 1320",206,207,206,0,1,1
"4727",2023-10-29,"40 - 1114",221,232,221,0,11,1
"4728",2023-10-29,"53 - 1103",186,186,186,0,0,1
"4729",2023-10-29,"2 - 1066",44,40,43,1,-4,0.977272727272727
"4730",2023-10-29,"82 - 1163",154,148,154,0,-6,1
"4731",2023-10-30,"40 - 1320",207,207,207,0,0,1
"4732",2023-10-30,"40 - 1114",221,232,221,0,11,1
"4733",2023-10-30,"53 - 1103",186,186,185,1,0,0.994623655913978
"4734",2023-10-30,"2 - 1066",44,40,44,0,-4,1
"4735",2023-10-30,"82 - 1163",155,148,154,1,-7,0.993548387096774
"4736",2023-10-31,"40 - 1320",207,207,207,0,0,1
"4737",2023-10-31,"40 - 1114",221,232,219,2,11,0.990950226244344
"4738",2023-10-31,"53 - 1103",187,186,187,0,-1,1
"4739",2023-10-31,"2 - 1066",44,40,44,0,-4,1
"4740",2023-10-31,"82 - 1163",157,148,157,0,-9,1
"4741",2023-11-01,"40 - 1320",208,207,206,2,-1,0.990384615384615
"4742",2023-11-01,"40 - 1114",219,232,218,1,13,0.995433789954338
"4743",2023-11-01,"53 - 1103",185,186,185,0,1,1
"4744",2023-11-01,"2 - 1066",42,40,41,1,-2,0.976190476190476
"4745",2023-11-01,"82 - 1163",155,148,155,0,-7,1
"4746",2023-11-02,"40 - 1320",207,207,206,1,0,0.995169082125604
"4747",2023-11-02,"40 - 1114",217,232,217,0,15,1
"4748",2023-11-02,"53 - 1103",187,186,187,0,-1,1
"4749",2023-11-02,"2 - 1066",42,40,41,1,-2,0.976190476190476
"4750",2023-11-02,"82 - 1163",155,148,155,0,-7,1
"4751",2023-11-03,"40 - 1320",207,207,206,1,0,0.995169082125604
"4752",2023-11-03,"40 - 1114",215,232,215,0,17,1
"4753",2023-11-03,"53 - 1103",187,186,186,1,-1,0.994652406417112
"4754",2023-11-03,"2 - 1066",43,40,40,3,-3,0.930232558139535
"4755",2023-11-03,"82 - 1163",156,148,156,0,-8,1
"4756",2023-11-04,"40 - 1320",206,207,206,0,1,1
"4757",2023-11-04,"40 - 1114",214,232,214,0,18,1
"4758",2023-11-04,"53 - 1103",187,186,187,0,-1,1
"4759",2023-11-04,"2 - 1066",41,40,41,0,-1,1
"4760",2023-11-04,"82 - 1163",157,148,156,1,-9,0.993630573248408
"4761",2023-11-05,"40 - 1320",208,207,207,1,-1,0.995192307692308
"4762",2023-11-05,"40 - 1114",214,232,214,0,18,1
"4763",2023-11-05,"53 - 1103",186,186,186,0,0,1
"4764",2023-11-05,"2 - 1066",41,40,41,0,-1,1
"4765",2023-11-05,"82 - 1163",153,148,153,0,-5,1
"4766",2023-11-06,"40 - 1320",208,207,206,2,-1,0.990384615384615
"4767",2023-11-06,"40 - 1114",214,232,212,2,18,0.990654205607477
"4768",2023-11-06,"53 - 1103",185,186,185,0,1,1
"4769",2023-11-06,"2 - 1066",40,40,40,0,0,1
"4770",2023-11-06,"82 - 1163",149,148,149,0,-1,1
"4771",2023-11-07,"40 - 1320",207,207,205,2,0,0.990338164251208
"4772",2023-11-07,"40 - 1114",213,232,213,0,19,1
"4773",2023-11-07,"53 - 1103",185,186,185,0,1,1
"4774",2023-11-07,"2 - 1066",40,40,40,0,0,1
"4775",2023-11-07,"82 - 1163",151,148,151,0,-3,1
"4776",2023-11-08,"40 - 1320",207,207,203,4,0,0.980676328502415
"4777",2023-11-08,"40 - 1114",215,232,211,4,17,0.981395348837209
"4778",2023-11-08,"53 - 1103",184,186,184,0,2,1
"4779",2023-11-08,"2 - 1066",42,40,41,1,-2,0.976190476190476
"4780",2023-11-08,"82 - 1163",150,148,150,0,-2,1
"4781",2023-11-09,"40 - 1320",205,207,205,0,2,1
"4782",2023-11-09,"40 - 1114",217,232,215,2,15,0.990783410138249
"4783",2023-11-09,"53 - 1103",185,186,185,0,1,1
"4784",2023-11-09,"2 - 1066",42,40,42,0,-2,1
"4785",2023-11-09,"82 - 1163",150,148,150,0,-2,1
"4786",2023-11-10,"40 - 1320",207,207,205,2,0,0.990338164251208
"4787",2023-11-10,"40 - 1114",220,232,220,0,12,1
"4788",2023-11-10,"53 - 1103",185,186,185,0,1,1
"4789",2023-11-10,"2 - 1066",43,40,43,0,-3,1
"4790",2023-11-10,"82 - 1163",149,148,149,0,-1,1
"4791",2023-11-11,"40 - 1320",207,207,207,0,0,1
"4792",2023-11-11,"40 - 1114",223,232,223,0,9,1
"4793",2023-11-11,"53 - 1103",185,186,185,0,1,1
"4794",2023-11-11,"2 - 1066",43,40,43,0,-3,1
"4795",2023-11-11,"82 - 1163",150,148,150,0,-2,1
"4796",2023-11-12,"40 - 1320",207,207,207,0,0,1
"4797",2023-11-12,"40 - 1114",226,232,226,0,6,1
"4798",2023-11-12,"53 - 1103",184,186,184,0,2,1
"4799",2023-11-12,"2 - 1066",42,40,42,0,-2,1
"4800",2023-11-12,"82 - 1163",151,148,151,0,-3,1
"4801",2023-11-13,"40 - 1320",207,207,207,0,0,1
"4802",2023-11-13,"40 - 1114",224,232,224,0,8,1
"4803",2023-11-13,"53 - 1103",184,186,184,0,2,1
"4804",2023-11-13,"2 - 1066",43,40,42,1,-3,0.976744186046512
"4805",2023-11-13,"82 - 1163",154,148,154,0,-6,1
"4806",2023-11-14,"40 - 1320",208,207,207,1,-1,0.995192307692308
"4807",2023-11-14,"40 - 1114",226,232,226,0,6,1
"4808",2023-11-14,"53 - 1103",185,186,183,2,1,0.989189189189189
"4809",2023-11-14,"2 - 1066",43,40,42,1,-3,0.976744186046512
"4810",2023-11-14,"82 - 1163",154,148,154,0,-6,1
"4811",2023-11-15,"40 - 1320",208,207,208,0,-1,1
"4812",2023-11-15,"40 - 1114",224,232,223,1,8,0.995535714285714
"4813",2023-11-15,"53 - 1103",184,186,184,0,2,1
"4814",2023-11-15,"2 - 1066",43,40,43,0,-3,1
"4815",2023-11-15,"82 - 1163",155,148,155,0,-7,1
"4816",2023-11-16,"40 - 1320",208,207,208,0,-1,1
"4817",2023-11-16,"40 - 1114",226,232,225,1,6,0.995575221238938
"4818",2023-11-16,"53 - 1103",184,186,184,0,2,1
"4819",2023-11-16,"2 - 1066",45,40,44,1,-5,0.977777777777778
"4820",2023-11-16,"82 - 1163",159,148,159,0,-11,1
"4821",2023-11-17,"40 - 1320",208,207,206,2,-1,0.990384615384615
"4822",2023-11-17,"40 - 1114",227,232,227,0,5,1
"4823",2023-11-17,"53 - 1103",186,186,184,2,0,0.989247311827957
"4824",2023-11-17,"2 - 1066",45,40,45,0,-5,1
"4825",2023-11-17,"82 - 1163",158,148,158,0,-10,1
"4826",2023-11-18,"40 - 1320",207,207,207,0,0,1
"4827",2023-11-18,"40 - 1114",227,232,227,0,5,1
"4828",2023-11-18,"53 - 1103",186,186,185,1,0,0.994623655913978
"4829",2023-11-18,"2 - 1066",47,40,47,0,-7,1
"4830",2023-11-18,"82 - 1163",157,148,157,0,-9,1
"4831",2023-11-19,"40 - 1320",207,207,207,0,0,1
"4832",2023-11-19,"40 - 1114",228,232,228,0,4,1
"4833",2023-11-19,"53 - 1103",187,186,186,1,-1,0.994652406417112
"4834",2023-11-19,"2 - 1066",47,40,47,0,-7,1
"4835",2023-11-19,"82 - 1163",156,148,156,0,-8,1
"4836",2023-11-20,"40 - 1320",208,207,207,1,-1,0.995192307692308
"4837",2023-11-20,"40 - 1114",231,232,230,1,1,0.995670995670996
"4838",2023-11-20,"53 - 1103",185,186,185,0,1,1
"4839",2023-11-20,"2 - 1066",47,40,47,0,-7,1
"4840",2023-11-20,"82 - 1163",159,148,159,0,-11,1
"4841",2023-11-21,"40 - 1320",208,207,207,1,-1,0.995192307692308
"4842",2023-11-21,"40 - 1114",230,232,230,0,2,1
"4843",2023-11-21,"53 - 1103",185,186,185,0,1,1
"4844",2023-11-21,"2 - 1066",47,40,47,0,-7,1
"4845",2023-11-21,"82 - 1163",157,148,157,0,-9,1
"4846",2023-11-22,"40 - 1320",208,207,207,1,-1,0.995192307692308
"4847",2023-11-22,"40 - 1114",230,232,230,0,2,1
"4848",2023-11-22,"53 - 1103",185,186,183,2,1,0.989189189189189
"4849",2023-11-22,"2 - 1066",47,40,46,1,-7,0.978723404255319
"4850",2023-11-22,"82 - 1163",158,148,158,0,-10,1
"4851",2023-11-23,"40 - 1320",208,207,208,0,-1,1
"4852",2023-11-23,"40 - 1114",229,232,229,0,3,1
"4853",2023-11-23,"53 - 1103",185,186,183,2,1,0.989189189189189
"4854",2023-11-23,"2 - 1066",47,40,46,1,-7,0.978723404255319
"4855",2023-11-23,"82 - 1163",158,148,158,0,-10,1
"4856",2023-11-24,"40 - 1320",208,207,208,0,-1,1
"4857",2023-11-24,"40 - 1114",229,232,229,0,3,1
"4858",2023-11-24,"53 - 1103",183,186,183,0,3,1
"4859",2023-11-24,"2 - 1066",46,40,45,1,-6,0.978260869565217
"4860",2023-11-24,"82 - 1163",161,148,161,0,-13,1
"4861",2023-11-25,"40 - 1320",208,207,206,2,-1,0.990384615384615
"4862",2023-11-25,"40 - 1114",230,232,230,0,2,1
"4863",2023-11-25,"53 - 1103",184,186,184,0,2,1
"4864",2023-11-25,"2 - 1066",47,40,47,0,-7,1
"4865",2023-11-25,"82 - 1163",167,148,167,0,-19,1
"4866",2023-11-26,"40 - 1320",206,207,206,0,1,1
"4867",2023-11-26,"40 - 1114",230,232,230,0,2,1
"4868",2023-11-26,"53 - 1103",184,186,184,0,2,1
"4869",2023-11-26,"2 - 1066",46,40,46,0,-6,1
"4870",2023-11-26,"82 - 1163",163,148,163,0,-15,1
"4871",2023-11-27,"40 - 1320",206,207,206,0,1,1
"4872",2023-11-27,"40 - 1114",230,232,230,0,2,1
"4873",2023-11-27,"53 - 1103",184,186,181,3,2,0.983695652173913
"4874",2023-11-27,"2 - 1066",46,40,46,0,-6,1
"4875",2023-11-27,"82 - 1163",165,148,165,0,-17,1
"4876",2023-11-28,"40 - 1320",208,207,207,1,-1,0.995192307692308
"4877",2023-11-28,"40 - 1114",230,232,230,0,2,1
"4878",2023-11-28,"53 - 1103",182,186,182,0,4,1
"4879",2023-11-28,"2 - 1066",46,40,46,0,-6,1
"4880",2023-11-28,"82 - 1163",163,148,163,0,-15,1
"4881",2023-11-29,"40 - 1320",208,207,208,0,-1,1
"4882",2023-11-29,"40 - 1114",230,232,230,0,2,1
"4883",2023-11-29,"53 - 1103",182,186,182,0,4,1
"4884",2023-11-29,"2 - 1066",47,40,46,1,-7,0.978723404255319
"4885",2023-11-29,"82 - 1163",166,148,166,0,-18,1
"4886",2023-11-30,"40 - 1320",208,207,208,0,-1,1
"4887",2023-11-30,"40 - 1114",231,232,231,0,1,1
"4888",2023-11-30,"53 - 1103",183,186,183,0,3,1
"4889",2023-11-30,"2 - 1066",47,40,47,0,-7,1
"4890",2023-11-30,"82 - 1163",163,148,163,0,-15,1
"4891",2023-12-01,"40 - 1320",207,207,207,0,0,1
"4892",2023-12-01,"40 - 1114",230,232,229,1,2,0.995652173913044
"4893",2023-12-01,"53 - 1103",183,186,183,0,3,1
"4894",2023-12-01,"2 - 1066",45,40,45,0,-5,1
"4895",2023-12-01,"82 - 1163",159,148,159,0,-11,1
"4896",2023-12-02,"40 - 1320",208,207,208,0,-1,1
"4897",2023-12-02,"40 - 1114",229,232,229,0,3,1
"4898",2023-12-02,"53 - 1103",183,186,183,0,3,1
"4899",2023-12-02,"2 - 1066",44,40,44,0,-4,1
"4900",2023-12-02,"82 - 1163",159,148,159,0,-11,1
"4901",2023-12-03,"40 - 1320",208,207,208,0,-1,1
"4902",2023-12-03,"40 - 1114",229,232,229,0,3,1
"4903",2023-12-03,"53 - 1103",183,186,183,0,3,1
"4904",2023-12-03,"2 - 1066",44,40,44,0,-4,1
"4905",2023-12-03,"82 - 1163",159,148,159,0,-11,1
"4906",2023-12-04,"40 - 1320",208,207,207,1,-1,0.995192307692308
"4907",2023-12-04,"40 - 1114",229,232,229,0,3,1
"4908",2023-12-04,"53 - 1103",184,186,184,0,2,1
"4909",2023-12-04,"2 - 1066",44,40,44,0,-4,1
"4910",2023-12-04,"82 - 1163",156,148,156,0,-8,1
"4911",2023-12-05,"40 - 1320",207,207,206,1,0,0.995169082125604
"4912",2023-12-05,"40 - 1114",230,231,230,0,1,1
"4913",2023-12-05,"53 - 1103",183,186,183,0,3,1
"4914",2023-12-05,"2 - 1066",44,40,44,0,-4,1
"4915",2023-12-05,"82 - 1163",155,148,155,0,-7,1
"4916",2023-12-06,"40 - 1320",208,207,208,0,-1,1
"4917",2023-12-06,"40 - 1114",230,231,230,0,1,1
"4918",2023-12-06,"53 - 1103",184,186,182,2,2,0.989130434782609
"4919",2023-12-06,"2 - 1066",43,40,43,0,-3,1
"4920",2023-12-06,"82 - 1163",153,148,153,0,-5,1
"4921",2023-12-07,"40 - 1320",207,207,207,0,0,1
"4922",2023-12-07,"40 - 1114",231,231,231,0,0,1
"4923",2023-12-07,"53 - 1103",184,186,183,1,2,0.994565217391304
"4924",2023-12-07,"2 - 1066",43,40,43,0,-3,1
"4925",2023-12-07,"82 - 1163",153,148,153,0,-5,1
"4926",2023-12-08,"40 - 1320",206,207,206,0,1,1
"4927",2023-12-08,"40 - 1114",229,231,229,0,2,1
"4928",2023-12-08,"53 - 1103",183,186,183,0,3,1
"4929",2023-12-08,"2 - 1066",43,40,43,0,-3,1
"4930",2023-12-08,"82 - 1163",151,148,151,0,-3,1
"4931",2023-12-09,"40 - 1320",206,207,206,0,1,1
"4932",2023-12-09,"40 - 1114",226,231,226,0,5,1
"4933",2023-12-09,"53 - 1103",183,186,183,0,3,1
"4934",2023-12-09,"2 - 1066",45,40,45,0,-5,1
"4935",2023-12-09,"82 - 1163",148,148,148,0,0,1
"4936",2023-12-10,"40 - 1320",207,207,207,0,0,1
"4937",2023-12-10,"40 - 1114",226,231,226,0,5,1
"4938",2023-12-10,"53 - 1103",183,186,183,0,3,1
"4939",2023-12-10,"2 - 1066",45,40,45,0,-5,1
"4940",2023-12-10,"82 - 1163",147,148,147,0,1,1
"4941",2023-12-11,"40 - 1320",205,207,205,0,2,1
"4942",2023-12-11,"40 - 1114",225,231,225,0,6,1
"4943",2023-12-11,"53 - 1103",183,186,183,0,3,1
"4944",2023-12-11,"2 - 1066",46,40,46,0,-6,1
"4945",2023-12-11,"82 - 1163",150,148,150,0,-2,1
"4946",2023-12-12,"40 - 1320",206,207,206,0,1,1
"4947",2023-12-12,"40 - 1114",227,231,227,0,4,1
"4948",2023-12-12,"53 - 1103",182,186,182,0,4,1
"4949",2023-12-12,"2 - 1066",47,40,46,1,-7,0.978723404255319
"4950",2023-12-12,"82 - 1163",153,148,153,0,-5,1
"4951",2023-12-13,"40 - 1320",204,207,204,0,3,1
"4952",2023-12-13,"40 - 1114",228,231,228,0,3,1
"4953",2023-12-13,"53 - 1103",183,186,183,0,3,1
"4954",2023-12-13,"2 - 1066",47,40,47,0,-7,1
"4955",2023-12-13,"82 - 1163",157,148,157,0,-9,1
"4956",2023-12-14,"40 - 1320",205,207,203,2,2,0.990243902439024
"4957",2023-12-14,"40 - 1114",230,231,228,2,1,0.991304347826087
"4958",2023-12-14,"53 - 1103",184,186,183,1,2,0.994565217391304
"4959",2023-12-14,"2 - 1066",47,40,47,0,-7,1
"4960",2023-12-14,"82 - 1163",155,148,154,1,-7,0.993548387096774
"4961",2023-12-15,"40 - 1320",205,207,202,3,2,0.985365853658537
"4962",2023-12-15,"40 - 1114",228,231,228,0,3,1
"4963",2023-12-15,"53 - 1103",183,186,183,0,3,1
"4964",2023-12-15,"2 - 1066",46,40,46,0,-6,1
"4965",2023-12-15,"82 - 1163",154,148,154,0,-6,1
"4966",2023-12-16,"40 - 1320",203,207,202,1,4,0.995073891625616
"4967",2023-12-16,"40 - 1114",227,231,227,0,4,1
"4968",2023-12-16,"53 - 1103",184,186,182,2,2,0.989130434782609
"4969",2023-12-16,"2 - 1066",47,40,47,0,-7,1
"4970",2023-12-16,"82 - 1163",153,148,152,1,-5,0.993464052287582
"4971",2023-12-17,"40 - 1320",204,207,204,0,3,1
"4972",2023-12-17,"40 - 1114",227,231,227,0,4,1
"4973",2023-12-17,"53 - 1103",182,186,182,0,4,1
"4974",2023-12-17,"2 - 1066",47,40,47,0,-7,1
"4975",2023-12-17,"82 - 1163",154,148,154,0,-6,1
"4976",2023-12-18,"40 - 1320",206,207,206,0,1,1
"4977",2023-12-18,"40 - 1114",228,231,228,0,3,1
"4978",2023-12-18,"53 - 1103",183,186,183,0,3,1
"4979",2023-12-18,"2 - 1066",47,40,47,0,-7,1
"4980",2023-12-18,"82 - 1163",154,148,154,0,-6,1
"4981",2023-12-19,"40 - 1320",207,207,206,1,0,0.995169082125604
"4982",2023-12-19,"40 - 1114",229,231,229,0,2,1
"4983",2023-12-19,"53 - 1103",185,186,185,0,1,1
"4984",2023-12-19,"2 - 1066",47,40,47,0,-7,1
"4985",2023-12-19,"82 - 1163",153,148,153,0,-5,1
"4986",2023-12-20,"40 - 1320",207,207,207,0,0,1
"4987",2023-12-20,"40 - 1114",228,231,228,0,3,1
"4988",2023-12-20,"53 - 1103",185,186,184,1,1,0.994594594594595
"4989",2023-12-20,"2 - 1066",48,40,48,0,-8,1
"4990",2023-12-20,"82 - 1163",157,148,157,0,-9,1
"4991",2023-12-21,"40 - 1320",207,207,207,0,0,1
"4992",2023-12-21,"40 - 1114",229,231,229,0,2,1
"4993",2023-12-21,"53 - 1103",183,186,182,1,3,0.994535519125683
"4994",2023-12-21,"2 - 1066",47,40,47,0,-7,1
"4995",2023-12-21,"82 - 1163",151,148,151,0,-3,1
"4996",2023-12-22,"40 - 1320",207,207,206,1,0,0.995169082125604
"4997",2023-12-22,"40 - 1114",227,231,226,1,4,0.995594713656388
"4998",2023-12-22,"53 - 1103",184,186,184,0,2,1
"4999",2023-12-22,"2 - 1066",46,40,46,0,-6,1
"5000",2023-12-22,"82 - 1163",154,148,154,0,-6,1
"5001",2023-12-23,"40 - 1320",207,207,205,2,0,0.990338164251208
"5002",2023-12-23,"40 - 1114",227,231,227,0,4,1
"5003",2023-12-23,"53 - 1103",184,186,184,0,2,1
"5004",2023-12-23,"2 - 1066",49,40,46,3,-9,0.938775510204082
"5005",2023-12-23,"82 - 1163",152,148,152,0,-4,1
"5006",2023-12-24,"40 - 1320",205,207,205,0,2,1
"5007",2023-12-24,"40 - 1114",227,231,227,0,4,1
"5008",2023-12-24,"53 - 1103",184,186,184,0,2,1
"5009",2023-12-24,"2 - 1066",49,40,46,3,-9,0.938775510204082
"5010",2023-12-24,"82 - 1163",152,148,152,0,-4,1
"5011",2023-12-25,"40 - 1320",207,207,207,0,0,1
"5012",2023-12-25,"40 - 1114",227,231,227,0,4,1
"5013",2023-12-25,"53 - 1103",184,186,183,1,2,0.994565217391304
"5014",2023-12-25,"2 - 1066",49,40,48,1,-9,0.979591836734694
"5015",2023-12-25,"82 - 1163",152,148,152,0,-4,1
"5016",2023-12-26,"40 - 1320",207,207,207,0,0,1
"5017",2023-12-26,"40 - 1114",227,231,227,0,4,1
"5018",2023-12-26,"53 - 1103",183,186,183,0,3,1
"5019",2023-12-26,"2 - 1066",49,40,48,1,-9,0.979591836734694
"5020",2023-12-26,"82 - 1163",153,148,153,0,-5,1
"5021",2023-12-27,"40 - 1320",207,207,207,0,0,1
"5022",2023-12-27,"40 - 1114",227,231,227,0,4,1
"5023",2023-12-27,"53 - 1103",184,186,182,2,2,0.989130434782609
"5024",2023-12-27,"2 - 1066",48,40,48,0,-8,1
"5025",2023-12-27,"82 - 1163",151,148,151,0,-3,1
"5026",2023-12-28,"40 - 1320",207,207,207,0,0,1
"5027",2023-12-28,"40 - 1114",227,231,227,0,4,1
"5028",2023-12-28,"53 - 1103",184,186,182,2,2,0.989130434782609
"5029",2023-12-28,"2 - 1066",48,40,48,0,-8,1
"5030",2023-12-28,"82 - 1163",151,148,151,0,-3,1
"5031",2023-12-29,"40 - 1320",206,207,206,0,1,1
"5032",2023-12-29,"40 - 1114",228,231,228,0,3,1
"5033",2023-12-29,"53 - 1103",184,186,182,2,2,0.989130434782609
"5034",2023-12-29,"2 - 1066",48,40,48,0,-8,1
"5035",2023-12-29,"82 - 1163",153,148,153,0,-5,1
"5036",2023-12-30,"40 - 1320",207,207,207,0,0,1
"5037",2023-12-30,"40 - 1114",228,231,228,0,3,1
"5038",2023-12-30,"53 - 1103",183,186,182,1,3,0.994535519125683
"5039",2023-12-30,"2 - 1066",48,40,48,0,-8,1
"5040",2023-12-30,"82 - 1163",153,148,149,4,-5,0.973856209150327
"5041",2023-12-31,"40 - 1320",205,207,204,1,2,0.995121951219512
"5042",2023-12-31,"40 - 1114",228,231,228,0,3,1
"5043",2023-12-31,"53 - 1103",183,186,182,1,3,0.994535519125683
"5044",2023-12-31,"2 - 1066",48,40,48,0,-8,1
"5045",2023-12-31,"82 - 1163",148,148,148,0,0,1
"5046",2024-01-01,"40 - 1320",206,207,206,0,1,1
"5047",2024-01-01,"40 - 1114",228,231,228,0,3,1
"5048",2024-01-01,"2 - 1066",49,40,49,0,-9,1
"5049",2024-01-01,"82 - 1163",146,148,145,1,2,0.993150684931507
"5050",2024-01-02,"40 - 1320",206,207,206,0,1,1
"5051",2024-01-02,"40 - 1114",228,231,227,1,3,0.995614035087719
"5052",2024-01-02,"2 - 1066",49,40,49,0,-9,1
"5053",2024-01-02,"82 - 1163",147,148,147,0,1,1
"5054",2024-01-03,"40 - 1320",207,207,206,1,0,0.995169082125604
"5055",2024-01-03,"40 - 1114",228,231,228,0,3,1
"5056",2024-01-03,"2 - 1066",48,40,48,0,-8,1
"5057",2024-01-03,"82 - 1163",147,148,147,0,1,1
"5058",2024-01-04,"40 - 1320",207,207,207,0,0,1
"5059",2024-01-04,"40 - 1114",228,231,228,0,3,1
"5060",2024-01-04,"2 - 1066",48,40,48,0,-8,1
"5061",2024-01-04,"82 - 1163",148,148,148,0,0,1
"5062",2024-01-05,"40 - 1320",206,207,206,0,1,1
"5063",2024-01-05,"40 - 1114",230,231,230,0,1,1
"5064",2024-01-05,"2 - 1066",48,40,48,0,-8,1
"5065",2024-01-05,"82 - 1163",147,148,147,0,1,1
"5066",2024-01-06,"40 - 1320",206,207,206,0,1,1
"5067",2024-01-06,"40 - 1114",230,231,230,0,1,1
"5068",2024-01-06,"2 - 1066",47,40,46,1,-7,0.978723404255319
"5069",2024-01-06,"82 - 1163",149,148,149,0,-1,1
"5070",2024-01-07,"40 - 1320",207,207,207,0,0,1
"5071",2024-01-07,"40 - 1114",230,231,230,0,1,1
"5072",2024-01-07,"2 - 1066",47,40,47,0,-7,1
"5073",2024-01-07,"82 - 1163",148,148,148,0,0,1
"5074",2024-01-08,"40 - 1320",207,207,206,1,0,0.995169082125604
"5075",2024-01-08,"40 - 1114",229,231,229,0,2,1
"5076",2024-01-08,"2 - 1066",46,40,46,0,-6,1
"5077",2024-01-08,"82 - 1163",146,148,146,0,2,1
"5078",2024-01-09,"40 - 1320",207,207,207,0,0,1
"5079",2024-01-09,"40 - 1114",229,231,228,1,2,0.995633187772926
"5080",2024-01-09,"2 - 1066",46,40,46,0,-6,1
"5081",2024-01-09,"82 - 1163",146,148,146,0,2,1
"5082",2024-01-10,"40 - 1320",207,207,207,0,0,1
"5083",2024-01-10,"40 - 1114",229,231,229,0,2,1
"5084",2024-01-10,"2 - 1066",46,40,46,0,-6,1
"5085",2024-01-10,"82 - 1163",146,148,146,0,2,1
"5086",2024-01-11,"40 - 1320",207,207,207,0,0,1
"5087",2024-01-11,"40 - 1114",229,231,229,0,2,1
"5088",2024-01-11,"2 - 1066",45,40,45,0,-5,1
"5089",2024-01-11,"82 - 1163",152,148,152,0,-4,1
"5090",2024-01-12,"40 - 1320",207,207,207,0,0,1
"5091",2024-01-12,"40 - 1114",229,231,229,0,2,1
"5092",2024-01-12,"2 - 1066",46,40,46,0,-6,1
"5093",2024-01-12,"82 - 1163",157,148,157,0,-9,1
"5094",2024-01-13,"40 - 1320",207,207,207,0,0,1
"5095",2024-01-13,"40 - 1114",227,231,227,0,4,1
"5096",2024-01-13,"2 - 1066",48,40,48,0,-8,1
"5097",2024-01-13,"82 - 1163",156,148,156,0,-8,1
"5098",2024-01-14,"40 - 1320",207,207,206,1,0,0.995169082125604
"5099",2024-01-14,"40 - 1114",227,231,227,0,4,1
"5100",2024-01-14,"2 - 1066",48,40,48,0,-8,1
"5101",2024-01-14,"82 - 1163",155,148,155,0,-7,1
"5102",2024-01-15,"40 - 1320",207,207,206,1,0,0.995169082125604
"5103",2024-01-15,"40 - 1114",227,231,227,0,4,1
"5104",2024-01-15,"2 - 1066",48,40,48,0,-8,1
"5105",2024-01-15,"82 - 1163",151,148,151,0,-3,1
"5106",2024-01-16,"40 - 1320",205,207,204,1,2,0.995121951219512
"5107",2024-01-16,"40 - 1114",227,231,227,0,4,1
"5108",2024-01-16,"2 - 1066",47,40,47,0,-7,1
"5109",2024-01-16,"82 - 1163",149,148,149,0,-1,1
"5110",2024-01-17,"40 - 1320",206,207,205,1,1,0.995145631067961
"5111",2024-01-17,"40 - 1114",228,231,228,0,3,1
"5112",2024-01-17,"2 - 1066",47,40,47,0,-7,1
"5113",2024-01-17,"82 - 1163",147,148,147,0,1,1
"5114",2024-01-18,"40 - 1320",205,207,205,0,2,1
"5115",2024-01-18,"40 - 1114",228,231,228,0,3,1
"5116",2024-01-18,"2 - 1066",48,40,48,0,-8,1
"5117",2024-01-18,"82 - 1163",149,148,149,0,-1,1
"5118",2024-01-19,"40 - 1320",206,207,204,2,1,0.990291262135922
"5119",2024-01-19,"40 - 1114",230,231,230,0,1,1
"5120",2024-01-19,"2 - 1066",48,40,48,0,-8,1
"5121",2024-01-19,"82 - 1163",151,148,151,0,-3,1
"5122",2024-01-20,"40 - 1320",206,207,204,2,1,0.990291262135922
"5123",2024-01-20,"40 - 1114",228,231,228,0,3,1
"5124",2024-01-20,"2 - 1066",49,40,49,0,-9,1
"5125",2024-01-20,"82 - 1163",152,148,152,0,-4,1
"5126",2024-01-21,"40 - 1320",204,207,204,0,3,1
"5127",2024-01-21,"40 - 1114",226,231,226,0,5,1
"5128",2024-01-21,"2 - 1066",49,40,49,0,-9,1
"5129",2024-01-21,"82 - 1163",150,148,150,0,-2,1
"5130",2024-01-22,"40 - 1320",205,207,204,1,2,0.995121951219512
"5131",2024-01-22,"40 - 1114",226,231,226,0,5,1
"5132",2024-01-22,"2 - 1066",49,40,49,0,-9,1
"5133",2024-01-22,"82 - 1163",149,148,149,0,-1,1
"5134",2024-01-23,"40 - 1320",205,207,205,0,2,1
"5135",2024-01-23,"40 - 1114",227,231,227,0,4,1
"5136",2024-01-23,"2 - 1066",50,40,50,0,-10,1
"5137",2024-01-23,"82 - 1163",148,148,148,0,0,1
"5138",2024-01-24,"40 - 1320",206,207,206,0,1,1
"5139",2024-01-24,"40 - 1114",228,231,228,0,3,1
"5140",2024-01-24,"2 - 1066",51,40,50,1,-11,0.980392156862745
"5141",2024-01-24,"82 - 1163",148,148,148,0,0,1
"5142",2024-01-25,"40 - 1320",206,207,206,0,1,1
"5143",2024-01-25,"40 - 1114",228,231,228,0,3,1
"5144",2024-01-25,"2 - 1066",49,40,49,0,-9,1
"5145",2024-01-25,"82 - 1163",149,148,148,1,-1,0.993288590604027
"5146",2024-01-26,"40 - 1320",206,207,206,0,1,1
"5147",2024-01-26,"40 - 1114",227,231,227,0,4,1
"5148",2024-01-26,"2 - 1066",49,40,49,0,-9,1
"5149",2024-01-26,"82 - 1163",151,148,151,0,-3,1
"5150",2024-01-27,"40 - 1320",207,207,206,1,0,0.995169082125604
"5151",2024-01-27,"40 - 1114",228,231,228,0,3,1
"5152",2024-01-27,"2 - 1066",49,40,49,0,-9,1
"5153",2024-01-27,"82 - 1163",151,148,151,0,-3,1
"5154",2024-01-28,"40 - 1320",207,207,207,0,0,1
"5155",2024-01-28,"40 - 1114",228,231,228,0,3,1
"5156",2024-01-28,"2 - 1066",49,40,48,1,-9,0.979591836734694
"5157",2024-01-28,"82 - 1163",151,148,151,0,-3,1
"5158",2024-01-29,"40 - 1320",207,207,206,1,0,0.995169082125604
"5159",2024-01-29,"40 - 1114",229,231,229,0,2,1
"5160",2024-01-29,"2 - 1066",49,40,49,0,-9,1
"5161",2024-01-29,"82 - 1163",149,148,149,0,-1,1
"5162",2024-01-30,"40 - 1320",207,207,206,1,0,0.995169082125604
"5163",2024-01-30,"40 - 1114",229,231,229,0,2,1
"5164",2024-01-30,"2 - 1066",49,40,49,0,-9,1
"5165",2024-01-30,"82 - 1163",149,148,149,0,-1,1
"5166",2024-01-31,"40 - 1320",207,207,206,1,0,0.995169082125604
"5167",2024-01-31,"40 - 1114",230,231,230,0,1,1
"5168",2024-01-31,"2 - 1066",49,40,49,0,-9,1
"5169",2024-01-31,"82 - 1163",149,148,149,0,-1,1
"5170",2024-02-01,"40 - 1320",205,207,204,1,2,0.995121951219512
"5171",2024-02-01,"40 - 1114",228,231,228,0,3,1
"5172",2024-02-01,"2 - 1066",46,40,46,0,-6,1
"5173",2024-02-01,"82 - 1163",149,148,149,0,-1,1
"5174",2024-02-02,"40 - 1320",203,207,203,0,4,1
"5175",2024-02-02,"40 - 1114",228,231,228,0,3,1
"5176",2024-02-02,"2 - 1066",50,40,46,4,-10,0.92
"5177",2024-02-02,"82 - 1163",149,148,149,0,-1,1
"5178",2024-02-03,"40 - 1320",205,207,205,0,2,1
"5179",2024-02-03,"40 - 1114",226,231,226,0,5,1
"5180",2024-02-03,"2 - 1066",45,40,45,0,-5,1
"5181",2024-02-03,"82 - 1163",148,148,147,1,0,0.993243243243243
"5182",2024-02-04,"40 - 1320",207,207,207,0,0,1
"5183",2024-02-04,"40 - 1114",226,231,226,0,5,1
"5184",2024-02-04,"2 - 1066",45,40,45,0,-5,1
"5185",2024-02-04,"82 - 1163",148,148,148,0,0,1
"5186",2024-02-05,"40 - 1320",207,207,207,0,0,1
"5187",2024-02-05,"40 - 1114",226,231,226,0,5,1
"5188",2024-02-05,"2 - 1066",45,40,45,0,-5,1
"5189",2024-02-05,"82 - 1163",146,148,146,0,2,1
"5190",2024-02-06,"40 - 1320",206,207,206,0,1,1
"5191",2024-02-06,"40 - 1114",227,231,227,0,4,1
"5192",2024-02-06,"2 - 1066",44,40,44,0,-4,1
"5193",2024-02-06,"82 - 1163",146,148,145,1,2,0.993150684931507
"5194",2024-02-07,"40 - 1320",206,207,205,1,1,0.995145631067961
"5195",2024-02-07,"40 - 1114",226,231,226,0,5,1
"5196",2024-02-07,"2 - 1066",45,40,45,0,-5,1
"5197",2024-02-07,"82 - 1163",147,148,147,0,1,1
"5198",2024-02-08,"40 - 1320",205,207,205,0,2,1
"5199",2024-02-08,"40 - 1114",225,231,225,0,6,1
"5200",2024-02-08,"2 - 1066",47,40,47,0,-7,1
"5201",2024-02-08,"82 - 1163",146,148,146,0,2,1
"5202",2024-02-09,"40 - 1320",206,207,206,0,1,1
"5203",2024-02-09,"40 - 1114",223,231,223,0,8,1
"5204",2024-02-09,"2 - 1066",46,40,46,0,-6,1
"5205",2024-02-09,"82 - 1163",147,148,147,0,1,1
"5206",2024-02-10,"40 - 1320",206,207,206,0,1,1
"5207",2024-02-10,"40 - 1114",225,231,224,1,6,0.995555555555556
"5208",2024-02-10,"2 - 1066",46,40,46,0,-6,1
"5209",2024-02-10,"82 - 1163",146,148,146,0,2,1
"5210",2024-02-11,"40 - 1320",206,207,206,0,1,1
"5211",2024-02-11,"40 - 1114",227,231,226,1,4,0.995594713656388
"5212",2024-02-11,"2 - 1066",50,40,49,1,-10,0.98
"5213",2024-02-11,"82 - 1163",147,148,147,0,1,1
"5214",2024-02-12,"40 - 1320",206,207,205,1,1,0.995145631067961
"5215",2024-02-12,"40 - 1114",226,231,226,0,5,1
"5216",2024-02-12,"2 - 1066",50,40,50,0,-10,1
"5217",2024-02-12,"82 - 1163",147,148,147,0,1,1
"5218",2024-02-13,"40 - 1320",205,207,204,1,2,0.995121951219512
"5219",2024-02-13,"40 - 1114",224,231,224,0,7,1
"5220",2024-02-13,"2 - 1066",50,40,50,0,-10,1
"5221",2024-02-13,"82 - 1163",152,148,152,0,-4,1
"5222",2024-02-14,"40 - 1320",204,207,204,0,3,1
"5223",2024-02-14,"40 - 1114",225,231,225,0,6,1
"5224",2024-02-14,"2 - 1066",51,40,50,1,-11,0.980392156862745
"5225",2024-02-14,"82 - 1163",151,148,151,0,-3,1
"5226",2024-02-15,"40 - 1320",206,207,205,1,1,0.995145631067961
"5227",2024-02-15,"40 - 1114",226,231,226,0,5,1
"5228",2024-02-15,"2 - 1066",51,40,50,1,-11,0.980392156862745
"5229",2024-02-15,"82 - 1163",152,148,152,0,-4,1
"5230",2024-02-16,"40 - 1320",205,207,205,0,2,1
"5231",2024-02-16,"40 - 1114",226,231,226,0,5,1
"5232",2024-02-16,"2 - 1066",51,40,51,0,-11,1
"5233",2024-02-16,"82 - 1163",155,148,155,0,-7,1
"5234",2024-02-17,"40 - 1320",206,207,206,0,1,1
"5235",2024-02-17,"40 - 1114",226,231,226,0,5,1
"5236",2024-02-17,"2 - 1066",51,40,51,0,-11,1
"5237",2024-02-17,"82 - 1163",154,148,154,0,-6,1
"5238",2024-02-18,"40 - 1320",207,207,207,0,0,1
"5239",2024-02-18,"40 - 1114",226,231,226,0,5,1
"5240",2024-02-18,"2 - 1066",51,40,51,0,-11,1
"5241",2024-02-18,"82 - 1163",155,148,155,0,-7,1
"5242",2024-02-19,"40 - 1320",207,207,207,0,0,1
"5243",2024-02-19,"40 - 1114",226,231,226,0,5,1
"5244",2024-02-19,"2 - 1066",51,40,51,0,-11,1
"5245",2024-02-19,"82 - 1163",156,148,156,0,-8,1
"5246",2024-02-20,"40 - 1320",207,207,207,0,0,1
"5247",2024-02-20,"40 - 1114",226,231,226,0,5,1
"5248",2024-02-20,"2 - 1066",51,40,51,0,-11,1
"5249",2024-02-20,"82 - 1163",155,148,155,0,-7,1
"5250",2024-02-21,"40 - 1320",207,207,207,0,0,1
"5251",2024-02-21,"40 - 1114",227,231,227,0,4,1
"5252",2024-02-21,"2 - 1066",51,40,51,0,-11,1
"5253",2024-02-21,"82 - 1163",155,148,155,0,-7,1
"5254",2024-02-22,"40 - 1320",207,207,207,0,0,1
"5255",2024-02-22,"40 - 1114",228,231,228,0,3,1
"5256",2024-02-22,"2 - 1066",51,40,51,0,-11,1
"5257",2024-02-22,"82 - 1163",156,148,156,0,-8,1
"5258",2024-02-23,"40 - 1320",207,207,207,0,0,1
"5259",2024-02-23,"40 - 1114",227,231,227,0,4,1
"5260",2024-02-23,"2 - 1066",51,40,51,0,-11,1
"5261",2024-02-23,"82 - 1163",157,148,154,3,-9,0.980891719745223
"5262",2024-02-24,"40 - 1320",207,207,207,0,0,1
"5263",2024-02-24,"40 - 1114",227,231,227,0,4,1
"5264",2024-02-24,"2 - 1066",51,40,51,0,-11,1
"5265",2024-02-24,"82 - 1163",153,148,150,3,-5,0.980392156862745
"5266",2024-02-25,"40 - 1320",207,207,207,0,0,1
"5267",2024-02-25,"40 - 1114",227,231,227,0,4,1
"5268",2024-02-25,"2 - 1066",51,40,51,0,-11,1
"5269",2024-02-25,"82 - 1163",150,148,150,0,-2,1
"5270",2024-02-26,"40 - 1320",207,207,207,0,0,1
"5271",2024-02-26,"40 - 1114",226,231,226,0,5,1
"5272",2024-02-26,"2 - 1066",50,40,50,0,-10,1
"5273",2024-02-26,"82 - 1163",147,148,147,0,1,1
"5274",2024-02-27,"40 - 1320",207,207,207,0,0,1
"5275",2024-02-27,"40 - 1114",225,231,225,0,6,1
"5276",2024-02-27,"2 - 1066",49,40,49,0,-9,1
"5277",2024-02-27,"82 - 1163",146,148,146,0,2,1
"5278",2024-02-28,"40 - 1320",207,207,207,0,0,1
"5279",2024-02-28,"40 - 1114",225,231,225,0,6,1
"5280",2024-02-28,"2 - 1066",49,40,49,0,-9,1
"5281",2024-02-28,"82 - 1163",143,148,143,0,5,1
"5282",2024-02-29,"40 - 1320",207,207,207,0,0,1
"5283",2024-02-29,"40 - 1114",224,231,224,0,7,1
"5284",2024-02-29,"2 - 1066",49,40,49,0,-9,1
"5285",2024-02-29,"82 - 1163",143,148,143,0,5,1
"5286",2024-03-01,"40 - 1320",205,207,203,2,2,0.990243902439024
"5287",2024-03-01,"40 - 1114",222,231,222,0,9,1
"5288",2024-03-01,"2 - 1066",46,40,46,0,-6,1
"5289",2024-03-01,"82 - 1163",143,148,143,0,5,1
"5290",2024-03-02,"40 - 1320",202,207,202,0,5,1
"5291",2024-03-02,"40 - 1114",222,231,222,0,9,1
"5292",2024-03-02,"2 - 1066",49,40,46,3,-9,0.938775510204082
"5293",2024-03-02,"82 - 1163",143,148,143,0,5,1
"5294",2024-03-03,"40 - 1320",203,207,202,1,4,0.995073891625616
"5295",2024-03-03,"40 - 1114",224,231,224,0,7,1
"5296",2024-03-03,"2 - 1066",46,40,45,1,-6,0.978260869565217
"5297",2024-03-03,"82 - 1163",144,148,144,0,4,1
"5298",2024-03-04,"40 - 1320",204,207,203,1,3,0.995098039215686
"5299",2024-03-04,"40 - 1114",224,231,224,0,7,1
"5300",2024-03-04,"2 - 1066",47,40,47,0,-7,1
"5301",2024-03-04,"82 - 1163",145,148,145,0,3,1
"5302",2024-03-05,"40 - 1320",202,207,202,0,5,1
"5303",2024-03-05,"40 - 1114",225,232,225,0,7,1
"5304",2024-03-05,"2 - 1066",45,40,45,0,-5,1
"5305",2024-03-05,"82 - 1163",146,148,146,0,2,1
"5306",2024-03-06,"40 - 1320",205,207,204,1,2,0.995121951219512
"5307",2024-03-06,"40 - 1114",227,232,227,0,5,1
"5308",2024-03-06,"2 - 1066",47,40,45,2,-7,0.957446808510638
"5309",2024-03-06,"82 - 1163",148,148,147,1,0,0.993243243243243
"5310",2024-03-07,"40 - 1320",207,207,206,1,0,0.995169082125604
"5311",2024-03-07,"40 - 1114",228,232,228,0,4,1
"5312",2024-03-07,"2 - 1066",47,40,47,0,-7,1
"5313",2024-03-07,"82 - 1163",149,148,149,0,-1,1
"5314",2024-03-08,"40 - 1320",204,207,204,0,3,1
"5315",2024-03-08,"40 - 1114",226,232,226,0,6,1
"5316",2024-03-08,"2 - 1066",47,40,47,0,-7,1
"5317",2024-03-08,"82 - 1163",151,148,151,0,-3,1
"5318",2024-03-09,"40 - 1320",205,207,205,0,2,1
"5319",2024-03-09,"40 - 1114",226,232,226,0,6,1
"5320",2024-03-09,"2 - 1066",46,40,46,0,-6,1
"5321",2024-03-09,"82 - 1163",150,148,150,0,-2,1
"5322",2024-03-10,"40 - 1320",206,207,206,0,1,1
"5323",2024-03-10,"40 - 1114",226,232,226,0,6,1
"5324",2024-03-10,"2 - 1066",46,40,46,0,-6,1
"5325",2024-03-10,"82 - 1163",150,148,150,0,-2,1
"5326",2024-03-11,"40 - 1320",206,207,206,0,1,1
"5327",2024-03-11,"40 - 1114",225,232,225,0,7,1
"5328",2024-03-11,"2 - 1066",46,40,46,0,-6,1
"5329",2024-03-11,"82 - 1163",148,148,148,0,0,1
"5330",2024-03-12,"40 - 1320",207,207,207,0,0,1
"5331",2024-03-12,"40 - 1114",224,232,224,0,8,1
"5332",2024-03-12,"2 - 1066",47,40,47,0,-7,1
"5333",2024-03-12,"82 - 1163",146,148,146,0,2,1
"5334",2024-03-13,"40 - 1320",207,207,207,0,0,1
"5335",2024-03-13,"40 - 1114",227,232,227,0,5,1
"5336",2024-03-13,"2 - 1066",49,40,48,1,-9,0.979591836734694
"5337",2024-03-13,"82 - 1163",144,148,144,0,4,1
"5338",2024-03-14,"40 - 1320",207,207,207,0,0,1
"5339",2024-03-14,"40 - 1114",229,232,228,1,3,0.995633187772926
"5340",2024-03-14,"2 - 1066",49,40,49,0,-9,1
"5341",2024-03-14,"82 - 1163",144,148,144,0,4,1
"5342",2024-03-15,"40 - 1320",206,207,205,1,1,0.995145631067961
"5343",2024-03-15,"40 - 1114",229,232,229,0,3,1
"5344",2024-03-15,"2 - 1066",49,40,49,0,-9,1
"5345",2024-03-15,"82 - 1163",145,148,145,0,3,1
"5346",2024-03-16,"40 - 1320",204,207,203,1,3,0.995098039215686
"5347",2024-03-16,"40 - 1114",228,232,228,0,4,1
"5348",2024-03-16,"2 - 1066",49,40,49,0,-9,1
"5349",2024-03-16,"82 - 1163",144,148,144,0,4,1
"5350",2024-03-17,"40 - 1320",203,207,203,0,4,1
"5351",2024-03-17,"40 - 1114",228,232,228,0,4,1
"5352",2024-03-17,"2 - 1066",49,40,49,0,-9,1
"5353",2024-03-17,"82 - 1163",152,148,151,1,-4,0.993421052631579
"5354",2024-03-18,"40 - 1320",204,207,204,0,3,1
"5355",2024-03-18,"40 - 1114",227,232,227,0,5,1
"5356",2024-03-18,"2 - 1066",48,40,48,0,-8,1
"5357",2024-03-18,"82 - 1163",151,148,151,0,-3,1
"5358",2024-03-19,"40 - 1320",205,207,205,0,2,1
"5359",2024-03-19,"40 - 1114",227,232,227,0,5,1
"5360",2024-03-19,"2 - 1066",49,40,49,0,-9,1
"5361",2024-03-19,"82 - 1163",149,148,149,0,-1,1
"5362",2024-03-20,"40 - 1320",205,207,204,1,2,0.995121951219512
"5363",2024-03-20,"40 - 1114",229,232,228,1,3,0.995633187772926
"5364",2024-03-20,"2 - 1066",50,40,50,0,-10,1
"5365",2024-03-20,"82 - 1163",150,148,150,0,-2,1
"5366",2024-03-21,"40 - 1320",206,207,205,1,1,0.995145631067961
"5367",2024-03-21,"40 - 1114",229,232,229,0,3,1
"5368",2024-03-21,"2 - 1066",50,40,50,0,-10,1
"5369",2024-03-21,"82 - 1163",153,148,153,0,-5,1
"5370",2024-03-22,"40 - 1320",207,207,206,1,0,0.995169082125604
"5371",2024-03-22,"40 - 1114",229,232,229,0,3,1
"5372",2024-03-22,"2 - 1066",50,40,50,0,-10,1
"5373",2024-03-22,"82 - 1163",153,148,153,0,-5,1
"5374",2024-03-23,"40 - 1320",207,207,207,0,0,1
"5375",2024-03-23,"40 - 1114",229,232,229,0,3,1
"5376",2024-03-23,"2 - 1066",51,40,51,0,-11,1
"5377",2024-03-23,"82 - 1163",153,148,153,0,-5,1
"5378",2024-03-24,"40 - 1320",207,207,207,0,0,1
"5379",2024-03-24,"40 - 1114",229,231,229,0,2,1
"5380",2024-03-24,"2 - 1066",51,40,51,0,-11,1
"5381",2024-03-24,"82 - 1163",154,148,154,0,-6,1
"5382",2024-03-25,"40 - 1320",207,207,207,0,0,1
"5383",2024-03-25,"40 - 1114",229,231,229,0,2,1
"5384",2024-03-25,"2 - 1066",51,40,51,0,-11,1
"5385",2024-03-25,"82 - 1163",153,148,153,0,-5,1
"5386",2024-03-26,"40 - 1320",207,207,207,0,0,1
"5387",2024-03-26,"40 - 1114",229,231,229,0,2,1
"5388",2024-03-26,"2 - 1066",50,40,50,0,-10,1
"5389",2024-03-26,"82 - 1163",158,148,158,0,-10,1
"5390",2024-03-27,"40 - 1320",206,207,206,0,1,1
"5391",2024-03-27,"40 - 1114",228,231,228,0,3,1
"5392",2024-03-27,"2 - 1066",50,40,50,0,-10,1
"5393",2024-03-27,"82 - 1163",157,148,157,0,-9,1
"5394",2024-03-28,"40 - 1320",207,207,207,0,0,1
"5395",2024-03-28,"40 - 1114",226,231,226,0,5,1
"5396",2024-03-28,"2 - 1066",50,40,50,0,-10,1
"5397",2024-03-28,"82 - 1163",157,148,157,0,-9,1
"5398",2024-03-29,"40 - 1320",206,207,206,0,1,1
"5399",2024-03-29,"40 - 1114",228,231,227,1,3,0.995614035087719
"5400",2024-03-29,"2 - 1066",50,40,50,0,-10,1
"5401",2024-03-29,"82 - 1163",162,148,161,1,-14,0.993827160493827
"5402",2024-03-30,"40 - 1320",206,207,206,0,1,1
"5403",2024-03-30,"40 - 1114",227,231,227,0,4,1
"5404",2024-03-30,"2 - 1066",50,40,50,0,-10,1
"5405",2024-03-30,"82 - 1163",162,148,162,0,-14,1
"5406",2024-03-31,"40 - 1320",206,207,206,0,1,1
"5407",2024-03-31,"40 - 1114",227,231,227,0,4,1
"5408",2024-03-31,"2 - 1066",50,40,50,0,-10,1
"5409",2024-03-31,"82 - 1163",162,148,162,0,-14,1
"5410",2024-04-01,"40 - 1320",204,207,204,0,3,1
"5411",2024-04-01,"40 - 1114",226,231,226,0,5,1
"5412",2024-04-01,"2 - 1066",50,40,50,0,-10,1
"5413",2024-04-01,"82 - 1163",162,148,162,0,-14,1
"5414",2024-04-02,"40 - 1320",204,207,204,0,3,1
"5415",2024-04-02,"40 - 1114",226,231,226,0,5,1
"5416",2024-04-02,"2 - 1066",50,40,50,0,-10,1
"5417",2024-04-02,"82 - 1163",161,148,161,0,-13,1
"5418",2024-04-03,"40 - 1320",205,207,204,1,2,0.995121951219512
"5419",2024-04-03,"40 - 1114",227,231,227,0,4,1
"5420",2024-04-03,"2 - 1066",50,40,50,0,-10,1
"5421",2024-04-03,"82 - 1163",161,148,161,0,-13,1
"5422",2024-04-04,"40 - 1320",204,207,204,0,3,1
"5423",2024-04-04,"40 - 1114",226,231,226,0,5,1
"5424",2024-04-04,"2 - 1066",50,40,50,0,-10,1
"5425",2024-04-04,"82 - 1163",160,148,160,0,-12,1
"5426",2024-04-05,"40 - 1320",204,207,204,0,3,1
"5427",2024-04-05,"40 - 1114",226,231,226,0,5,1
"5428",2024-04-05,"2 - 1066",50,40,50,0,-10,1
"5429",2024-04-05,"82 - 1163",162,148,162,0,-14,1
"5430",2024-04-06,"40 - 1320",206,207,204,2,1,0.990291262135922
"5431",2024-04-06,"40 - 1114",226,231,226,0,5,1
"5432",2024-04-06,"2 - 1066",50,40,50,0,-10,1
"5433",2024-04-06,"82 - 1163",162,148,162,0,-14,1
"5434",2024-04-07,"40 - 1320",206,207,206,0,1,1
"5435",2024-04-07,"40 - 1114",226,231,226,0,5,1
"5436",2024-04-07,"2 - 1066",50,40,50,0,-10,1
"5437",2024-04-07,"82 - 1163",160,148,160,0,-12,1
"5438",2024-04-08,"40 - 1320",206,207,206,0,1,1
"5439",2024-04-08,"40 - 1114",228,231,228,0,3,1
"5440",2024-04-08,"2 - 1066",49,40,49,0,-9,1
"5441",2024-04-08,"82 - 1163",163,148,163,0,-15,1
"5442",2024-04-09,"40 - 1320",206,207,206,0,1,1
"5443",2024-04-09,"40 - 1114",228,231,228,0,3,1
"5444",2024-04-09,"2 - 1066",49,40,49,0,-9,1
"5445",2024-04-09,"82 - 1163",163,148,163,0,-15,1
"5446",2024-04-10,"40 - 1320",207,207,206,1,0,0.995169082125604
"5447",2024-04-10,"40 - 1114",228,231,228,0,3,1
"5448",2024-04-10,"2 - 1066",50,40,50,0,-10,1
"5449",2024-04-10,"82 - 1163",164,148,164,0,-16,1
"5450",2024-04-11,"40 - 1320",207,207,207,0,0,1
"5451",2024-04-11,"40 - 1114",229,231,229,0,2,1
"5452",2024-04-11,"2 - 1066",50,40,50,0,-10,1
"5453",2024-04-11,"82 - 1163",167,148,167,0,-19,1
"5454",2024-04-12,"40 - 1320",207,207,207,0,0,1
"5455",2024-04-12,"40 - 1114",229,231,228,1,2,0.995633187772926
"5456",2024-04-12,"2 - 1066",50,40,50,0,-10,1
"5457",2024-04-12,"82 - 1163",166,148,163,3,-18,0.981927710843373
"5458",2024-04-13,"40 - 1320",207,207,207,0,0,1
"5459",2024-04-13,"40 - 1114",227,231,226,1,4,0.995594713656388
"5460",2024-04-13,"2 - 1066",49,40,49,0,-9,1
"5461",2024-04-13,"82 - 1163",163,148,163,0,-15,1
"5462",2024-04-14,"40 - 1320",207,207,207,0,0,1
"5463",2024-04-14,"40 - 1114",227,231,226,1,4,0.995594713656388
"5464",2024-04-14,"2 - 1066",48,40,48,0,-8,1
"5465",2024-04-14,"82 - 1163",163,148,163,0,-15,1
"5466",2024-04-15,"40 - 1320",206,207,206,0,1,1
"5467",2024-04-15,"40 - 1114",226,231,226,0,5,1
"5468",2024-04-15,"2 - 1066",48,40,48,0,-8,1
"5469",2024-04-15,"82 - 1163",163,148,163,0,-15,1
"5470",2024-04-16,"40 - 1320",206,207,206,0,1,1
"5471",2024-04-16,"40 - 1114",225,231,225,0,6,1
"5472",2024-04-16,"2 - 1066",48,40,48,0,-8,1
"5473",2024-04-16,"82 - 1163",163,148,163,0,-15,1
"5474",2024-04-17,"40 - 1320",206,207,206,0,1,1
"5475",2024-04-17,"40 - 1114",225,231,225,0,6,1
"5476",2024-04-17,"2 - 1066",48,40,48,0,-8,1
"5477",2024-04-17,"82 - 1163",161,148,161,0,-13,1
"5478",2024-04-18,"40 - 1320",206,207,206,0,1,1
"5479",2024-04-18,"40 - 1114",226,231,226,0,5,1
"5480",2024-04-18,"2 - 1066",49,40,49,0,-9,1
"5481",2024-04-18,"82 - 1163",160,148,160,0,-12,1
"5482",2024-04-19,"40 - 1320",206,207,205,1,1,0.995145631067961
"5483",2024-04-19,"40 - 1114",228,231,227,1,3,0.995614035087719
"5484",2024-04-19,"2 - 1066",49,40,49,0,-9,1
"5485",2024-04-19,"82 - 1163",160,148,160,0,-12,1
"5486",2024-04-20,"40 - 1320",205,207,205,0,2,1
"5487",2024-04-20,"40 - 1114",228,231,228,0,3,1
"5488",2024-04-20,"2 - 1066",48,40,48,0,-8,1
"5489",2024-04-20,"82 - 1163",161,148,161,0,-13,1
"5490",2024-04-21,"40 - 1320",206,207,206,0,1,1
"5491",2024-04-21,"40 - 1114",228,231,228,0,3,1
"5492",2024-04-21,"2 - 1066",48,40,48,0,-8,1
"5493",2024-04-21,"82 - 1163",160,148,160,0,-12,1
"5494",2024-04-22,"40 - 1320",206,207,206,0,1,1
"5495",2024-04-22,"40 - 1114",228,231,228,0,3,1
"5496",2024-04-22,"2 - 1066",48,40,48,0,-8,1
"5497",2024-04-22,"82 - 1163",160,148,160,0,-12,1
"5498",2024-04-23,"40 - 1320",207,207,207,0,0,1
"5499",2024-04-23,"40 - 1114",228,231,228,0,3,1
"5500",2024-04-23,"2 - 1066",49,40,49,0,-9,1
"5501",2024-04-23,"82 - 1163",159,148,159,0,-11,1
"5502",2024-04-24,"40 - 1320",207,207,207,0,0,1
"5503",2024-04-24,"40 - 1114",229,231,228,1,2,0.995633187772926
"5504",2024-04-24,"2 - 1066",49,40,49,0,-9,1
"5505",2024-04-24,"82 - 1163",160,148,160,0,-12,1
"5506",2024-04-25,"40 - 1320",207,207,207,0,0,1
"5507",2024-04-25,"40 - 1114",228,231,228,0,3,1
"5508",2024-04-25,"2 - 1066",49,40,49,0,-9,1
"5509",2024-04-25,"82 - 1163",162,148,162,0,-14,1
"5510",2024-04-26,"40 - 1320",207,207,207,0,0,1
"5511",2024-04-26,"40 - 1114",228,231,228,0,3,1
"5512",2024-04-26,"2 - 1066",49,40,49,0,-9,1
"5513",2024-04-26,"82 - 1163",163,148,163,0,-15,1
"5514",2024-04-27,"40 - 1320",207,207,207,0,0,1
"5515",2024-04-27,"40 - 1114",228,231,228,0,3,1
"5516",2024-04-27,"2 - 1066",49,40,49,0,-9,1
"5517",2024-04-27,"82 - 1163",162,148,162,0,-14,1
"5518",2024-04-28,"40 - 1320",207,207,207,0,0,1
"5519",2024-04-28,"40 - 1114",228,231,228,0,3,1
"5520",2024-04-28,"2 - 1066",49,40,49,0,-9,1
"5521",2024-04-28,"82 - 1163",162,148,162,0,-14,1
"5522",2024-04-29,"40 - 1320",207,207,207,0,0,1
"5523",2024-04-29,"40 - 1114",228,231,228,0,3,1
"5524",2024-04-29,"2 - 1066",49,40,49,0,-9,1
"5525",2024-04-29,"82 - 1163",166,148,166,0,-18,1
"5526",2024-04-30,"40 - 1320",207,207,207,0,0,1
"5527",2024-04-30,"40 - 1114",229,231,229,0,2,1
"5528",2024-04-30,"2 - 1066",49,40,49,0,-9,1
"5529",2024-04-30,"82 - 1163",164,148,164,0,-16,1
"5530",2024-05-01,"40 - 1320",207,207,207,0,0,1
"5531",2024-05-01,"40 - 1114",229,231,229,0,2,1
"5532",2024-05-01,"2 - 1066",49,40,49,0,-9,1
"5533",2024-05-01,"82 - 1163",168,148,168,0,-20,1
"5534",2024-05-02,"40 - 1320",207,207,207,0,0,1
"5535",2024-05-02,"40 - 1114",229,231,229,0,2,1
"5536",2024-05-02,"2 - 1066",50,40,50,0,-10,1
"5537",2024-05-02,"82 - 1163",171,148,171,0,-23,1
"5538",2024-05-03,"40 - 1320",207,207,207,0,0,1
"5539",2024-05-03,"40 - 1114",229,231,229,0,2,1
"5540",2024-05-03,"2 - 1066",50,40,50,0,-10,1
"5541",2024-05-03,"82 - 1163",165,148,161,4,-17,0.975757575757576
"5542",2024-05-04,"40 - 1320",207,207,207,0,0,1
"5543",2024-05-04,"40 - 1114",229,231,229,0,2,1
"5544",2024-05-04,"2 - 1066",50,40,50,0,-10,1
"5545",2024-05-04,"82 - 1163",162,148,162,0,-14,1
"5546",2024-05-05,"40 - 1320",207,207,207,0,0,1
"5547",2024-05-05,"40 - 1114",229,231,229,0,2,1
"5548",2024-05-05,"2 - 1066",50,40,50,0,-10,1
"5549",2024-05-05,"82 - 1163",161,148,161,0,-13,1
"5550",2024-05-06,"40 - 1320",207,207,207,0,0,1
"5551",2024-05-06,"40 - 1114",230,231,230,0,1,1
"5552",2024-05-06,"2 - 1066",50,40,50,0,-10,1
"5553",2024-05-06,"82 - 1163",162,148,162,0,-14,1
"5554",2024-05-07,"40 - 1320",207,207,207,0,0,1
"5555",2024-05-07,"40 - 1114",230,231,230,0,1,1
"5556",2024-05-07,"2 - 1066",50,40,50,0,-10,1
"5557",2024-05-07,"82 - 1163",162,148,162,0,-14,1
"5558",2024-05-08,"40 - 1320",207,207,207,0,0,1
"5559",2024-05-08,"40 - 1114",229,231,229,0,2,1
"5560",2024-05-08,"2 - 1066",50,40,50,0,-10,1
"5561",2024-05-08,"82 - 1163",163,148,163,0,-15,1
"5562",2024-05-09,"40 - 1320",207,207,207,0,0,1
"5563",2024-05-09,"40 - 1114",227,231,227,0,4,1
"5564",2024-05-09,"2 - 1066",50,40,50,0,-10,1
"5565",2024-05-09,"82 - 1163",162,148,162,0,-14,1
"5566",2024-05-10,"40 - 1320",207,207,207,0,0,1
"5567",2024-05-10,"40 - 1114",228,231,227,1,3,0.995614035087719
"5568",2024-05-10,"2 - 1066",50,40,50,0,-10,1
"5569",2024-05-10,"82 - 1163",163,148,163,0,-15,1
"5570",2024-05-11,"40 - 1320",207,207,207,0,0,1
"5571",2024-05-11,"40 - 1114",226,231,226,0,5,1
"5572",2024-05-11,"2 - 1066",50,40,50,0,-10,1
"5573",2024-05-11,"82 - 1163",163,148,163,0,-15,1
"5574",2024-05-12,"40 - 1320",207,207,207,0,0,1
"5575",2024-05-12,"40 - 1114",226,231,226,0,5,1
"5576",2024-05-12,"2 - 1066",50,40,50,0,-10,1
"5577",2024-05-12,"82 - 1163",161,148,161,0,-13,1
"5578",2024-05-13,"40 - 1320",207,207,207,0,0,1
"5579",2024-05-13,"40 - 1114",228,231,228,0,3,1
"5580",2024-05-13,"2 - 1066",50,40,50,0,-10,1
"5581",2024-05-13,"82 - 1163",164,148,164,0,-16,1
"5582",2024-05-14,"40 - 1320",207,207,206,1,0,0.995169082125604
"5583",2024-05-14,"40 - 1114",229,231,229,0,2,1
"5584",2024-05-14,"2 - 1066",50,40,50,0,-10,1
"5585",2024-05-14,"82 - 1163",160,148,160,0,-12,1
"5586",2024-05-15,"40 - 1320",207,207,206,1,0,0.995169082125604
"5587",2024-05-15,"40 - 1114",229,231,229,0,2,1
"5588",2024-05-15,"2 - 1066",50,40,50,0,-10,1
"5589",2024-05-15,"82 - 1163",160,148,160,0,-12,1
"5590",2024-05-16,"40 - 1320",207,207,207,0,0,1
"5591",2024-05-16,"40 - 1114",229,231,229,0,2,1
"5592",2024-05-16,"2 - 1066",50,40,50,0,-10,1
"5593",2024-05-16,"82 - 1163",158,148,158,0,-10,1
"5594",2024-05-17,"40 - 1320",207,207,207,0,0,1
"5595",2024-05-17,"40 - 1114",229,231,229,0,2,1
"5596",2024-05-17,"2 - 1066",50,40,50,0,-10,1
"5597",2024-05-17,"82 - 1163",162,148,162,0,-14,1
"5598",2024-05-18,"40 - 1320",207,207,207,0,0,1
"5599",2024-05-18,"40 - 1114",229,231,229,0,2,1
"5600",2024-05-18,"2 - 1066",50,40,50,0,-10,1
"5601",2024-05-18,"82 - 1163",162,148,162,0,-14,1
"5602",2024-05-19,"40 - 1320",207,207,207,0,0,1
"5603",2024-05-19,"40 - 1114",229,231,229,0,2,1
"5604",2024-05-19,"2 - 1066",50,40,50,0,-10,1
"5605",2024-05-19,"82 - 1163",164,148,164,0,-16,1
"5606",2024-05-20,"40 - 1320",207,207,207,0,0,1
"5607",2024-05-20,"40 - 1114",229,231,229,0,2,1
"5608",2024-05-20,"2 - 1066",50,40,50,0,-10,1
"5609",2024-05-20,"82 - 1163",162,148,162,0,-14,1
"5610",2024-05-21,"40 - 1320",207,207,207,0,0,1
"5611",2024-05-21,"40 - 1114",229,231,229,0,2,1
"5612",2024-05-21,"2 - 1066",50,40,50,0,-10,1
"5613",2024-05-21,"82 - 1163",162,148,162,0,-14,1
"5614",2024-05-22,"40 - 1320",207,207,207,0,0,1
"5615",2024-05-22,"40 - 1114",229,231,229,0,2,1
"5616",2024-05-22,"2 - 1066",50,40,50,0,-10,1
"5617",2024-05-22,"82 - 1163",162,148,162,0,-14,1
"5618",2024-05-23,"40 - 1320",207,207,207,0,0,1
"5619",2024-05-23,"40 - 1114",229,231,229,0,2,1
"5620",2024-05-23,"2 - 1066",50,40,50,0,-10,1
"5621",2024-05-23,"82 - 1163",163,148,163,0,-15,1
"5622",2024-05-24,"40 - 1320",207,207,207,0,0,1
"5623",2024-05-24,"40 - 1114",228,231,228,0,3,1
"5624",2024-05-24,"2 - 1066",50,40,50,0,-10,1
"5625",2024-05-24,"82 - 1163",164,148,164,0,-16,1
"5626",2024-05-25,"40 - 1320",207,207,207,0,0,1
"5627",2024-05-25,"40 - 1114",229,231,229,0,2,1
"5628",2024-05-25,"2 - 1066",50,40,50,0,-10,1
"5629",2024-05-25,"82 - 1163",163,148,163,0,-15,1
"5630",2024-05-26,"40 - 1320",207,207,207,0,0,1
"5631",2024-05-26,"40 - 1114",229,231,229,0,2,1
"5632",2024-05-26,"2 - 1066",50,40,50,0,-10,1
"5633",2024-05-26,"82 - 1163",162,148,162,0,-14,1
"5634",2024-05-27,"40 - 1320",207,207,207,0,0,1
"5635",2024-05-27,"40 - 1114",230,231,230,0,1,1
"5636",2024-05-27,"2 - 1066",50,40,50,0,-10,1
"5637",2024-05-27,"82 - 1163",160,148,160,0,-12,1
"5638",2024-05-28,"40 - 1320",207,207,207,0,0,1
"5639",2024-05-28,"40 - 1114",230,231,230,0,1,1
"5640",2024-05-28,"2 - 1066",50,40,50,0,-10,1
"5641",2024-05-28,"82 - 1163",160,148,160,0,-12,1
"5642",2024-05-29,"40 - 1320",207,207,207,0,0,1
"5643",2024-05-29,"40 - 1114",230,231,230,0,1,1
"5644",2024-05-29,"2 - 1066",50,40,50,0,-10,1
"5645",2024-05-29,"82 - 1163",160,148,160,0,-12,1
"5646",2024-05-30,"40 - 1320",207,207,207,0,0,1
"5647",2024-05-30,"40 - 1114",230,231,230,0,1,1
"5648",2024-05-30,"2 - 1066",50,40,50,0,-10,1
"5649",2024-05-30,"82 - 1163",159,148,159,0,-11,1
"5650",2024-05-31,"40 - 1320",207,207,207,0,0,1
"5651",2024-05-31,"40 - 1114",230,231,230,0,1,1
"5652",2024-05-31,"2 - 1066",50,40,50,0,-10,1
"5653",2024-05-31,"82 - 1163",157,148,157,0,-9,1
"5654",2024-06-01,"40 - 1320",206,207,206,0,1,1
"5655",2024-06-01,"40 - 1114",229,231,229,0,2,1
"5656",2024-06-01,"2 - 1066",49,40,49,0,-9,1
"5657",2024-06-01,"82 - 1163",156,134,156,0,-22,1
"5658",2024-06-02,"40 - 1320",207,207,207,0,0,1
"5659",2024-06-02,"40 - 1114",229,231,229,0,2,1
"5660",2024-06-02,"2 - 1066",49,40,49,0,-9,1
"5661",2024-06-02,"82 - 1163",157,148,157,0,-9,1
"5662",2024-06-03,"40 - 1320",207,207,206,1,0,0.995169082125604
"5663",2024-06-03,"40 - 1114",228,231,228,0,3,1
"5664",2024-06-03,"2 - 1066",49,40,49,0,-9,1
"5665",2024-06-03,"82 - 1163",158,148,158,0,-10,1
"5666",2024-06-04,"40 - 1320",207,207,206,1,0,0.995169082125604
"5667",2024-06-04,"40 - 1114",228,231,228,0,3,1
"5668",2024-06-04,"2 - 1066",48,40,48,0,-8,1
"5669",2024-06-04,"82 - 1163",157,148,157,0,-9,1
"5670",2024-06-05,"40 - 1320",207,207,207,0,0,1
"5671",2024-06-05,"40 - 1114",228,231,228,0,3,1
"5672",2024-06-05,"2 - 1066",48,40,48,0,-8,1
"5673",2024-06-05,"82 - 1163",158,148,158,0,-10,1
"5674",2024-06-06,"40 - 1320",207,207,207,0,0,1
"5675",2024-06-06,"40 - 1114",228,231,228,0,3,1
"5676",2024-06-06,"2 - 1066",48,40,48,0,-8,1
"5677",2024-06-06,"82 - 1163",158,148,158,0,-10,1
"5678",2024-06-07,"40 - 1320",207,207,207,0,0,1
"5679",2024-06-07,"40 - 1114",228,231,228,0,3,1
"5680",2024-06-07,"2 - 1066",48,40,48,0,-8,1
"5681",2024-06-07,"82 - 1163",159,148,159,0,-11,1
"5682",2024-06-08,"40 - 1320",207,207,207,0,0,1
"5683",2024-06-08,"40 - 1114",227,231,227,0,4,1
"5684",2024-06-08,"2 - 1066",47,40,47,0,-7,1
"5685",2024-06-08,"82 - 1163",158,148,158,0,-10,1
"5686",2024-06-09,"40 - 1320",207,207,207,0,0,1
"5687",2024-06-09,"40 - 1114",227,231,227,0,4,1
"5688",2024-06-09,"2 - 1066",47,40,47,0,-7,1
"5689",2024-06-09,"82 - 1163",158,148,158,0,-10,1
"5690",2024-06-10,"40 - 1320",207,207,207,0,0,1
"5691",2024-06-10,"40 - 1114",228,231,228,0,3,1
"5692",2024-06-10,"2 - 1066",47,40,47,0,-7,1
"5693",2024-06-10,"82 - 1163",160,148,160,0,-12,1
"5694",2024-06-11,"40 - 1320",207,207,207,0,0,1
"5695",2024-06-11,"40 - 1114",227,231,226,1,4,0.995594713656388
"5696",2024-06-11,"2 - 1066",47,40,47,0,-7,1
"5697",2024-06-11,"82 - 1163",160,148,160,0,-12,1
"5698",2024-06-12,"40 - 1320",207,207,207,0,0,1
"5699",2024-06-12,"40 - 1114",229,231,228,1,2,0.995633187772926
"5700",2024-06-12,"2 - 1066",48,40,48,0,-8,1
"5701",2024-06-12,"82 - 1163",157,148,157,0,-9,1
"5702",2024-06-13,"40 - 1320",207,207,207,0,0,1
"5703",2024-06-13,"40 - 1114",229,231,228,1,2,0.995633187772926
"5704",2024-06-13,"2 - 1066",48,40,48,0,-8,1
"5705",2024-06-13,"82 - 1163",159,148,158,1,-11,0.993710691823899
"5706",2024-06-14,"40 - 1320",207,207,207,0,0,1
"5707",2024-06-14,"40 - 1114",229,231,229,0,2,1
"5708",2024-06-14,"2 - 1066",48,40,48,0,-8,1
"5709",2024-06-14,"82 - 1163",161,148,161,0,-13,1
"5710",2024-06-15,"40 - 1320",207,207,207,0,0,1
"5711",2024-06-15,"40 - 1114",229,231,229,0,2,1
"5712",2024-06-15,"2 - 1066",48,40,48,0,-8,1
"5713",2024-06-15,"82 - 1163",161,148,161,0,-13,1
"5714",2024-06-16,"40 - 1320",207,207,207,0,0,1
"5715",2024-06-16,"40 - 1114",229,231,229,0,2,1
"5716",2024-06-16,"2 - 1066",48,40,48,0,-8,1
"5717",2024-06-16,"82 - 1163",163,148,162,1,-15,0.993865030674847
"5718",2024-06-17,"40 - 1320",206,207,206,0,1,1
"5719",2024-06-17,"40 - 1114",230,231,230,0,1,1
"5720",2024-06-17,"2 - 1066",48,40,48,0,-8,1
"5721",2024-06-17,"82 - 1163",167,148,167,0,-19,1
"5722",2024-06-18,"40 - 1320",207,207,207,0,0,1
"5723",2024-06-18,"40 - 1114",231,231,231,0,0,1
"5724",2024-06-18,"2 - 1066",48,40,48,0,-8,1
"5725",2024-06-18,"82 - 1163",168,148,168,0,-20,1
"5726",2024-06-19,"40 - 1320",207,207,207,0,0,1
"5727",2024-06-19,"40 - 1114",231,231,231,0,0,1
"5728",2024-06-19,"2 - 1066",48,40,48,0,-8,1
"5729",2024-06-19,"82 - 1163",170,148,170,0,-22,1
"5730",2024-06-20,"40 - 1320",207,207,207,0,0,1
"5731",2024-06-20,"40 - 1114",231,231,231,0,0,1
"5732",2024-06-20,"2 - 1066",48,40,48,0,-8,1
"5733",2024-06-20,"82 - 1163",172,148,172,0,-24,1
"5734",2024-06-21,"40 - 1320",207,207,207,0,0,1
"5735",2024-06-21,"40 - 1114",231,231,231,0,0,1
"5736",2024-06-21,"2 - 1066",48,40,48,0,-8,1
"5737",2024-06-21,"82 - 1163",171,148,171,0,-23,1
"5738",2024-06-22,"40 - 1320",207,207,207,0,0,1
"5739",2024-06-22,"40 - 1114",231,231,231,0,0,1
"5740",2024-06-22,"2 - 1066",48,40,48,0,-8,1
"5741",2024-06-22,"82 - 1163",171,148,171,0,-23,1
"5742",2024-06-23,"40 - 1320",207,207,207,0,0,1
"5743",2024-06-23,"40 - 1114",231,231,231,0,0,1
"5744",2024-06-23,"2 - 1066",48,40,48,0,-8,1
"5745",2024-06-23,"82 - 1163",171,148,171,0,-23,1
"5746",2024-06-24,"40 - 1320",207,207,207,0,0,1
"5747",2024-06-24,"40 - 1114",231,231,231,0,0,1
"5748",2024-06-24,"2 - 1066",48,40,48,0,-8,1
"5749",2024-06-24,"82 - 1163",167,148,167,0,-19,1
"5750",2024-06-25,"40 - 1320",207,207,207,0,0,1
"5751",2024-06-25,"40 - 1114",231,231,231,0,0,1
"5752",2024-06-25,"2 - 1066",48,40,48,0,-8,1
"5753",2024-06-25,"82 - 1163",170,148,169,1,-22,0.994117647058824
"5754",2024-06-26,"40 - 1320",207,207,207,0,0,1
"5755",2024-06-26,"40 - 1114",231,231,231,0,0,1
"5756",2024-06-26,"2 - 1066",47,40,47,0,-7,1
"5757",2024-06-26,"82 - 1163",168,148,168,0,-20,1
"5758",2024-06-27,"40 - 1320",207,207,207,0,0,1
"5759",2024-06-27,"40 - 1114",231,231,231,0,0,1
"5760",2024-06-27,"2 - 1066",47,40,47,0,-7,1
"5761",2024-06-27,"82 - 1163",165,148,163,2,-17,0.987878787878788
"5762",2024-06-28,"40 - 1320",207,207,207,0,0,1
"5763",2024-06-28,"40 - 1114",230,231,230,0,1,1
"5764",2024-06-28,"2 - 1066",47,40,47,0,-7,1
"5765",2024-06-28,"82 - 1163",161,148,161,0,-13,1
"5766",2024-06-29,"40 - 1320",207,207,207,0,0,1
"5767",2024-06-29,"40 - 1114",230,231,230,0,1,1
"5768",2024-06-29,"2 - 1066",47,40,47,0,-7,1
"5769",2024-06-29,"82 - 1163",163,148,163,0,-15,1
"5770",2024-06-30,"40 - 1320",207,207,207,0,0,1
"5771",2024-06-30,"40 - 1114",229,231,229,0,2,1
"5772",2024-06-30,"2 - 1066",47,40,47,0,-7,1
"5773",2024-06-30,"82 - 1163",163,148,163,0,-15,1
"5774",2024-07-01,"40 - 1320",207,207,207,0,0,1
"5775",2024-07-01,"40 - 1114",228,231,228,0,3,1
"5776",2024-07-01,"2 - 1066",47,40,47,0,-7,1
"5777",2024-07-01,"82 - 1163",163,148,163,0,-15,1
"5778",2024-07-02,"40 - 1320",206,207,206,0,1,1
"5779",2024-07-02,"40 - 1114",228,231,228,0,3,1
"5780",2024-07-02,"2 - 1066",47,40,47,0,-7,1
"5781",2024-07-02,"82 - 1163",162,148,162,0,-14,1
"5782",2024-07-03,"40 - 1320",207,207,207,0,0,1
"5783",2024-07-03,"40 - 1114",228,231,228,0,3,1
"5784",2024-07-03,"2 - 1066",47,40,47,0,-7,1
"5785",2024-07-03,"82 - 1163",161,148,161,0,-13,1
"5786",2024-07-04,"40 - 1320",207,207,207,0,0,1
"5787",2024-07-04,"40 - 1114",228,231,228,0,3,1
"5788",2024-07-04,"2 - 1066",47,40,47,0,-7,1
"5789",2024-07-04,"82 - 1163",162,148,162,0,-14,1
"5790",2024-07-05,"40 - 1320",207,207,207,0,0,1
"5791",2024-07-05,"40 - 1114",230,231,230,0,1,1
"5792",2024-07-05,"2 - 1066",47,40,47,0,-7,1
"5793",2024-07-05,"82 - 1163",164,148,164,0,-16,1
"5794",2024-07-06,"40 - 1320",207,207,207,0,0,1
"5795",2024-07-06,"40 - 1114",230,231,230,0,1,1
"5796",2024-07-06,"2 - 1066",47,40,47,0,-7,1
"5797",2024-07-06,"82 - 1163",164,148,164,0,-16,1
"5798",2024-07-07,"40 - 1320",207,207,207,0,0,1
"5799",2024-07-07,"40 - 1114",230,231,230,0,1,1
"5800",2024-07-07,"2 - 1066",47,40,47,0,-7,1
"5801",2024-07-07,"82 - 1163",164,148,164,0,-16,1
"5802",2024-07-08,"40 - 1320",207,207,207,0,0,1
"5803",2024-07-08,"40 - 1114",231,231,230,1,0,0.995670995670996
"5804",2024-07-08,"2 - 1066",47,40,47,0,-7,1
"5805",2024-07-08,"82 - 1163",163,148,163,0,-15,1
"5806",2024-07-09,"40 - 1320",207,207,206,1,0,0.995169082125604
"5807",2024-07-09,"40 - 1114",229,231,229,0,2,1
"5808",2024-07-09,"2 - 1066",47,40,47,0,-7,1
"5809",2024-07-09,"82 - 1163",161,148,161,0,-13,1
"5810",2024-07-10,"40 - 1320",206,207,206,0,1,1
"5811",2024-07-10,"40 - 1114",229,231,229,0,2,1
"5812",2024-07-10,"2 - 1066",47,40,47,0,-7,1
"5813",2024-07-10,"82 - 1163",160,148,160,0,-12,1
"5814",2024-07-11,"40 - 1320",207,207,207,0,0,1
"5815",2024-07-11,"40 - 1114",229,231,229,0,2,1
"5816",2024-07-11,"2 - 1066",47,40,47,0,-7,1
"5817",2024-07-11,"82 - 1163",161,148,161,0,-13,1
"5818",2024-07-12,"40 - 1320",207,207,207,0,0,1
"5819",2024-07-12,"40 - 1114",229,231,228,1,2,0.995633187772926
"5820",2024-07-12,"2 - 1066",47,40,47,0,-7,1
"5821",2024-07-12,"82 - 1163",161,148,161,0,-13,1
"5822",2024-07-13,"40 - 1320",207,207,207,0,0,1
"5823",2024-07-13,"40 - 1114",229,231,228,1,2,0.995633187772926
"5824",2024-07-13,"2 - 1066",47,40,47,0,-7,1
"5825",2024-07-13,"82 - 1163",160,148,160,0,-12,1
"5826",2024-07-14,"40 - 1320",207,207,207,0,0,1
"5827",2024-07-14,"40 - 1114",229,231,228,1,2,0.995633187772926
"5828",2024-07-14,"2 - 1066",47,40,47,0,-7,1
"5829",2024-07-14,"82 - 1163",164,148,163,1,-16,0.99390243902439
"5830",2024-07-15,"40 - 1320",207,207,207,0,0,1
"5831",2024-07-15,"40 - 1114",227,231,227,0,4,1
"5832",2024-07-15,"2 - 1066",47,40,47,0,-7,1
"5833",2024-07-15,"82 - 1163",161,148,161,0,-13,1
"5834",2024-07-16,"40 - 1320",207,207,207,0,0,1
"5835",2024-07-16,"40 - 1114",227,231,227,0,4,1
"5836",2024-07-16,"2 - 1066",47,40,47,0,-7,1
"5837",2024-07-16,"82 - 1163",162,148,161,1,-14,0.993827160493827
"5838",2024-07-17,"40 - 1320",207,207,207,0,0,1
"5839",2024-07-17,"40 - 1114",227,231,227,0,4,1
"5840",2024-07-17,"2 - 1066",47,40,47,0,-7,1
"5841",2024-07-17,"82 - 1163",162,148,162,0,-14,1
"5842",2024-07-18,"40 - 1320",207,207,207,0,0,1
"5843",2024-07-18,"40 - 1114",228,231,228,0,3,1
"5844",2024-07-18,"2 - 1066",47,40,47,0,-7,1
"5845",2024-07-18,"82 - 1163",163,148,163,0,-15,1
"5846",2024-07-19,"40 - 1320",207,207,207,0,0,1
"5847",2024-07-19,"40 - 1114",228,231,228,0,3,1
"5848",2024-07-19,"2 - 1066",47,40,47,0,-7,1
"5849",2024-07-19,"82 - 1163",163,148,163,0,-15,1
"5850",2024-07-20,"40 - 1320",207,207,207,0,0,1
"5851",2024-07-20,"40 - 1114",228,231,228,0,3,1
"5852",2024-07-20,"2 - 1066",47,40,47,0,-7,1
"5853",2024-07-20,"82 - 1163",162,148,162,0,-14,1
"5854",2024-07-21,"40 - 1320",207,207,207,0,0,1
"5855",2024-07-21,"40 - 1114",228,231,228,0,3,1
"5856",2024-07-21,"2 - 1066",47,40,47,0,-7,1
"5857",2024-07-21,"82 - 1163",161,148,161,0,-13,1
"5858",2024-07-22,"40 - 1320",207,207,207,0,0,1
"5859",2024-07-22,"40 - 1114",229,231,229,0,2,1
"5860",2024-07-22,"2 - 1066",47,40,47,0,-7,1
"5861",2024-07-22,"82 - 1163",161,148,161,0,-13,1
"5862",2024-07-23,"40 - 1320",207,207,207,0,0,1
"5863",2024-07-23,"40 - 1114",229,231,229,0,2,1
"5864",2024-07-23,"2 - 1066",47,40,47,0,-7,1
"5865",2024-07-23,"82 - 1163",162,148,162,0,-14,1
"5866",2024-07-24,"40 - 1320",207,207,207,0,0,1
"5867",2024-07-24,"40 - 1114",229,231,229,0,2,1
"5868",2024-07-24,"2 - 1066",47,40,47,0,-7,1
"5869",2024-07-24,"82 - 1163",163,148,162,1,-15,0.993865030674847
"5870",2024-07-25,"40 - 1320",207,207,207,0,0,1
"5871",2024-07-25,"40 - 1114",229,231,229,0,2,1
"5872",2024-07-25,"2 - 1066",46,40,46,0,-6,1
"5873",2024-07-25,"82 - 1163",163,148,162,1,-15,0.993865030674847
"5874",2024-07-26,"40 - 1320",207,207,205,2,0,0.990338164251208
"5875",2024-07-26,"40 - 1114",229,231,229,0,2,1
"5876",2024-07-26,"2 - 1066",46,40,46,0,-6,1
"5877",2024-07-26,"82 - 1163",172,148,172,0,-24,1
"5878",2024-07-27,"40 - 1320",206,207,206,0,1,1
"5879",2024-07-27,"40 - 1114",229,231,229,0,2,1
"5880",2024-07-27,"2 - 1066",46,40,46,0,-6,1
"5881",2024-07-27,"82 - 1163",172,148,172,0,-24,1
"5882",2024-07-28,"40 - 1320",206,207,206,0,1,1
"5883",2024-07-28,"40 - 1114",229,231,229,0,2,1
"5884",2024-07-28,"2 - 1066",46,40,46,0,-6,1
"5885",2024-07-28,"82 - 1163",170,134,170,0,-36,1
"5886",2024-07-29,"40 - 1320",207,207,207,0,0,1
"5887",2024-07-29,"40 - 1114",229,231,229,0,2,1
"5888",2024-07-29,"2 - 1066",45,40,45,0,-5,1
"5889",2024-07-29,"82 - 1163",171,148,171,0,-23,1
"5890",2024-07-30,"40 - 1320",207,207,207,0,0,1
"5891",2024-07-30,"40 - 1114",230,231,230,0,1,1
"5892",2024-07-30,"2 - 1066",45,40,45,0,-5,1
"5893",2024-07-30,"82 - 1163",171,148,171,0,-23,1
"5894",2024-07-31,"40 - 1320",207,207,207,0,0,1
"5895",2024-07-31,"40 - 1114",228,231,228,0,3,1
"5896",2024-07-31,"2 - 1066",45,40,45,0,-5,1
"5897",2024-07-31,"82 - 1163",171,148,171,0,-23,1
"5898",2024-08-01,"40 - 1320",207,207,207,0,0,1
"5899",2024-08-01,"40 - 1114",227,231,226,1,4,0.995594713656388
"5900",2024-08-01,"2 - 1066",45,40,45,0,-5,1
"5901",2024-08-01,"82 - 1163",169,148,169,0,-21,1
"5902",2024-08-02,"40 - 1320",207,207,207,0,0,1
"5903",2024-08-02,"40 - 1114",227,231,227,0,4,1
"5904",2024-08-02,"2 - 1066",45,40,45,0,-5,1
"5905",2024-08-02,"82 - 1163",169,148,169,0,-21,1
"5906",2024-08-03,"40 - 1320",207,207,207,0,0,1
"5907",2024-08-03,"40 - 1114",227,231,227,0,4,1
"5908",2024-08-03,"2 - 1066",45,40,45,0,-5,1
"5909",2024-08-03,"82 - 1163",168,148,168,0,-20,1
"5910",2024-08-04,"40 - 1320",206,207,206,0,1,1
"5911",2024-08-04,"40 - 1114",227,231,227,0,4,1
"5912",2024-08-04,"2 - 1066",45,40,45,0,-5,1
"5913",2024-08-04,"82 - 1163",168,148,168,0,-20,1
"5914",2024-08-05,"40 - 1320",207,207,207,0,0,1
"5915",2024-08-05,"40 - 1114",229,231,228,1,2,0.995633187772926
"5916",2024-08-05,"2 - 1066",45,40,45,0,-5,1
"5917",2024-08-05,"82 - 1163",167,148,167,0,-19,1
"5918",2024-08-06,"40 - 1320",206,207,206,0,1,1
"5919",2024-08-06,"40 - 1114",228,231,228,0,3,1
"5920",2024-08-06,"2 - 1066",45,40,45,0,-5,1
"5921",2024-08-06,"82 - 1163",167,148,167,0,-19,1
"5922",2024-08-07,"40 - 1320",207,207,207,0,0,1
"5923",2024-08-07,"40 - 1114",227,231,227,0,4,1
"5924",2024-08-07,"2 - 1066",45,40,45,0,-5,1
"5925",2024-08-07,"82 - 1163",167,148,167,0,-19,1
"5926",2024-08-08,"40 - 1320",207,207,207,0,0,1
"5927",2024-08-08,"40 - 1114",226,231,226,0,5,1
"5928",2024-08-08,"2 - 1066",45,40,45,0,-5,1
"5929",2024-08-08,"82 - 1163",166,148,166,0,-18,1
"5930",2024-08-09,"40 - 1320",207,207,207,0,0,1
"5931",2024-08-09,"40 - 1114",226,231,225,1,5,0.995575221238938
"5932",2024-08-09,"2 - 1066",45,40,45,0,-5,1
"5933",2024-08-09,"82 - 1163",166,148,166,0,-18,1
"5934",2024-08-10,"40 - 1320",207,207,207,0,0,1
"5935",2024-08-10,"40 - 1114",226,231,226,0,5,1
"5936",2024-08-10,"2 - 1066",44,40,44,0,-4,1
"5937",2024-08-10,"82 - 1163",165,148,165,0,-17,1
"5938",2024-08-11,"40 - 1320",207,207,207,0,0,1
"5939",2024-08-11,"40 - 1114",226,231,226,0,5,1
"5940",2024-08-11,"2 - 1066",44,40,44,0,-4,1
"5941",2024-08-11,"82 - 1163",164,148,164,0,-16,1
"5942",2024-08-12,"40 - 1320",206,207,206,0,1,1
"5943",2024-08-12,"40 - 1114",226,231,226,0,5,1
"5944",2024-08-12,"2 - 1066",44,40,44,0,-4,1
"5945",2024-08-12,"82 - 1163",164,148,164,0,-16,1
"5946",2024-08-13,"40 - 1320",206,207,205,1,1,0.995145631067961
"5947",2024-08-13,"40 - 1114",228,231,227,1,3,0.995614035087719
"5948",2024-08-13,"2 - 1066",44,40,44,0,-4,1
"5949",2024-08-13,"82 - 1163",164,148,164,0,-16,1
"5950",2024-08-14,"40 - 1320",206,207,206,0,1,1
"5951",2024-08-14,"40 - 1114",227,231,227,0,4,1
"5952",2024-08-14,"2 - 1066",42,40,42,0,-2,1
"5953",2024-08-14,"82 - 1163",165,148,165,0,-17,1
"5954",2024-08-15,"40 - 1320",207,207,206,1,0,0.995169082125604
"5955",2024-08-15,"40 - 1114",225,231,225,0,6,1
"5956",2024-08-15,"2 - 1066",42,40,42,0,-2,1
"5957",2024-08-15,"82 - 1163",166,148,166,0,-18,1
"5958",2024-08-16,"40 - 1320",207,207,207,0,0,1
"5959",2024-08-16,"40 - 1114",225,231,225,0,6,1
"5960",2024-08-16,"2 - 1066",42,40,42,0,-2,1
"5961",2024-08-16,"82 - 1163",168,148,168,0,-20,1
"5962",2024-08-17,"40 - 1320",207,207,207,0,0,1
"5963",2024-08-17,"40 - 1114",226,231,226,0,5,1
"5964",2024-08-17,"2 - 1066",42,40,42,0,-2,1
"5965",2024-08-17,"82 - 1163",166,148,166,0,-18,1
"5966",2024-08-18,"40 - 1320",207,207,207,0,0,1
"5967",2024-08-18,"40 - 1114",227,231,227,0,4,1
"5968",2024-08-18,"2 - 1066",42,40,42,0,-2,1
"5969",2024-08-18,"82 - 1163",167,148,167,0,-19,1
"5970",2024-08-19,"40 - 1320",207,207,207,0,0,1
"5971",2024-08-19,"40 - 1114",225,231,225,0,6,1
"5972",2024-08-19,"2 - 1066",42,40,42,0,-2,1
"5973",2024-08-19,"82 - 1163",167,148,167,0,-19,1
"5974",2024-08-20,"40 - 1320",207,207,207,0,0,1
"5975",2024-08-20,"40 - 1114",224,231,222,2,7,0.991071428571429
"5976",2024-08-20,"2 - 1066",42,40,42,0,-2,1
"5977",2024-08-20,"82 - 1163",167,148,167,0,-19,1
"5978",2024-08-21,"40 - 1320",207,207,207,0,0,1
"5979",2024-08-21,"40 - 1114",223,231,221,2,8,0.991031390134529
"5980",2024-08-21,"2 - 1066",44,40,44,0,-4,1
"5981",2024-08-21,"82 - 1163",168,148,168,0,-20,1
"5982",2024-08-22,"40 - 1320",207,207,207,0,0,1
"5983",2024-08-22,"40 - 1114",223,232,223,0,9,1
"5984",2024-08-22,"2 - 1066",44,40,44,0,-4,1
"5985",2024-08-22,"82 - 1163",167,148,167,0,-19,1
"5986",2024-08-23,"40 - 1320",207,207,207,0,0,1
"5987",2024-08-23,"40 - 1114",224,232,224,0,8,1
"5988",2024-08-23,"2 - 1066",44,40,44,0,-4,1
"5989",2024-08-23,"82 - 1163",166,148,166,0,-18,1
"5990",2024-08-24,"40 - 1320",207,207,207,0,0,1
"5991",2024-08-24,"40 - 1114",223,232,223,0,9,1
"5992",2024-08-24,"2 - 1066",43,40,43,0,-3,1
"5993",2024-08-24,"82 - 1163",161,148,161,0,-13,1
"5994",2024-08-25,"40 - 1320",207,207,207,0,0,1
"5995",2024-08-25,"40 - 1114",223,232,223,0,9,1
"5996",2024-08-25,"2 - 1066",43,40,43,0,-3,1
"5997",2024-08-25,"82 - 1163",162,148,162,0,-14,1
"5998",2024-08-26,"40 - 1320",207,207,206,1,0,0.995169082125604
"5999",2024-08-26,"40 - 1114",223,232,223,0,9,1
"6000",2024-08-26,"2 - 1066",43,40,43,0,-3,1
"6001",2024-08-26,"82 - 1163",161,148,161,0,-13,1
"6002",2024-08-27,"40 - 1320",207,207,206,1,0,0.995169082125604
"6003",2024-08-27,"40 - 1114",224,232,224,0,8,1
"6004",2024-08-27,"2 - 1066",44,40,44,0,-4,1
"6005",2024-08-27,"82 - 1163",161,148,161,0,-13,1
"6006",2024-08-28,"40 - 1320",207,207,206,1,0,0.995169082125604
"6007",2024-08-28,"40 - 1114",223,232,223,0,9,1
"6008",2024-08-28,"2 - 1066",44,40,44,0,-4,1
"6009",2024-08-28,"82 - 1163",161,148,161,0,-13,1
"6010",2024-08-29,"40 - 1320",207,207,207,0,0,1
"6011",2024-08-29,"40 - 1114",224,232,224,0,8,1
"6012",2024-08-29,"2 - 1066",44,40,44,0,-4,1
"6013",2024-08-29,"82 - 1163",162,148,162,0,-14,1
"6014",2024-08-30,"40 - 1320",206,207,206,0,1,1
"6015",2024-08-30,"40 - 1114",226,232,226,0,6,1
"6016",2024-08-30,"2 - 1066",44,40,44,0,-4,1
"6017",2024-08-30,"82 - 1163",160,148,160,0,-12,1
"6018",2024-08-31,"40 - 1320",203,207,203,0,4,1
"6019",2024-08-31,"40 - 1114",225,232,225,0,7,1
"6020",2024-08-31,"2 - 1066",44,40,44,0,-4,1
"6021",2024-08-31,"82 - 1163",159,134,159,0,-25,1
"6022",2024-09-01,"40 - 1320",203,207,203,0,4,1
"6023",2024-09-01,"40 - 1114",222,232,222,0,10,1
"6024",2024-09-01,"2 - 1066",44,40,44,0,-4,1
"6025",2024-09-01,"82 - 1163",160,134,160,0,-26,1
"6026",2024-09-02,"40 - 1320",205,207,204,1,2,0.995121951219512
"6027",2024-09-02,"40 - 1114",221,232,221,0,11,1
"6028",2024-09-02,"2 - 1066",44,40,44,0,-4,1
"6029",2024-09-02,"82 - 1163",160,134,160,0,-26,1
"6030",2024-09-03,"40 - 1320",204,207,203,1,3,0.995098039215686
"6031",2024-09-03,"40 - 1114",220,232,220,0,12,1
"6032",2024-09-03,"2 - 1066",44,40,44,0,-4,1
"6033",2024-09-03,"82 - 1163",161,148,161,0,-13,1
"6034",2024-09-04,"40 - 1320",203,207,203,0,4,1
"6035",2024-09-04,"40 - 1114",221,232,221,0,11,1
"6036",2024-09-04,"2 - 1066",44,40,44,0,-4,1
"6037",2024-09-04,"82 - 1163",160,148,160,0,-12,1
"6038",2024-09-05,"40 - 1320",204,207,203,1,3,0.995098039215686
"6039",2024-09-05,"40 - 1114",222,232,220,2,10,0.990990990990991
"6040",2024-09-05,"2 - 1066",44,40,44,0,-4,1
"6041",2024-09-05,"82 - 1163",160,148,160,0,-12,1
"6042",2024-09-06,"40 - 1320",204,207,204,0,3,1
"6043",2024-09-06,"40 - 1114",218,232,218,0,14,1
"6044",2024-09-06,"2 - 1066",44,40,44,0,-4,1
"6045",2024-09-06,"82 - 1163",162,148,162,0,-14,1
"6046",2024-09-07,"40 - 1320",204,207,204,0,3,1
"6047",2024-09-07,"40 - 1114",220,232,220,0,12,1
"6048",2024-09-07,"2 - 1066",44,40,44,0,-4,1
"6049",2024-09-07,"82 - 1163",162,148,162,0,-14,1
"6050",2024-09-08,"40 - 1320",204,207,204,0,3,1
"6051",2024-09-08,"40 - 1114",222,232,222,0,10,1
"6052",2024-09-08,"2 - 1066",44,40,44,0,-4,1
"6053",2024-09-08,"82 - 1163",162,148,162,0,-14,1
"6054",2024-09-09,"40 - 1320",205,207,204,1,2,0.995121951219512
"6055",2024-09-09,"40 - 1114",222,232,222,0,10,1
"6056",2024-09-09,"2 - 1066",45,40,45,0,-5,1
"6057",2024-09-09,"82 - 1163",163,148,163,0,-15,1
"6058",2024-09-10,"40 - 1320",205,207,205,0,2,1
"6059",2024-09-10,"40 - 1114",221,232,221,0,11,1
"6060",2024-09-10,"2 - 1066",45,40,45,0,-5,1
"6061",2024-09-10,"82 - 1163",163,148,163,0,-15,1
"6062",2024-09-11,"40 - 1320",205,207,205,0,2,1
"6063",2024-09-11,"40 - 1114",223,232,223,0,9,1
"6064",2024-09-11,"2 - 1066",45,40,45,0,-5,1
"6065",2024-09-11,"82 - 1163",163,148,163,0,-15,1
"6066",2024-09-12,"40 - 1320",205,207,205,0,2,1
"6067",2024-09-12,"40 - 1114",226,232,223,3,6,0.986725663716814
"6068",2024-09-12,"2 - 1066",45,40,45,0,-5,1
"6069",2024-09-12,"82 - 1163",167,148,167,0,-19,1
"6070",2024-09-13,"40 - 1320",205,207,205,0,2,1
"6071",2024-09-13,"40 - 1114",225,232,225,0,7,1
"6072",2024-09-13,"2 - 1066",45,40,45,0,-5,1
"6073",2024-09-13,"82 - 1163",165,148,165,0,-17,1
"6074",2024-09-14,"40 - 1320",205,207,204,1,2,0.995121951219512
"6075",2024-09-14,"40 - 1114",226,232,226,0,6,1
"6076",2024-09-14,"2 - 1066",45,40,45,0,-5,1
"6077",2024-09-14,"82 - 1163",165,148,165,0,-17,1
"6078",2024-09-15,"40 - 1320",204,207,204,0,3,1
"6079",2024-09-15,"40 - 1114",226,232,226,0,6,1
"6080",2024-09-15,"2 - 1066",45,40,45,0,-5,1
"6081",2024-09-15,"82 - 1163",166,148,166,0,-18,1
"6082",2024-09-16,"40 - 1320",206,207,205,1,1,0.995145631067961
"6083",2024-09-16,"40 - 1114",227,232,227,0,5,1
"6084",2024-09-16,"2 - 1066",45,40,45,0,-5,1
"6085",2024-09-16,"82 - 1163",166,148,166,0,-18,1
"6086",2024-09-17,"40 - 1320",206,207,205,1,1,0.995145631067961
"6087",2024-09-17,"40 - 1114",228,232,228,0,4,1
"6088",2024-09-17,"2 - 1066",45,40,45,0,-5,1
"6089",2024-09-17,"82 - 1163",165,148,165,0,-17,1
"6090",2024-09-18,"40 - 1320",206,207,206,0,1,1
"6091",2024-09-18,"40 - 1114",227,232,227,0,5,1
"6092",2024-09-18,"2 - 1066",45,40,45,0,-5,1
"6093",2024-09-18,"82 - 1163",166,148,166,0,-18,1
"6094",2024-09-19,"40 - 1320",206,207,206,0,1,1
"6095",2024-09-19,"40 - 1114",229,232,229,0,3,1
"6096",2024-09-19,"2 - 1066",45,40,45,0,-5,1
"6097",2024-09-19,"82 - 1163",164,148,164,0,-16,1
"6098",2024-09-20,"40 - 1320",206,207,206,0,1,1
"6099",2024-09-20,"40 - 1114",229,232,229,0,3,1
"6100",2024-09-20,"2 - 1066",45,40,45,0,-5,1
"6101",2024-09-20,"82 - 1163",163,148,163,0,-15,1
"6102",2024-09-21,"40 - 1320",206,207,206,0,1,1
"6103",2024-09-21,"40 - 1114",228,232,228,0,4,1
"6104",2024-09-21,"2 - 1066",45,40,45,0,-5,1
"6105",2024-09-21,"82 - 1163",163,148,163,0,-15,1
"6106",2024-09-22,"40 - 1320",207,207,207,0,0,1
"6107",2024-09-22,"40 - 1114",228,232,228,0,4,1
"6108",2024-09-22,"2 - 1066",45,40,45,0,-5,1
"6109",2024-09-22,"82 - 1163",163,148,163,0,-15,1
"6110",2024-09-23,"40 - 1320",207,207,207,0,0,1
"6111",2024-09-23,"40 - 1114",228,232,228,0,4,1
"6112",2024-09-23,"2 - 1066",45,40,45,0,-5,1
"6113",2024-09-23,"82 - 1163",163,148,163,0,-15,1
"6114",2024-09-24,"40 - 1320",207,207,207,0,0,1
"6115",2024-09-24,"40 - 1114",228,232,228,0,4,1
"6116",2024-09-24,"2 - 1066",45,40,45,0,-5,1
"6117",2024-09-24,"82 - 1163",164,148,164,0,-16,1
"6118",2024-09-25,"40 - 1320",207,207,207,0,0,1
"6119",2024-09-25,"40 - 1114",229,232,228,1,3,0.995633187772926
"6120",2024-09-25,"2 - 1066",45,40,45,0,-5,1
"6121",2024-09-25,"82 - 1163",164,148,164,0,-16,1
"6122",2024-09-26,"40 - 1320",207,207,207,0,0,1
"6123",2024-09-26,"40 - 1114",229,232,228,1,3,0.995633187772926
"6124",2024-09-26,"2 - 1066",45,40,45,0,-5,1
"6125",2024-09-26,"82 - 1163",162,148,162,0,-14,1
"6126",2024-09-27,"40 - 1320",207,207,207,0,0,1
"6127",2024-09-27,"40 - 1114",229,232,229,0,3,1
"6128",2024-09-27,"2 - 1066",45,40,45,0,-5,1
"6129",2024-09-27,"82 - 1163",162,148,162,0,-14,1
"6130",2024-09-28,"40 - 1320",207,207,207,0,0,1
"6131",2024-09-28,"40 - 1114",229,232,229,0,3,1
"6132",2024-09-28,"2 - 1066",45,40,45,0,-5,1
"6133",2024-09-28,"82 - 1163",162,148,162,0,-14,1
"6134",2024-09-29,"40 - 1320",206,207,206,0,1,1
"6135",2024-09-29,"40 - 1114",229,232,229,0,3,1
"6136",2024-09-29,"2 - 1066",45,40,45,0,-5,1
"6137",2024-09-29,"82 - 1163",161,148,161,0,-13,1
"6138",2024-09-30,"40 - 1320",207,207,206,1,0,0.995169082125604
"6139",2024-09-30,"40 - 1114",228,232,228,0,4,1
"6140",2024-09-30,"2 - 1066",45,40,45,0,-5,1
"6141",2024-09-30,"82 - 1163",161,148,161,0,-13,1
"6142",2024-10-01,"40 - 1320",207,207,203,4,0,0.980676328502415
"6143",2024-10-01,"40 - 1114",227,232,227,0,5,1
"6144",2024-10-01,"2 - 1066",45,40,45,0,-5,1
"6145",2024-10-01,"82 - 1163",163,148,163,0,-15,1
"6146",2024-10-02,"40 - 1320",203,207,203,0,4,1
"6147",2024-10-02,"40 - 1114",226,232,226,0,6,1
"6148",2024-10-02,"2 - 1066",45,40,45,0,-5,1
"6149",2024-10-02,"82 - 1163",162,148,162,0,-14,1
"6150",2024-10-03,"40 - 1320",203,207,202,1,4,0.995073891625616
"6151",2024-10-03,"40 - 1114",226,232,226,0,6,1
"6152",2024-10-03,"2 - 1066",45,40,45,0,-5,1
"6153",2024-10-03,"82 - 1163",162,134,162,0,-28,1
"6154",2024-10-04,"40 - 1320",205,207,202,3,2,0.985365853658537
"6155",2024-10-04,"40 - 1114",227,232,226,1,5,0.995594713656388
"6156",2024-10-04,"2 - 1066",45,40,45,0,-5,1
"6157",2024-10-04,"82 - 1163",162,134,162,0,-28,1
"6158",2024-10-05,"40 - 1320",204,207,204,0,3,1
"6159",2024-10-05,"40 - 1114",225,232,225,0,7,1
"6160",2024-10-05,"2 - 1066",45,40,45,0,-5,1
"6161",2024-10-05,"82 - 1163",163,134,160,3,-29,0.98159509202454
"6162",2024-10-06,"40 - 1320",206,207,206,0,1,1
"6163",2024-10-06,"40 - 1114",226,232,226,0,6,1
"6164",2024-10-06,"2 - 1066",45,40,45,0,-5,1
"6165",2024-10-06,"82 - 1163",160,134,160,0,-26,1
"6166",2024-10-07,"40 - 1320",206,207,206,0,1,1
"6167",2024-10-07,"40 - 1114",226,232,226,0,6,1
"6168",2024-10-07,"2 - 1066",45,40,45,0,-5,1
"6169",2024-10-07,"82 - 1163",160,134,160,0,-26,1
"6170",2024-10-08,"40 - 1320",206,207,206,0,1,1
"6171",2024-10-08,"40 - 1114",228,232,228,0,4,1
"6172",2024-10-08,"2 - 1066",47,40,45,2,-7,0.957446808510638
"6173",2024-10-08,"82 - 1163",162,148,162,0,-14,1
"6174",2024-10-09,"40 - 1320",207,207,206,1,0,0.995169082125604
"6175",2024-10-09,"40 - 1114",228,232,228,0,4,1
"6176",2024-10-09,"2 - 1066",45,40,45,0,-5,1
"6177",2024-10-09,"82 - 1163",162,148,162,0,-14,1
"6178",2024-10-10,"40 - 1320",206,207,206,0,1,1
"6179",2024-10-10,"40 - 1114",229,232,229,0,3,1
"6180",2024-10-10,"2 - 1066",45,40,45,0,-5,1
"6181",2024-10-10,"82 - 1163",164,148,164,0,-16,1
"6182",2024-10-11,"40 - 1320",206,207,206,0,1,1
"6183",2024-10-11,"40 - 1114",230,232,230,0,2,1
"6184",2024-10-11,"2 - 1066",45,40,45,0,-5,1
"6185",2024-10-11,"82 - 1163",166,148,166,0,-18,1
"6186",2024-10-12,"40 - 1320",206,207,206,0,1,1
"6187",2024-10-12,"40 - 1114",230,232,230,0,2,1
"6188",2024-10-12,"2 - 1066",45,40,45,0,-5,1
"6189",2024-10-12,"82 - 1163",166,148,166,0,-18,1
"6190",2024-10-13,"40 - 1320",206,207,206,0,1,1
"6191",2024-10-13,"40 - 1114",230,232,230,0,2,1
"6192",2024-10-13,"2 - 1066",45,40,45,0,-5,1
"6193",2024-10-13,"82 - 1163",165,148,165,0,-17,1
"6194",2024-10-14,"40 - 1320",206,207,206,0,1,1
"6195",2024-10-14,"40 - 1114",230,232,230,0,2,1
"6196",2024-10-14,"2 - 1066",45,40,45,0,-5,1
"6197",2024-10-14,"82 - 1163",166,148,166,0,-18,1
"6198",2024-10-15,"40 - 1320",206,207,206,0,1,1
"6199",2024-10-15,"40 - 1114",230,232,230,0,2,1
"6200",2024-10-15,"2 - 1066",45,40,45,0,-5,1
"6201",2024-10-15,"82 - 1163",167,148,166,1,-19,0.994011976047904
"6202",2024-10-16,"40 - 1320",207,207,206,1,0,0.995169082125604
"6203",2024-10-16,"40 - 1114",230,232,230,0,2,1
"6204",2024-10-16,"2 - 1066",45,40,45,0,-5,1
"6205",2024-10-16,"82 - 1163",163,148,163,0,-15,1
"6206",2024-10-17,"40 - 1320",207,207,207,0,0,1
"6207",2024-10-17,"40 - 1114",230,232,230,0,2,1
"6208",2024-10-17,"2 - 1066",45,40,45,0,-5,1
"6209",2024-10-17,"82 - 1163",163,148,163,0,-15,1
"6210",2024-10-18,"40 - 1320",207,207,207,0,0,1
"6211",2024-10-18,"40 - 1114",230,232,230,0,2,1
"6212",2024-10-18,"2 - 1066",45,40,45,0,-5,1
"6213",2024-10-18,"82 - 1163",164,148,164,0,-16,1
"6214",2024-10-19,"40 - 1320",207,207,207,0,0,1
"6215",2024-10-19,"40 - 1114",230,232,230,0,2,1
"6216",2024-10-19,"2 - 1066",45,40,45,0,-5,1
"6217",2024-10-19,"82 - 1163",165,148,165,0,-17,1
"6218",2024-10-20,"40 - 1320",207,207,207,0,0,1
"6219",2024-10-20,"40 - 1114",230,232,230,0,2,1
"6220",2024-10-20,"2 - 1066",45,40,45,0,-5,1
"6221",2024-10-20,"82 - 1163",163,134,163,0,-29,1
"6222",2024-10-21,"40 - 1320",207,207,207,0,0,1
"6223",2024-10-21,"40 - 1114",231,232,231,0,1,1
"6224",2024-10-21,"2 - 1066",45,40,45,0,-5,1
"6225",2024-10-21,"82 - 1163",163,134,163,0,-29,1
"6226",2024-10-22,"40 - 1320",207,207,207,0,0,1
"6227",2024-10-22,"40 - 1114",231,232,231,0,1,1
"6228",2024-10-22,"2 - 1066",45,40,45,0,-5,1
"6229",2024-10-22,"82 - 1163",162,134,162,0,-28,1
"6230",2024-10-23,"40 - 1320",207,207,207,0,0,1
"6231",2024-10-23,"40 - 1114",231,232,231,0,1,1
"6232",2024-10-23,"2 - 1066",45,40,45,0,-5,1
"6233",2024-10-23,"82 - 1163",162,134,162,0,-28,1
"6234",2024-10-24,"40 - 1320",207,207,207,0,0,1
"6235",2024-10-24,"40 - 1114",231,232,231,0,1,1
"6236",2024-10-24,"2 - 1066",45,40,45,0,-5,1
"6237",2024-10-24,"82 - 1163",161,134,161,0,-27,1
"6238",2024-10-25,"40 - 1320",207,207,207,0,0,1
"6239",2024-10-25,"40 - 1114",231,232,230,1,1,0.995670995670996
"6240",2024-10-25,"2 - 1066",45,40,45,0,-5,1
"6241",2024-10-25,"82 - 1163",165,134,165,0,-31,1
"6242",2024-10-26,"40 - 1320",206,207,206,0,1,1
"6243",2024-10-26,"40 - 1114",230,232,230,0,2,1
"6244",2024-10-26,"2 - 1066",45,40,45,0,-5,1
"6245",2024-10-26,"82 - 1163",165,134,165,0,-31,1
"6246",2024-10-27,"40 - 1320",207,207,207,0,0,1
"6247",2024-10-27,"40 - 1114",230,232,230,0,2,1
"6248",2024-10-27,"2 - 1066",45,40,45,0,-5,1
"6249",2024-10-27,"82 - 1163",165,134,165,0,-31,1
"6250",2024-10-28,"40 - 1320",207,207,207,0,0,1
"6251",2024-10-28,"40 - 1114",230,232,230,0,2,1
"6252",2024-10-28,"2 - 1066",45,40,45,0,-5,1
"6253",2024-10-28,"82 - 1163",164,134,164,0,-30,1
"6254",2024-10-29,"40 - 1320",207,207,207,0,0,1
"6255",2024-10-29,"40 - 1114",229,232,229,0,3,1
"6256",2024-10-29,"2 - 1066",45,40,45,0,-5,1
"6257",2024-10-29,"82 - 1163",164,134,164,0,-30,1
"6258",2024-10-30,"40 - 1320",207,207,207,0,0,1
"6259",2024-10-30,"40 - 1114",229,232,229,0,3,1
"6260",2024-10-30,"2 - 1066",45,40,45,0,-5,1
"6261",2024-10-30,"82 - 1163",164,134,164,0,-30,1
"6262",2024-10-31,"40 - 1320",207,207,207,0,0,1
"6263",2024-10-31,"40 - 1114",228,232,228,0,4,1
"6264",2024-10-31,"2 - 1066",43,40,43,0,-3,1
"6265",2024-10-31,"82 - 1163",163,134,163,0,-29,1
"6266",2024-11-01,"40 - 1320",206,207,206,0,1,1
"6267",2024-11-01,"40 - 1114",225,232,225,0,7,1
"6268",2024-11-01,"2 - 1066",42,40,42,0,-2,1
"6269",2024-11-01,"82 - 1163",162,134,162,0,-28,1
"6270",2024-11-02,"40 - 1320",203,207,203,0,4,1
"6271",2024-11-02,"40 - 1114",224,232,224,0,8,1
"6272",2024-11-02,"2 - 1066",42,40,42,0,-2,1
"6273",2024-11-02,"82 - 1163",162,134,162,0,-28,1
"6274",2024-11-03,"40 - 1320",205,207,204,1,2,0.995121951219512
"6275",2024-11-03,"40 - 1114",222,232,222,0,10,1
"6276",2024-11-03,"2 - 1066",42,40,42,0,-2,1
"6277",2024-11-03,"82 - 1163",161,134,161,0,-27,1
"6278",2024-11-04,"40 - 1320",203,207,203,0,4,1
"6279",2024-11-04,"40 - 1114",223,232,222,1,9,0.995515695067265
"6280",2024-11-04,"2 - 1066",41,40,41,0,-1,1
"6281",2024-11-04,"82 - 1163",162,134,162,0,-28,1
"6282",2024-11-05,"40 - 1320",205,207,205,0,2,1
"6283",2024-11-05,"40 - 1114",225,232,225,0,7,1
"6284",2024-11-05,"2 - 1066",42,40,42,0,-2,1
"6285",2024-11-05,"82 - 1163",162,134,162,0,-28,1
"6286",2024-11-06,"40 - 1320",206,207,206,0,1,1
"6287",2024-11-06,"40 - 1114",228,232,227,1,4,0.995614035087719
"6288",2024-11-06,"2 - 1066",42,40,42,0,-2,1
"6289",2024-11-06,"82 - 1163",163,134,163,0,-29,1
"6290",2024-11-07,"40 - 1320",206,207,206,0,1,1
"6291",2024-11-07,"40 - 1114",228,232,227,1,4,0.995614035087719
"6292",2024-11-07,"2 - 1066",43,40,43,0,-3,1
"6293",2024-11-07,"82 - 1163",163,134,163,0,-29,1
"6294",2024-11-08,"40 - 1320",206,207,206,0,1,1
"6295",2024-11-08,"40 - 1114",230,232,230,0,2,1
"6296",2024-11-08,"2 - 1066",43,40,43,0,-3,1
"6297",2024-11-08,"82 - 1163",165,148,165,0,-17,1
"6298",2024-11-09,"40 - 1320",206,207,206,0,1,1
"6299",2024-11-09,"40 - 1114",230,232,230,0,2,1
"6300",2024-11-09,"2 - 1066",43,40,43,0,-3,1
"6301",2024-11-09,"82 - 1163",165,148,165,0,-17,1
"6302",2024-11-10,"40 - 1320",206,207,206,0,1,1
"6303",2024-11-10,"40 - 1114",230,232,229,1,2,0.995652173913044
"6304",2024-11-10,"2 - 1066",43,40,43,0,-3,1
"6305",2024-11-10,"82 - 1163",165,148,165,0,-17,1
"6306",2024-11-11,"40 - 1320",206,207,206,0,1,1
"6307",2024-11-11,"40 - 1114",228,232,228,0,4,1
"6308",2024-11-11,"2 - 1066",44,40,44,0,-4,1
"6309",2024-11-11,"82 - 1163",165,148,165,0,-17,1
"6310",2024-11-12,"40 - 1320",206,207,206,0,1,1
"6311",2024-11-12,"40 - 1114",228,232,228,0,4,1
"6312",2024-11-12,"2 - 1066",44,40,44,0,-4,1
"6313",2024-11-12,"82 - 1163",166,148,166,0,-18,1
"6314",2024-11-13,"40 - 1320",207,207,206,1,0,0.995169082125604
"6315",2024-11-13,"40 - 1114",228,232,228,0,4,1
"6316",2024-11-13,"2 - 1066",44,40,44,0,-4,1
"6317",2024-11-13,"82 - 1163",165,148,165,0,-17,1
"6318",2024-11-14,"40 - 1320",206,207,206,0,1,1
"6319",2024-11-14,"40 - 1114",226,232,226,0,6,1
"6320",2024-11-14,"2 - 1066",44,40,44,0,-4,1
"6321",2024-11-14,"82 - 1163",165,148,165,0,-17,1
"6322",2024-11-15,"40 - 1320",206,207,205,1,1,0.995145631067961
"6323",2024-11-15,"40 - 1114",224,232,224,0,8,1
"6324",2024-11-15,"2 - 1066",44,40,44,0,-4,1
"6325",2024-11-15,"82 - 1163",166,148,166,0,-18,1
"6326",2024-11-16,"40 - 1320",206,207,206,0,1,1
"6327",2024-11-16,"40 - 1114",223,232,223,0,9,1
"6328",2024-11-16,"2 - 1066",45,40,45,0,-5,1
"6329",2024-11-16,"82 - 1163",166,148,166,0,-18,1
"6330",2024-11-17,"40 - 1320",206,207,206,0,1,1
"6331",2024-11-17,"40 - 1114",222,232,222,0,10,1
"6332",2024-11-17,"2 - 1066",45,40,45,0,-5,1
"6333",2024-11-17,"82 - 1163",166,148,166,0,-18,1
"6334",2024-11-18,"40 - 1320",205,207,205,0,2,1
"6335",2024-11-18,"40 - 1114",222,231,222,0,9,1
"6336",2024-11-18,"2 - 1066",45,40,45,0,-5,1
"6337",2024-11-18,"82 - 1163",165,134,165,0,-31,1
"6338",2024-11-19,"40 - 1320",205,207,205,0,2,1
"6339",2024-11-19,"40 - 1114",222,231,222,0,9,1
"6340",2024-11-19,"2 - 1066",45,40,45,0,-5,1
"6341",2024-11-19,"82 - 1163",165,134,165,0,-31,1
"6342",2024-11-20,"40 - 1320",205,207,204,1,2,0.995121951219512
"6343",2024-11-20,"40 - 1114",222,231,222,0,9,1
"6344",2024-11-20,"2 - 1066",45,40,45,0,-5,1
"6345",2024-11-20,"82 - 1163",165,148,165,0,-17,1
"6346",2024-11-21,"40 - 1320",204,207,204,0,3,1
"6347",2024-11-21,"40 - 1114",225,231,224,1,6,0.995555555555556
"6348",2024-11-21,"2 - 1066",45,40,45,0,-5,1
"6349",2024-11-21,"82 - 1163",165,148,165,0,-17,1
"6350",2024-11-22,"40 - 1320",205,207,205,0,2,1
"6351",2024-11-22,"40 - 1114",227,231,227,0,4,1
"6352",2024-11-22,"2 - 1066",45,40,45,0,-5,1
"6353",2024-11-22,"82 - 1163",162,148,162,0,-14,1
"6354",2024-11-23,"40 - 1320",206,207,206,0,1,1
"6355",2024-11-23,"40 - 1114",227,231,227,0,4,1
"6356",2024-11-23,"2 - 1066",45,40,45,0,-5,1
"6357",2024-11-23,"82 - 1163",162,148,162,0,-14,1
"6358",2024-11-24,"40 - 1320",206,207,206,0,1,1
"6359",2024-11-24,"40 - 1114",226,231,226,0,5,1
"6360",2024-11-24,"2 - 1066",45,40,45,0,-5,1
"6361",2024-11-24,"82 - 1163",164,148,164,0,-16,1
"6362",2024-11-25,"40 - 1320",206,207,206,0,1,1
"6363",2024-11-25,"40 - 1114",227,231,227,0,4,1
"6364",2024-11-25,"2 - 1066",46,40,45,1,-6,0.978260869565217
"6365",2024-11-25,"82 - 1163",164,148,164,0,-16,1
"6366",2024-11-26,"40 - 1320",207,207,206,1,0,0.995169082125604
"6367",2024-11-26,"40 - 1114",227,231,227,0,4,1
"6368",2024-11-26,"2 - 1066",46,40,46,0,-6,1
"6369",2024-11-26,"82 - 1163",164,148,164,0,-16,1
"6370",2024-11-27,"40 - 1320",207,207,207,0,0,1
"6371",2024-11-27,"40 - 1114",226,231,226,0,5,1
"6372",2024-11-27,"2 - 1066",46,40,46,0,-6,1
"6373",2024-11-27,"82 - 1163",164,148,164,0,-16,1
"6374",2024-11-28,"40 - 1320",207,207,207,0,0,1
"6375",2024-11-28,"40 - 1114",226,231,226,0,5,1
"6376",2024-11-28,"2 - 1066",46,40,46,0,-6,1
"6377",2024-11-28,"82 - 1163",162,148,162,0,-14,1
"6378",2024-11-29,"40 - 1320",207,207,207,0,0,1
"6379",2024-11-29,"40 - 1114",226,231,226,0,5,1
"6380",2024-11-29,"2 - 1066",46,40,46,0,-6,1
"6381",2024-11-29,"82 - 1163",160,148,159,1,-12,0.99375
"6382",2024-11-30,"40 - 1320",207,207,207,0,0,1
"6383",2024-11-30,"40 - 1114",224,231,224,0,7,1
"6384",2024-11-30,"2 - 1066",46,40,46,0,-6,1
"6385",2024-11-30,"82 - 1163",157,134,157,0,-23,1
"6386",2024-12-01,"40 - 1320",205,207,205,0,2,1
"6387",2024-12-01,"40 - 1114",225,231,225,0,6,1
"6388",2024-12-01,"2 - 1066",46,40,46,0,-6,1
"6389",2024-12-01,"82 - 1163",157,134,157,0,-23,1
"6390",2024-12-02,"40 - 1320",204,207,203,1,3,0.995098039215686
"6391",2024-12-02,"40 - 1114",225,231,223,2,6,0.991111111111111
"6392",2024-12-02,"2 - 1066",46,40,46,0,-6,1
"6393",2024-12-02,"82 - 1163",157,134,157,0,-23,1
"6394",2024-12-03,"40 - 1320",204,207,204,0,3,1
"6395",2024-12-03,"40 - 1114",222,231,222,0,9,1
"6396",2024-12-03,"2 - 1066",46,40,46,0,-6,1
"6397",2024-12-03,"82 - 1163",157,134,157,0,-23,1
"6398",2024-12-04,"40 - 1320",205,207,203,2,2,0.990243902439024
"6399",2024-12-04,"40 - 1114",221,231,221,0,10,1
"6400",2024-12-04,"2 - 1066",46,40,46,0,-6,1
"6401",2024-12-04,"82 - 1163",158,148,158,0,-10,1
"6402",2024-12-05,"40 - 1320",205,207,204,1,2,0.995121951219512
"6403",2024-12-05,"40 - 1114",224,231,224,0,7,1
"6404",2024-12-05,"2 - 1066",46,40,45,1,-6,0.978260869565217
"6405",2024-12-05,"82 - 1163",156,148,155,1,-8,0.993589743589744
"6406",2024-12-06,"40 - 1320",205,207,204,1,2,0.995121951219512
"6407",2024-12-06,"40 - 1114",226,231,226,0,5,1
"6408",2024-12-06,"2 - 1066",46,40,45,1,-6,0.978260869565217
"6409",2024-12-06,"82 - 1163",156,148,154,2,-8,0.987179487179487
"6410",2024-12-07,"40 - 1320",206,207,206,0,1,1
"6411",2024-12-07,"40 - 1114",228,231,228,0,3,1
"6412",2024-12-07,"2 - 1066",46,40,45,1,-6,0.978260869565217
"6413",2024-12-07,"82 - 1163",154,148,154,0,-6,1
"6414",2024-12-08,"40 - 1320",206,207,206,0,1,1
"6415",2024-12-08,"40 - 1114",228,231,228,0,3,1
"6416",2024-12-08,"2 - 1066",46,40,45,1,-6,0.978260869565217
"6417",2024-12-08,"82 - 1163",154,148,154,0,-6,1
"6418",2024-12-09,"40 - 1320",206,207,206,0,1,1
"6419",2024-12-09,"40 - 1114",229,231,229,0,2,1
"6420",2024-12-09,"2 - 1066",46,40,45,1,-6,0.978260869565217
"6421",2024-12-09,"82 - 1163",157,148,156,1,-9,0.993630573248408
"6422",2024-12-10,"40 - 1320",206,207,205,1,1,0.995145631067961
"6423",2024-12-10,"40 - 1114",229,231,228,1,2,0.995633187772926
"6424",2024-12-10,"2 - 1066",47,40,45,2,-7,0.957446808510638
"6425",2024-12-10,"82 - 1163",156,148,156,0,-8,1
"6426",2024-12-11,"40 - 1320",206,207,206,0,1,1
"6427",2024-12-11,"40 - 1114",227,231,227,0,4,1
"6428",2024-12-11,"2 - 1066",46,40,45,1,-6,0.978260869565217
"6429",2024-12-11,"82 - 1163",156,148,155,1,-8,0.993589743589744
"6430",2024-12-12,"40 - 1320",207,207,207,0,0,1
"6431",2024-12-12,"40 - 1114",228,231,228,0,3,1
"6432",2024-12-12,"2 - 1066",46,40,45,1,-6,0.978260869565217
"6433",2024-12-12,"82 - 1163",155,148,155,0,-7,1
"6434",2024-12-13,"40 - 1320",207,207,207,0,0,1
"6435",2024-12-13,"40 - 1114",229,231,229,0,2,1
"6436",2024-12-13,"2 - 1066",46,40,45,1,-6,0.978260869565217
"6437",2024-12-13,"82 - 1163",161,148,159,2,-13,0.987577639751553
"6438",2024-12-14,"40 - 1320",207,207,207,0,0,1
"6439",2024-12-14,"40 - 1114",229,231,228,1,2,0.995633187772926
"6440",2024-12-14,"2 - 1066",45,40,45,0,-5,1
"6441",2024-12-14,"82 - 1163",159,148,157,2,-11,0.987421383647799
"6442",2024-12-15,"40 - 1320",205,207,205,0,2,1
"6443",2024-12-15,"40 - 1114",228,231,228,0,3,1
"6444",2024-12-15,"2 - 1066",45,40,45,0,-5,1
"6445",2024-12-15,"82 - 1163",157,148,157,0,-9,1
"6446",2024-12-16,"40 - 1320",205,207,205,0,2,1
"6447",2024-12-16,"40 - 1114",230,231,230,0,1,1
"6448",2024-12-16,"2 - 1066",45,40,45,0,-5,1
"6449",2024-12-16,"82 - 1163",156,148,156,0,-8,1
"6450",2024-12-17,"40 - 1320",205,207,205,0,2,1
"6451",2024-12-17,"40 - 1114",227,231,227,0,4,1
"6452",2024-12-17,"2 - 1066",45,40,45,0,-5,1
"6453",2024-12-17,"82 - 1163",155,148,155,0,-7,1
"6454",2024-12-18,"40 - 1320",206,207,206,0,1,1
"6455",2024-12-18,"40 - 1114",227,231,226,1,4,0.995594713656388
"6456",2024-12-18,"2 - 1066",45,40,45,0,-5,1
"6457",2024-12-18,"82 - 1163",155,148,155,0,-7,1
"6458",2024-12-19,"40 - 1320",207,207,207,0,0,1
"6459",2024-12-19,"40 - 1114",226,231,226,0,5,1
"6460",2024-12-19,"2 - 1066",45,40,45,0,-5,1
"6461",2024-12-19,"82 - 1163",155,148,154,1,-7,0.993548387096774
"6462",2024-12-20,"40 - 1320",207,207,207,0,0,1
"6463",2024-12-20,"40 - 1114",225,231,225,0,6,1
"6464",2024-12-20,"2 - 1066",45,40,45,0,-5,1
"6465",2024-12-20,"82 - 1163",154,148,154,0,-6,1
"6466",2024-12-21,"40 - 1320",207,207,207,0,0,1
"6467",2024-12-21,"40 - 1114",224,231,224,0,7,1
"6468",2024-12-21,"2 - 1066",45,40,45,0,-5,1
"6469",2024-12-21,"82 - 1163",154,148,154,0,-6,1
"6470",2024-12-22,"40 - 1320",207,207,207,0,0,1
"6471",2024-12-22,"40 - 1114",224,231,224,0,7,1
"6472",2024-12-22,"2 - 1066",45,40,45,0,-5,1
"6473",2024-12-22,"82 - 1163",154,148,154,0,-6,1
"6474",2024-12-23,"40 - 1320",207,207,207,0,0,1
"6475",2024-12-23,"40 - 1114",227,231,227,0,4,1
"6476",2024-12-23,"2 - 1066",45,40,45,0,-5,1
"6477",2024-12-23,"82 - 1163",155,148,154,1,-7,0.993548387096774
"6478",2024-12-24,"40 - 1320",207,207,207,0,0,1
"6479",2024-12-24,"40 - 1114",227,231,227,0,4,1
"6480",2024-12-24,"2 - 1066",45,40,45,0,-5,1
"6481",2024-12-24,"82 - 1163",156,148,155,1,-8,0.993589743589744
"6482",2024-12-25,"40 - 1320",207,207,207,0,0,1
"6483",2024-12-25,"40 - 1114",227,231,227,0,4,1
"6484",2024-12-25,"2 - 1066",45,40,45,0,-5,1
"6485",2024-12-25,"82 - 1163",155,148,155,0,-7,1
"6486",2024-12-26,"40 - 1320",207,207,207,0,0,1
"6487",2024-12-26,"40 - 1114",227,231,227,0,4,1
"6488",2024-12-26,"2 - 1066",46,40,46,0,-6,1
"6489",2024-12-26,"82 - 1163",154,148,152,2,-6,0.987012987012987
"6490",2024-12-27,"40 - 1320",207,207,207,0,0,1
"6491",2024-12-27,"40 - 1114",229,231,228,1,2,0.995633187772926
"6492",2024-12-27,"2 - 1066",46,40,46,0,-6,1
"6493",2024-12-27,"82 - 1163",152,148,152,0,-4,1
"6494",2024-12-28,"40 - 1320",207,207,207,0,0,1
"6495",2024-12-28,"40 - 1114",228,231,228,0,3,1
"6496",2024-12-28,"2 - 1066",46,40,46,0,-6,1
"6497",2024-12-28,"82 - 1163",152,148,152,0,-4,1
"6498",2024-12-29,"40 - 1320",207,207,207,0,0,1
"6499",2024-12-29,"40 - 1114",228,231,228,0,3,1
"6500",2024-12-29,"2 - 1066",46,40,46,0,-6,1
"6501",2024-12-29,"82 - 1163",151,148,151,0,-3,1
"6502",2024-12-30,"40 - 1320",207,207,207,0,0,1
"6503",2024-12-30,"40 - 1114",229,231,229,0,2,1
"6504",2024-12-30,"2 - 1066",46,40,46,0,-6,1
"6505",2024-12-30,"82 - 1163",152,148,150,2,-4,0.986842105263158
"6506",2024-12-31,"40 - 1320",207,207,206,1,0,0.995169082125604
"6507",2024-12-31,"40 - 1114",230,231,229,1,1,0.995652173913044
"6508",2024-12-31,"2 - 1066",46,40,46,0,-6,1
"6509",2024-12-31,"82 - 1163",152,148,152,0,-4,1
