"OCCUPANCY_DATE","shelter_location_pair","capacity_actual_sum","capacity_funding_sum","occupied_sum","unoccupied_sum","unavailable_sum","occupancy_rate"
21-01-01,"62 - 1011",55,61,55,0,6,1
21-01-01,"3 - 1008",201,208,185,16,7,0.920398009950249
21-01-01,"16 - 1022",50,50,45,5,0,0.9
21-01-01,"24 - 1150",172,173,161,11,1,0.936046511627907
21-01-01,"24 - 1153",125,125,123,2,0,0.984
21-01-02,"62 - 1011",55,61,54,1,6,0.981818181818182
21-01-02,"3 - 1008",201,208,186,15,7,0.925373134328358
21-01-02,"16 - 1022",50,50,45,5,0,0.9
21-01-02,"24 - 1150",170,173,158,12,3,0.929411764705882
21-01-02,"24 - 1153",125,125,125,0,0,1
21-01-03,"62 - 1011",55,61,53,2,6,0.963636363636364
21-01-03,"3 - 1008",201,208,186,15,7,0.925373134328358
21-01-03,"16 - 1022",48,50,42,6,2,0.875
21-01-03,"24 - 1150",170,173,150,20,3,0.882352941176471
21-01-03,"24 - 1153",125,125,125,0,0,1
21-01-04,"62 - 1011",52,61,52,0,9,1
21-01-04,"3 - 1008",201,208,188,13,7,0.935323383084577
21-01-04,"16 - 1022",49,50,48,1,1,0.979591836734694
21-01-04,"24 - 1150",170,173,157,13,3,0.923529411764706
21-01-04,"24 - 1153",125,125,123,2,0,0.984
21-01-05,"62 - 1011",51,61,50,1,10,0.980392156862745
21-01-05,"3 - 1008",201,208,185,16,7,0.920398009950249
21-01-05,"16 - 1022",50,50,48,2,0,0.96
21-01-05,"24 - 1150",169,173,153,16,4,0.905325443786982
21-01-05,"24 - 1153",125,125,125,0,0,1
21-01-06,"62 - 1011",51,61,49,2,10,0.96078431372549
21-01-06,"3 - 1008",201,208,188,13,7,0.935323383084577
21-01-06,"16 - 1022",50,50,50,0,0,1
21-01-06,"24 - 1150",152,173,152,0,21,1
21-01-06,"24 - 1153",125,125,125,0,0,1
21-01-07,"62 - 1011",51,61,49,2,10,0.96078431372549
21-01-07,"3 - 1008",201,208,188,13,7,0.935323383084577
21-01-07,"16 - 1022",50,50,48,2,0,0.96
21-01-07,"24 - 1150",147,173,147,0,26,1
21-01-07,"24 - 1153",125,125,123,2,0,0.984
21-01-08,"62 - 1011",52,61,49,3,9,0.942307692307692
21-01-08,"3 - 1008",201,208,188,13,7,0.935323383084577
21-01-08,"16 - 1022",50,50,50,0,0,1
21-01-08,"24 - 1150",144,173,144,0,29,1
21-01-08,"24 - 1153",125,125,124,1,0,0.992
21-01-09,"62 - 1011",53,61,52,1,8,0.981132075471698
21-01-09,"3 - 1008",201,208,189,12,7,0.940298507462687
21-01-09,"16 - 1022",50,50,50,0,0,1
21-01-09,"24 - 1150",139,173,139,0,34,1
21-01-09,"24 - 1153",125,125,123,2,0,0.984
21-01-10,"62 - 1011",53,61,52,1,8,0.981132075471698
21-01-10,"3 - 1008",201,208,184,17,7,0.915422885572139
21-01-10,"16 - 1022",50,50,48,2,0,0.96
21-01-10,"24 - 1150",132,173,131,1,41,0.992424242424242
21-01-10,"24 - 1153",125,125,123,2,0,0.984
21-01-11,"62 - 1011",52,61,52,0,9,1
21-01-11,"3 - 1008",201,208,184,17,7,0.915422885572139
21-01-11,"16 - 1022",50,50,48,2,0,0.96
21-01-11,"24 - 1150",128,173,128,0,45,1
21-01-11,"24 - 1153",125,125,124,1,0,0.992
21-01-12,"62 - 1011",52,61,52,0,9,1
21-01-12,"3 - 1008",201,208,180,21,7,0.895522388059702
21-01-12,"16 - 1022",50,50,47,3,0,0.94
21-01-12,"24 - 1150",126,173,126,0,47,1
21-01-12,"24 - 1153",125,125,125,0,0,1
21-01-13,"62 - 1011",53,61,53,0,8,1
21-01-13,"3 - 1008",200,208,178,22,8,0.89
21-01-13,"16 - 1022",50,50,48,2,0,0.96
21-01-13,"24 - 1150",123,173,123,0,50,1
21-01-13,"24 - 1153",125,125,124,1,0,0.992
21-01-14,"62 - 1011",53,61,52,1,8,0.981132075471698
21-01-14,"3 - 1008",202,208,177,25,6,0.876237623762376
21-01-14,"16 - 1022",50,50,50,0,0,1
21-01-14,"24 - 1150",119,173,119,0,54,1
21-01-14,"24 - 1153",125,125,125,0,0,1
21-01-15,"62 - 1011",55,61,48,7,6,0.872727272727273
21-01-15,"3 - 1008",201,208,176,25,7,0.875621890547264
21-01-15,"16 - 1022",50,50,49,1,0,0.98
21-01-15,"24 - 1150",118,173,118,0,55,1
21-01-15,"24 - 1153",125,125,124,1,0,0.992
21-01-16,"62 - 1011",55,61,41,14,6,0.745454545454545
21-01-16,"3 - 1008",201,208,176,25,7,0.875621890547264
21-01-16,"16 - 1022",50,50,50,0,0,1
21-01-16,"24 - 1150",117,173,117,0,56,1
21-01-16,"24 - 1153",125,125,125,0,0,1
21-01-17,"62 - 1011",55,61,44,11,6,0.8
21-01-17,"3 - 1008",201,208,175,26,7,0.870646766169154
21-01-17,"16 - 1022",50,50,50,0,0,1
21-01-17,"24 - 1150",127,173,126,1,46,0.992125984251969
21-01-17,"24 - 1153",125,125,125,0,0,1
21-01-18,"62 - 1011",55,61,45,10,6,0.818181818181818
21-01-18,"3 - 1008",199,208,176,23,9,0.884422110552764
21-01-18,"16 - 1022",50,50,50,0,0,1
21-01-18,"24 - 1150",173,173,131,42,0,0.757225433526012
21-01-18,"24 - 1153",125,125,125,0,0,1
21-01-19,"62 - 1011",55,61,47,8,6,0.854545454545454
21-01-19,"3 - 1008",199,208,181,18,9,0.909547738693467
21-01-19,"16 - 1022",50,50,50,0,0,1
21-01-19,"24 - 1150",171,173,136,35,2,0.795321637426901
21-01-19,"24 - 1153",125,125,119,6,0,0.952
21-01-20,"62 - 1011",55,61,51,4,6,0.927272727272727
21-01-20,"3 - 1008",199,208,187,12,9,0.939698492462312
21-01-20,"16 - 1022",50,50,49,1,0,0.98
21-01-20,"24 - 1150",170,173,140,30,3,0.823529411764706
21-01-20,"24 - 1153",125,125,122,3,0,0.976
21-01-21,"62 - 1011",54,61,51,3,7,0.944444444444444
21-01-21,"3 - 1008",199,208,188,11,9,0.944723618090452
21-01-21,"16 - 1022",50,50,49,1,0,0.98
21-01-21,"24 - 1150",172,173,143,29,1,0.831395348837209
21-01-21,"24 - 1153",125,125,123,2,0,0.984
21-01-22,"62 - 1011",54,61,53,1,7,0.981481481481482
21-01-22,"3 - 1008",206,208,190,16,2,0.922330097087379
21-01-22,"16 - 1022",50,50,50,0,0,1
21-01-22,"24 - 1150",171,173,145,26,2,0.847953216374269
21-01-22,"24 - 1153",157,157,129,28,0,0.821656050955414
21-01-23,"62 - 1011",54,61,52,2,7,0.962962962962963
21-01-23,"3 - 1008",206,208,191,15,2,0.927184466019418
21-01-23,"16 - 1022",50,50,50,0,0,1
21-01-23,"24 - 1150",172,173,150,22,1,0.872093023255814
21-01-23,"24 - 1153",157,157,153,4,0,0.974522292993631
21-01-24,"62 - 1011",54,61,51,3,7,0.944444444444444
21-01-24,"3 - 1008",206,208,189,17,2,0.91747572815534
21-01-24,"16 - 1022",50,50,50,0,0,1
21-01-24,"24 - 1150",172,173,157,15,1,0.912790697674419
21-01-24,"24 - 1153",157,157,155,2,0,0.987261146496815
21-01-25,"62 - 1011",55,61,53,2,6,0.963636363636364
21-01-25,"3 - 1008",205,208,191,14,3,0.931707317073171
21-01-25,"16 - 1022",50,50,50,0,0,1
21-01-25,"24 - 1150",173,173,164,9,0,0.947976878612717
21-01-25,"24 - 1153",136,157,126,10,21,0.926470588235294
21-01-26,"62 - 1011",55,61,54,1,6,0.981818181818182
21-01-26,"3 - 1008",205,208,189,16,3,0.921951219512195
21-01-26,"16 - 1022",50,50,50,0,0,1
21-01-26,"24 - 1150",172,173,155,17,1,0.901162790697674
21-01-26,"24 - 1153",125,125,125,0,0,1
21-01-27,"62 - 1011",55,61,55,0,6,1
21-01-27,"3 - 1008",205,208,191,14,3,0.931707317073171
21-01-27,"16 - 1022",50,50,49,1,0,0.98
21-01-27,"24 - 1150",154,173,154,0,19,1
21-01-27,"24 - 1153",157,157,144,13,0,0.917197452229299
21-01-28,"62 - 1011",54,61,54,0,7,1
21-01-28,"3 - 1008",206,208,190,16,2,0.922330097087379
21-01-28,"16 - 1022",50,50,46,4,0,0.92
21-01-28,"24 - 1150",148,173,148,0,25,1
21-01-28,"24 - 1153",175,175,154,21,0,0.88
21-01-29,"62 - 1011",55,61,55,0,6,1
21-01-29,"3 - 1008",206,208,193,13,2,0.936893203883495
21-01-29,"16 - 1022",50,50,46,4,0,0.92
21-01-29,"24 - 1150",145,173,145,0,28,1
21-01-29,"24 - 1153",175,175,169,6,0,0.965714285714286
21-01-30,"62 - 1011",57,61,57,0,4,1
21-01-30,"3 - 1008",206,208,188,18,2,0.912621359223301
21-01-30,"16 - 1022",50,50,46,4,0,0.92
21-01-30,"24 - 1150",144,173,144,0,29,1
21-01-30,"24 - 1153",175,175,172,3,0,0.982857142857143
21-01-31,"62 - 1011",56,61,56,0,5,1
21-01-31,"3 - 1008",206,208,186,20,2,0.902912621359223
21-01-31,"16 - 1022",50,50,46,4,0,0.92
21-01-31,"24 - 1150",144,173,144,0,29,1
21-01-31,"24 - 1153",175,175,173,2,0,0.988571428571429
21-02-01,"62 - 1011",54,61,53,1,7,0.981481481481482
21-02-01,"3 - 1008",207,208,184,23,1,0.888888888888889
21-02-01,"16 - 1022",50,50,49,1,0,0.98
21-02-01,"24 - 1150",134,173,134,0,39,1
21-02-01,"24 - 1153",175,175,173,2,0,0.988571428571429
21-02-02,"62 - 1011",55,61,54,1,6,0.981818181818182
21-02-02,"3 - 1008",205,208,166,39,3,0.809756097560976
21-02-02,"16 - 1022",50,50,48,2,0,0.96
21-02-02,"24 - 1150",123,173,123,0,50,1
21-02-02,"24 - 1153",125,125,125,0,0,1
21-02-03,"62 - 1011",55,61,54,1,6,0.981818181818182
21-02-03,"3 - 1008",169,208,164,5,39,0.970414201183432
21-02-03,"16 - 1022",50,50,49,1,0,0.98
21-02-03,"24 - 1150",117,173,117,0,56,1
21-02-03,"24 - 1153",124,125,124,0,1,1
21-02-04,"62 - 1011",55,61,51,4,6,0.927272727272727
21-02-04,"3 - 1008",166,208,162,4,42,0.975903614457831
21-02-04,"16 - 1022",50,50,47,3,0,0.94
21-02-04,"24 - 1150",115,173,115,0,58,1
21-02-04,"24 - 1153",122,125,122,0,3,1
21-02-05,"62 - 1011",55,61,49,6,6,0.890909090909091
21-02-05,"3 - 1008",156,208,155,1,52,0.993589743589744
21-02-05,"16 - 1022",50,50,48,2,0,0.96
21-02-05,"24 - 1150",112,173,112,0,61,1
21-02-05,"24 - 1153",118,125,118,0,7,1
21-02-06,"62 - 1011",54,61,49,5,7,0.907407407407407
21-02-06,"3 - 1008",155,208,152,3,53,0.980645161290323
21-02-06,"16 - 1022",50,50,47,3,0,0.94
21-02-06,"24 - 1150",109,173,109,0,64,1
21-02-06,"24 - 1153",117,125,117,0,8,1
21-02-07,"62 - 1011",54,61,49,5,7,0.907407407407407
21-02-07,"3 - 1008",155,208,154,1,53,0.993548387096774
21-02-07,"16 - 1022",50,50,47,3,0,0.94
21-02-07,"24 - 1150",108,173,107,1,65,0.990740740740741
21-02-07,"24 - 1153",167,175,141,26,8,0.844311377245509
21-02-08,"62 - 1011",54,61,51,3,7,0.944444444444444
21-02-08,"3 - 1008",155,208,155,0,53,1
21-02-08,"16 - 1022",50,50,47,3,0,0.94
21-02-08,"24 - 1150",101,173,101,0,72,1
21-02-08,"24 - 1153",163,175,163,0,12,1
21-02-09,"62 - 1011",54,61,48,6,7,0.888888888888889
21-02-09,"3 - 1008",155,208,154,1,53,0.993548387096774
21-02-09,"16 - 1022",50,50,48,2,0,0.96
21-02-09,"24 - 1150",96,173,96,0,77,1
21-02-09,"24 - 1153",160,175,160,0,15,1
21-02-10,"62 - 1011",54,61,47,7,7,0.87037037037037
21-02-10,"3 - 1008",153,208,149,4,55,0.973856209150327
21-02-10,"16 - 1022",50,50,48,2,0,0.96
21-02-10,"24 - 1150",173,173,122,51,0,0.705202312138728
21-02-10,"24 - 1153",159,175,159,0,16,1
21-02-11,"62 - 1011",54,61,47,7,7,0.87037037037037
21-02-11,"3 - 1008",147,208,145,2,61,0.986394557823129
21-02-11,"16 - 1022",50,50,48,2,0,0.96
21-02-11,"24 - 1150",173,173,132,41,0,0.763005780346821
21-02-11,"24 - 1153",158,175,158,0,17,1
21-02-12,"62 - 1011",54,61,46,8,7,0.851851851851852
21-02-12,"3 - 1008",155,208,154,1,53,0.993548387096774
21-02-12,"16 - 1022",50,50,48,2,0,0.96
21-02-12,"24 - 1150",172,173,134,38,1,0.779069767441861
21-02-12,"24 - 1153",175,175,171,4,0,0.977142857142857
21-02-13,"62 - 1011",54,61,46,8,7,0.851851851851852
21-02-13,"3 - 1008",159,208,159,0,49,1
21-02-13,"16 - 1022",50,50,48,2,0,0.96
21-02-13,"24 - 1150",171,173,135,36,2,0.789473684210526
21-02-13,"24 - 1153",175,175,174,1,0,0.994285714285714
21-02-14,"62 - 1011",54,61,46,8,7,0.851851851851852
21-02-14,"3 - 1008",158,208,158,0,50,1
21-02-14,"16 - 1022",49,50,47,2,1,0.959183673469388
21-02-14,"24 - 1150",172,173,137,35,1,0.796511627906977
21-02-14,"24 - 1153",175,175,172,3,0,0.982857142857143
21-02-15,"62 - 1011",54,61,44,10,7,0.814814814814815
21-02-15,"3 - 1008",162,208,162,0,46,1
21-02-15,"16 - 1022",48,50,47,1,2,0.979166666666667
21-02-15,"24 - 1150",172,173,138,34,1,0.802325581395349
21-02-15,"24 - 1153",175,175,165,10,0,0.942857142857143
21-02-16,"62 - 1011",53,61,44,9,8,0.830188679245283
21-02-16,"3 - 1008",159,208,159,0,49,1
21-02-16,"16 - 1022",46,50,45,1,4,0.978260869565217
21-02-16,"24 - 1150",172,173,148,24,1,0.86046511627907
21-02-16,"24 - 1153",175,175,172,3,0,0.982857142857143
21-02-17,"62 - 1011",54,61,46,8,7,0.851851851851852
21-02-17,"3 - 1008",160,208,160,0,48,1
21-02-17,"16 - 1022",45,50,43,2,5,0.955555555555556
21-02-17,"24 - 1150",171,173,151,20,2,0.883040935672515
21-02-17,"24 - 1153",175,175,175,0,0,1
21-02-18,"62 - 1011",54,61,46,8,7,0.851851851851852
21-02-18,"3 - 1008",160,208,160,0,48,1
21-02-18,"16 - 1022",49,50,48,1,1,0.979591836734694
21-02-18,"24 - 1150",170,173,146,24,3,0.858823529411765
21-02-18,"24 - 1153",174,175,174,0,1,1
21-02-19,"62 - 1011",54,61,51,3,7,0.944444444444444
21-02-19,"3 - 1008",161,208,161,0,47,1
21-02-19,"16 - 1022",49,50,48,1,1,0.979591836734694
21-02-19,"24 - 1150",171,173,151,20,2,0.883040935672515
21-02-19,"24 - 1153",175,175,175,0,0,1
21-02-20,"62 - 1011",54,61,54,0,7,1
21-02-20,"3 - 1008",162,208,162,0,46,1
21-02-20,"16 - 1022",50,50,49,1,0,0.98
21-02-20,"24 - 1150",171,173,150,21,2,0.87719298245614
21-02-20,"24 - 1153",175,175,173,2,0,0.988571428571429
21-02-21,"62 - 1011",54,61,53,1,7,0.981481481481482
21-02-21,"3 - 1008",164,208,164,0,44,1
21-02-21,"16 - 1022",50,50,50,0,0,1
21-02-21,"24 - 1150",171,173,151,20,2,0.883040935672515
21-02-21,"24 - 1153",175,175,172,3,0,0.982857142857143
21-02-22,"62 - 1011",54,61,53,1,7,0.981481481481482
21-02-22,"3 - 1008",165,208,162,3,43,0.981818181818182
21-02-22,"16 - 1022",50,50,48,2,0,0.96
21-02-22,"24 - 1150",171,173,145,26,2,0.847953216374269
21-02-22,"24 - 1153",170,175,170,0,5,1
21-02-23,"62 - 1011",54,61,53,1,7,0.981481481481482
21-02-23,"3 - 1008",164,208,164,0,44,1
21-02-23,"16 - 1022",50,50,50,0,0,1
21-02-23,"24 - 1150",169,173,146,23,4,0.863905325443787
21-02-23,"24 - 1153",157,175,157,0,18,1
21-02-24,"62 - 1011",54,61,53,1,7,0.981481481481482
21-02-24,"3 - 1008",164,208,164,0,44,1
21-02-24,"16 - 1022",50,50,49,1,0,0.98
21-02-24,"24 - 1150",172,173,152,20,1,0.883720930232558
21-02-24,"24 - 1153",140,175,140,0,35,1
21-02-25,"62 - 1011",54,61,54,0,7,1
21-02-25,"3 - 1008",164,208,164,0,44,1
21-02-25,"16 - 1022",50,50,50,0,0,1
21-02-25,"24 - 1150",172,173,153,19,1,0.88953488372093
21-02-25,"24 - 1153",130,175,130,0,45,1
21-02-26,"62 - 1011",54,61,54,0,7,1
21-02-26,"3 - 1008",166,208,166,0,42,1
21-02-26,"16 - 1022",50,50,49,1,0,0.98
21-02-26,"24 - 1150",170,173,155,15,3,0.911764705882353
21-02-26,"24 - 1153",125,125,125,0,0,1
21-02-27,"62 - 1011",52,61,50,2,9,0.961538461538462
21-02-27,"3 - 1008",167,208,167,0,41,1
21-02-27,"16 - 1022",50,50,49,1,0,0.98
21-02-27,"24 - 1150",169,173,157,12,4,0.928994082840237
21-02-27,"24 - 1153",125,125,123,2,0,0.984
21-02-28,"62 - 1011",53,61,51,2,8,0.962264150943396
21-02-28,"3 - 1008",167,208,166,1,41,0.994011976047904
21-02-28,"16 - 1022",50,50,49,1,0,0.98
21-02-28,"24 - 1150",170,173,163,7,3,0.958823529411765
21-02-28,"24 - 1153",125,125,125,0,0,1
21-03-01,"62 - 1011",52,61,50,2,9,0.961538461538462
21-03-01,"3 - 1008",167,208,167,0,41,1
21-03-01,"16 - 1022",49,50,48,1,1,0.979591836734694
21-03-01,"24 - 1150",172,173,163,9,1,0.947674418604651
21-03-01,"24 - 1153",175,175,138,37,0,0.788571428571429
21-03-02,"62 - 1011",54,61,50,4,7,0.925925925925926
21-03-02,"3 - 1008",167,208,166,1,41,0.994011976047904
21-03-02,"16 - 1022",47,50,46,1,3,0.978723404255319
21-03-02,"24 - 1150",173,173,157,16,0,0.907514450867052
21-03-02,"24 - 1153",174,175,155,19,1,0.890804597701149
21-03-03,"62 - 1011",54,61,51,3,7,0.944444444444444
21-03-03,"3 - 1008",165,208,163,2,43,0.987878787878788
21-03-03,"16 - 1022",46,50,45,1,4,0.978260869565217
21-03-03,"24 - 1150",173,173,155,18,0,0.895953757225434
21-03-03,"24 - 1153",174,175,156,18,1,0.896551724137931
21-03-04,"62 - 1011",54,61,50,4,7,0.925925925925926
21-03-04,"3 - 1008",165,208,163,2,43,0.987878787878788
21-03-04,"16 - 1022",46,50,45,1,4,0.978260869565217
21-03-04,"24 - 1150",173,173,155,18,0,0.895953757225434
21-03-04,"24 - 1153",174,175,172,2,1,0.988505747126437
21-03-05,"62 - 1011",54,61,50,4,7,0.925925925925926
21-03-05,"3 - 1008",167,208,164,3,41,0.982035928143713
21-03-05,"16 - 1022",47,50,44,3,3,0.936170212765957
21-03-05,"24 - 1150",173,173,155,18,0,0.895953757225434
21-03-05,"24 - 1153",173,175,173,0,2,1
21-03-06,"62 - 1011",58,61,47,11,3,0.810344827586207
21-03-06,"3 - 1008",167,208,164,3,41,0.982035928143713
21-03-06,"16 - 1022",47,50,44,3,3,0.936170212765957
21-03-06,"24 - 1150",173,173,158,15,0,0.913294797687861
21-03-06,"24 - 1153",169,175,169,0,6,1
21-03-07,"62 - 1011",58,61,47,11,3,0.810344827586207
21-03-07,"3 - 1008",167,208,164,3,41,0.982035928143713
21-03-07,"16 - 1022",46,50,43,3,4,0.934782608695652
21-03-07,"24 - 1150",173,173,157,16,0,0.907514450867052
21-03-07,"24 - 1153",167,175,165,2,8,0.988023952095808
21-03-08,"62 - 1011",59,61,48,11,2,0.813559322033898
21-03-08,"3 - 1008",167,208,164,3,41,0.982035928143713
21-03-08,"16 - 1022",50,50,45,5,0,0.9
21-03-08,"24 - 1150",173,173,162,11,0,0.936416184971098
21-03-08,"24 - 1153",157,175,155,2,18,0.987261146496815
21-03-09,"62 - 1011",60,61,48,12,1,0.8
21-03-09,"3 - 1008",167,208,164,3,41,0.982035928143713
21-03-09,"16 - 1022",50,50,47,3,0,0.94
21-03-09,"24 - 1150",173,173,166,7,0,0.959537572254335
21-03-09,"24 - 1153",131,175,127,4,44,0.969465648854962
21-03-10,"62 - 1011",60,61,51,9,1,0.85
21-03-10,"3 - 1008",167,208,164,3,41,0.982035928143713
21-03-10,"16 - 1022",50,50,48,2,0,0.96
21-03-10,"24 - 1150",173,173,165,8,0,0.953757225433526
21-03-10,"24 - 1153",115,175,115,0,60,1
21-03-11,"62 - 1011",60,61,54,6,1,0.9
21-03-11,"3 - 1008",167,208,163,4,41,0.976047904191617
21-03-11,"16 - 1022",50,50,46,4,0,0.92
21-03-11,"24 - 1150",173,173,164,9,0,0.947976878612717
21-03-11,"24 - 1153",110,175,110,0,65,1
21-03-12,"62 - 1011",60,61,54,6,1,0.9
21-03-12,"3 - 1008",167,208,163,4,41,0.976047904191617
21-03-12,"16 - 1022",50,50,48,2,0,0.96
21-03-12,"24 - 1150",171,173,165,6,2,0.964912280701754
21-03-12,"24 - 1153",146,175,120,26,29,0.821917808219178
21-03-13,"62 - 1011",60,61,56,4,1,0.933333333333333
21-03-13,"3 - 1008",167,208,160,7,41,0.958083832335329
21-03-13,"16 - 1022",50,50,48,2,0,0.96
21-03-13,"24 - 1150",171,173,166,5,2,0.970760233918129
21-03-13,"24 - 1153",145,175,136,9,30,0.937931034482759
21-03-14,"62 - 1011",60,61,55,5,1,0.916666666666667
21-03-14,"3 - 1008",160,208,160,0,48,1
21-03-14,"16 - 1022",50,50,48,2,0,0.96
21-03-14,"24 - 1150",172,173,171,1,1,0.994186046511628
21-03-14,"24 - 1153",128,175,122,6,47,0.953125
21-03-15,"62 - 1011",60,61,54,6,1,0.9
21-03-15,"3 - 1008",160,208,160,0,48,1
21-03-15,"16 - 1022",50,50,50,0,0,1
21-03-15,"24 - 1150",162,173,162,0,11,1
21-03-15,"24 - 1153",126,175,125,1,49,0.992063492063492
21-03-16,"62 - 1011",60,61,56,4,1,0.933333333333333
21-03-16,"3 - 1008",160,208,160,0,48,1
21-03-16,"16 - 1022",50,50,47,3,0,0.94
21-03-16,"24 - 1150",157,173,157,0,16,1
21-03-16,"24 - 1153",114,175,114,0,61,1
21-03-17,"62 - 1011",60,61,58,2,1,0.966666666666667
21-03-17,"3 - 1008",160,208,158,2,48,0.9875
21-03-17,"16 - 1022",50,50,49,1,0,0.98
21-03-17,"24 - 1150",148,173,148,0,25,1
21-03-17,"24 - 1153",98,175,97,1,77,0.989795918367347
21-03-18,"62 - 1011",60,61,58,2,1,0.966666666666667
21-03-18,"3 - 1008",160,208,158,2,48,0.9875
21-03-18,"16 - 1022",50,50,46,4,0,0.92
21-03-18,"24 - 1150",145,173,145,0,28,1
21-03-18,"24 - 1153",84,175,84,0,91,1
21-03-19,"62 - 1011",60,61,59,1,1,0.983333333333333
21-03-19,"3 - 1008",159,208,157,2,49,0.987421383647799
21-03-19,"16 - 1022",50,50,47,3,0,0.94
21-03-19,"24 - 1150",135,173,135,0,38,1
21-03-19,"24 - 1153",77,175,77,0,98,1
21-03-20,"62 - 1011",60,61,59,1,1,0.983333333333333
21-03-20,"3 - 1008",158,208,156,2,50,0.987341772151899
21-03-20,"16 - 1022",50,50,46,4,0,0.92
21-03-20,"24 - 1150",125,173,125,0,48,1
21-03-20,"24 - 1153",75,175,72,3,100,0.96
21-03-21,"62 - 1011",60,61,60,0,1,1
21-03-21,"3 - 1008",158,208,157,1,50,0.993670886075949
21-03-21,"16 - 1022",50,50,46,4,0,0.92
21-03-21,"24 - 1150",121,173,121,0,52,1
21-03-21,"24 - 1153",70,175,70,0,105,1
21-03-22,"62 - 1011",60,61,60,0,1,1
21-03-22,"3 - 1008",157,208,156,1,51,0.993630573248408
21-03-22,"16 - 1022",50,50,46,4,0,0.92
21-03-22,"24 - 1150",115,173,115,0,58,1
21-03-22,"24 - 1153",66,175,66,0,109,1
21-03-23,"62 - 1011",60,61,59,1,1,0.983333333333333
21-03-23,"3 - 1008",156,208,155,1,52,0.993589743589744
21-03-23,"16 - 1022",50,50,46,4,0,0.92
21-03-23,"24 - 1150",110,173,110,0,63,1
21-03-23,"24 - 1153",67,125,67,0,58,1
21-03-24,"62 - 1011",60,61,59,1,1,0.983333333333333
21-03-24,"3 - 1008",157,208,155,2,51,0.987261146496815
21-03-24,"16 - 1022",49,50,47,2,1,0.959183673469388
21-03-24,"24 - 1150",106,173,106,0,67,1
21-03-24,"24 - 1153",76,125,76,0,49,1
21-03-25,"62 - 1011",60,61,58,2,1,0.966666666666667
21-03-25,"3 - 1008",158,208,155,3,50,0.981012658227848
21-03-25,"16 - 1022",49,50,46,3,1,0.938775510204082
21-03-25,"24 - 1150",92,173,92,0,81,1
21-03-25,"24 - 1153",83,175,80,3,92,0.963855421686747
21-03-26,"62 - 1011",60,61,60,0,1,1
21-03-26,"3 - 1008",159,208,156,3,49,0.981132075471698
21-03-26,"16 - 1022",49,50,48,1,1,0.979591836734694
21-03-26,"24 - 1150",89,173,89,0,84,1
21-03-26,"24 - 1153",78,175,78,0,97,1
21-03-27,"62 - 1011",60,61,60,0,1,1
21-03-27,"3 - 1008",159,208,156,3,49,0.981132075471698
21-03-27,"16 - 1022",49,50,49,0,1,1
21-03-27,"24 - 1150",88,173,88,0,85,1
21-03-27,"24 - 1153",87,175,86,1,88,0.988505747126437
21-03-28,"62 - 1011",60,61,59,1,1,0.983333333333333
21-03-28,"3 - 1008",159,208,156,3,49,0.981132075471698
21-03-28,"16 - 1022",49,50,49,0,1,1
21-03-28,"24 - 1150",87,173,87,0,86,1
21-03-28,"24 - 1153",92,175,92,0,83,1
21-03-29,"62 - 1011",60,61,59,1,1,0.983333333333333
21-03-29,"3 - 1008",168,208,165,3,40,0.982142857142857
21-03-29,"16 - 1022",49,50,48,1,1,0.979591836734694
21-03-29,"24 - 1150",87,173,87,0,86,1
21-03-29,"24 - 1153",91,175,91,0,84,1
21-03-30,"62 - 1011",60,61,59,1,1,0.983333333333333
21-03-30,"3 - 1008",171,208,168,3,37,0.982456140350877
21-03-30,"16 - 1022",50,50,47,3,0,0.94
21-03-30,"24 - 1150",85,173,85,0,88,1
21-03-30,"24 - 1153",95,175,95,0,80,1
21-03-31,"62 - 1011",60,61,60,0,1,1
21-03-31,"3 - 1008",174,208,169,5,34,0.971264367816092
21-03-31,"16 - 1022",50,50,49,1,0,0.98
21-03-31,"24 - 1150",81,173,81,0,92,1
21-03-31,"24 - 1153",93,175,92,1,82,0.989247311827957
21-04-01,"62 - 1011",60,61,59,1,1,0.983333333333333
21-04-01,"3 - 1008",180,208,179,1,28,0.994444444444444
21-04-01,"16 - 1022",50,50,48,2,0,0.96
21-04-01,"24 - 1150",80,173,80,0,93,1
21-04-01,"24 - 1153",86,175,86,0,89,1
21-04-02,"62 - 1011",60,61,59,1,1,0.983333333333333
21-04-02,"3 - 1008",184,208,179,5,24,0.972826086956522
21-04-02,"16 - 1022",50,50,48,2,0,0.96
21-04-02,"24 - 1150",80,173,80,0,93,1
21-04-02,"24 - 1153",87,175,87,0,88,1
21-04-03,"62 - 1011",60,61,59,1,1,0.983333333333333
21-04-03,"3 - 1008",187,208,185,2,21,0.989304812834225
21-04-03,"16 - 1022",50,50,47,3,0,0.94
21-04-03,"24 - 1150",80,173,80,0,93,1
21-04-03,"24 - 1153",84,125,84,0,41,1
21-04-04,"62 - 1011",60,61,59,1,1,0.983333333333333
21-04-04,"3 - 1008",186,208,183,3,22,0.983870967741935
21-04-04,"16 - 1022",50,50,48,2,0,0.96
21-04-04,"24 - 1150",84,173,84,0,89,1
21-04-04,"24 - 1153",84,125,84,0,41,1
21-04-05,"62 - 1011",60,61,59,1,1,0.983333333333333
21-04-05,"3 - 1008",186,208,182,4,22,0.978494623655914
21-04-05,"16 - 1022",50,50,46,4,0,0.92
21-04-05,"24 - 1150",86,173,86,0,87,1
21-04-05,"24 - 1153",84,125,84,0,41,1
21-04-06,"62 - 1011",59,61,56,3,2,0.949152542372881
21-04-06,"3 - 1008",185,186,174,11,1,0.940540540540541
21-04-06,"16 - 1022",50,50,46,4,0,0.92
21-04-06,"24 - 1150",84,173,84,0,89,1
21-04-06,"24 - 1153",82,125,82,0,43,1
21-04-07,"62 - 1011",60,61,57,3,1,0.95
21-04-07,"3 - 1008",183,186,168,15,3,0.918032786885246
21-04-07,"16 - 1022",50,50,47,3,0,0.94
21-04-07,"24 - 1150",77,173,77,0,96,1
21-04-07,"24 - 1153",83,125,83,0,42,1
21-04-08,"62 - 1011",60,61,60,0,1,1
21-04-08,"3 - 1008",183,186,165,18,3,0.901639344262295
21-04-08,"16 - 1022",49,50,49,0,1,1
21-04-08,"24 - 1150",72,173,72,0,101,1
21-04-08,"24 - 1153",83,125,83,0,42,1
21-04-09,"62 - 1011",60,61,59,1,1,0.983333333333333
21-04-09,"3 - 1008",166,186,165,1,20,0.993975903614458
21-04-09,"16 - 1022",47,50,47,0,3,1
21-04-09,"24 - 1150",72,173,72,0,101,1
21-04-09,"24 - 1153",83,125,83,0,42,1
21-04-10,"62 - 1011",60,61,59,1,1,0.983333333333333
21-04-10,"3 - 1008",166,186,165,1,20,0.993975903614458
21-04-10,"16 - 1022",46,50,46,0,4,1
21-04-10,"24 - 1150",75,173,75,0,98,1
21-04-10,"24 - 1153",82,125,82,0,43,1
21-04-11,"62 - 1011",60,61,58,2,1,0.966666666666667
21-04-11,"3 - 1008",166,186,164,2,20,0.987951807228916
21-04-11,"16 - 1022",46,50,45,1,4,0.978260869565217
21-04-11,"24 - 1150",76,173,76,0,97,1
21-04-11,"24 - 1153",82,125,82,0,43,1
21-04-12,"62 - 1011",60,61,58,2,1,0.966666666666667
21-04-12,"3 - 1008",164,186,163,1,22,0.99390243902439
21-04-12,"16 - 1022",44,50,43,1,6,0.977272727272727
21-04-12,"24 - 1150",74,173,74,0,99,1
21-04-12,"24 - 1153",82,125,80,2,43,0.975609756097561
21-04-13,"62 - 1011",60,61,59,1,1,0.983333333333333
21-04-13,"3 - 1008",164,186,163,1,22,0.99390243902439
21-04-13,"16 - 1022",42,50,40,2,8,0.952380952380952
21-04-13,"24 - 1150",71,173,71,0,102,1
21-04-13,"24 - 1153",80,125,80,0,45,1
21-04-14,"62 - 1011",60,61,59,1,1,0.983333333333333
21-04-14,"3 - 1008",163,186,161,2,23,0.987730061349693
21-04-14,"16 - 1022",40,50,39,1,10,0.975
21-04-14,"24 - 1150",73,173,73,0,100,1
21-04-14,"24 - 1153",80,125,79,1,45,0.9875
21-04-15,"62 - 1011",60,61,59,1,1,0.983333333333333
21-04-15,"3 - 1008",168,186,161,7,18,0.958333333333333
21-04-15,"16 - 1022",40,50,39,1,10,0.975
21-04-15,"24 - 1150",73,173,73,0,100,1
21-04-15,"24 - 1153",79,125,79,0,46,1
21-04-16,"62 - 1011",61,61,60,1,0,0.983606557377049
21-04-16,"3 - 1008",178,208,170,8,30,0.955056179775281
21-04-16,"16 - 1022",40,50,38,2,10,0.95
21-04-16,"24 - 1150",73,173,73,0,100,1
21-04-16,"24 - 1153",77,125,77,0,48,1
21-04-17,"62 - 1011",60,61,59,1,1,0.983333333333333
21-04-17,"3 - 1008",187,208,174,13,21,0.93048128342246
21-04-17,"16 - 1022",40,50,38,2,10,0.95
21-04-17,"24 - 1150",73,173,73,0,100,1
21-04-17,"24 - 1153",142,172,124,18,30,0.873239436619718
21-04-18,"62 - 1011",59,61,59,0,2,1
21-04-18,"3 - 1008",188,208,181,7,20,0.962765957446808
21-04-18,"16 - 1022",39,50,37,2,11,0.948717948717949
21-04-18,"24 - 1150",72,173,71,1,101,0.986111111111111
21-04-18,"24 - 1153",143,172,136,7,29,0.951048951048951
21-04-19,"62 - 1011",59,61,58,1,2,0.983050847457627
21-04-19,"3 - 1008",185,208,182,3,23,0.983783783783784
21-04-19,"16 - 1022",39,50,37,2,11,0.948717948717949
21-04-19,"24 - 1150",72,173,72,0,101,1
21-04-19,"24 - 1153",142,172,140,2,30,0.985915492957746
21-04-20,"62 - 1011",59,61,58,1,2,0.983050847457627
21-04-20,"3 - 1008",185,208,180,5,23,0.972972972972973
21-04-20,"16 - 1022",39,50,35,4,11,0.897435897435897
21-04-20,"24 - 1150",73,173,73,0,100,1
21-04-20,"24 - 1153",140,172,140,0,32,1
21-04-21,"62 - 1011",59,61,57,2,2,0.966101694915254
21-04-21,"3 - 1008",184,208,176,8,24,0.956521739130435
21-04-21,"16 - 1022",37,50,35,2,13,0.945945945945946
21-04-21,"24 - 1150",72,173,72,0,101,1
21-04-21,"24 - 1153",140,172,136,4,32,0.971428571428571
21-04-22,"62 - 1011",59,61,57,2,2,0.966101694915254
21-04-22,"3 - 1008",181,208,172,9,27,0.950276243093923
21-04-22,"16 - 1022",37,50,35,2,13,0.945945945945946
21-04-22,"24 - 1150",72,173,72,0,101,1
21-04-22,"24 - 1153",140,172,140,0,32,1
21-04-23,"62 - 1011",59,61,57,2,2,0.966101694915254
21-04-23,"3 - 1008",181,208,173,8,27,0.955801104972376
21-04-23,"16 - 1022",32,50,32,0,18,1
21-04-23,"24 - 1150",71,173,71,0,102,1
21-04-23,"24 - 1153",141,172,141,0,31,1
21-04-24,"62 - 1011",59,61,57,2,2,0.966101694915254
21-04-24,"3 - 1008",181,208,173,8,27,0.955801104972376
21-04-24,"16 - 1022",32,50,31,1,18,0.96875
21-04-24,"24 - 1150",73,173,73,0,100,1
21-04-24,"24 - 1153",139,172,139,0,33,1
21-04-25,"62 - 1011",59,61,57,2,2,0.966101694915254
21-04-25,"3 - 1008",181,208,173,8,27,0.955801104972376
21-04-25,"16 - 1022",32,50,32,0,18,1
21-04-25,"24 - 1150",73,173,73,0,100,1
21-04-25,"24 - 1153",139,172,137,2,33,0.985611510791367
21-04-26,"62 - 1011",59,61,56,3,2,0.949152542372881
21-04-26,"3 - 1008",177,208,169,8,31,0.954802259887006
21-04-26,"16 - 1022",34,50,33,1,16,0.970588235294118
21-04-26,"24 - 1150",74,173,74,0,99,1
21-04-26,"24 - 1153",139,172,139,0,33,1
21-04-27,"62 - 1011",59,61,55,4,2,0.932203389830508
21-04-27,"3 - 1008",167,208,167,0,41,1
21-04-27,"16 - 1022",34,50,33,1,16,0.970588235294118
21-04-27,"24 - 1150",73,173,73,0,100,1
21-04-27,"24 - 1153",139,172,138,1,33,0.992805755395683
21-04-28,"62 - 1011",59,61,55,4,2,0.932203389830508
21-04-28,"3 - 1008",166,208,166,0,42,1
21-04-28,"16 - 1022",33,50,32,1,17,0.96969696969697
21-04-28,"24 - 1150",74,173,74,0,99,1
21-04-28,"24 - 1153",137,172,136,1,35,0.992700729927007
21-04-29,"62 - 1011",59,61,53,6,2,0.898305084745763
21-04-29,"3 - 1008",162,208,161,1,46,0.993827160493827
21-04-29,"16 - 1022",31,50,31,0,19,1
21-04-29,"24 - 1150",146,173,97,49,27,0.664383561643836
21-04-29,"24 - 1153",139,172,139,0,33,1
21-04-30,"62 - 1011",59,61,53,6,2,0.898305084745763
21-04-30,"3 - 1008",166,208,157,9,42,0.94578313253012
21-04-30,"16 - 1022",31,50,31,0,19,1
21-04-30,"24 - 1150",167,173,113,54,6,0.676646706586826
21-04-30,"24 - 1153",139,172,138,1,33,0.992805755395683
21-05-01,"62 - 1011",59,61,52,7,2,0.88135593220339
21-05-01,"3 - 1008",165,208,157,8,43,0.951515151515152
21-05-01,"16 - 1022",29,50,29,0,21,1
21-05-01,"24 - 1150",169,173,123,46,4,0.727810650887574
21-05-01,"24 - 1153",139,172,138,1,33,0.992805755395683
21-05-02,"62 - 1011",59,61,51,8,2,0.864406779661017
21-05-02,"3 - 1008",165,208,155,10,43,0.939393939393939
21-05-02,"16 - 1022",29,50,29,0,21,1
21-05-02,"24 - 1150",170,173,131,39,3,0.770588235294118
21-05-02,"24 - 1153",139,172,137,2,33,0.985611510791367
21-05-03,"62 - 1011",59,61,51,8,2,0.864406779661017
21-05-03,"3 - 1008",158,208,154,4,50,0.974683544303797
21-05-03,"16 - 1022",29,50,28,1,21,0.96551724137931
21-05-03,"24 - 1150",171,173,133,38,2,0.777777777777778
21-05-03,"24 - 1153",140,172,137,3,32,0.978571428571429
21-05-04,"62 - 1011",59,61,52,7,2,0.88135593220339
21-05-04,"3 - 1008",158,208,152,6,50,0.962025316455696
21-05-04,"16 - 1022",29,50,28,1,21,0.96551724137931
21-05-04,"24 - 1150",132,173,132,0,41,1
21-05-04,"24 - 1153",140,172,140,0,32,1
21-05-05,"62 - 1011",59,61,51,8,2,0.864406779661017
21-05-05,"3 - 1008",158,208,152,6,50,0.962025316455696
21-05-05,"16 - 1022",30,50,29,1,20,0.966666666666667
21-05-05,"24 - 1150",126,173,126,0,47,1
21-05-05,"24 - 1153",140,172,140,0,32,1
21-05-06,"62 - 1011",59,61,53,6,2,0.898305084745763
21-05-06,"3 - 1008",167,201,150,17,34,0.898203592814371
21-05-06,"16 - 1022",29,50,26,3,21,0.896551724137931
21-05-06,"24 - 1150",121,173,121,0,52,1
21-05-06,"24 - 1153",140,172,140,0,32,1
21-05-07,"62 - 1011",59,61,54,5,2,0.915254237288136
21-05-07,"3 - 1008",168,201,157,11,33,0.93452380952381
21-05-07,"16 - 1022",50,50,44,6,0,0.88
21-05-07,"24 - 1150",112,173,112,0,61,1
21-05-07,"24 - 1153",141,172,141,0,31,1
21-05-08,"62 - 1011",59,61,53,6,2,0.898305084745763
21-05-08,"3 - 1008",169,201,161,8,32,0.952662721893491
21-05-08,"16 - 1022",50,50,44,6,0,0.88
21-05-08,"24 - 1150",112,173,111,1,61,0.991071428571429
21-05-08,"24 - 1153",141,172,140,1,31,0.99290780141844
21-05-09,"62 - 1011",59,61,54,5,2,0.915254237288136
21-05-09,"3 - 1008",169,201,159,10,32,0.940828402366864
21-05-09,"16 - 1022",50,50,43,7,0,0.86
21-05-09,"24 - 1150",171,173,121,50,2,0.707602339181287
21-05-09,"24 - 1153",140,172,137,3,32,0.978571428571429
21-05-10,"62 - 1011",59,61,55,4,2,0.932203389830508
21-05-10,"3 - 1008",166,201,159,7,35,0.957831325301205
21-05-10,"16 - 1022",49,50,45,4,1,0.918367346938776
21-05-10,"24 - 1150",173,173,131,42,0,0.757225433526012
21-05-10,"24 - 1153",124,125,123,1,1,0.991935483870968
21-05-11,"62 - 1011",59,61,55,4,2,0.932203389830508
21-05-11,"3 - 1008",168,201,159,9,33,0.946428571428571
21-05-11,"16 - 1022",50,50,40,10,0,0.8
21-05-11,"24 - 1150",173,173,130,43,0,0.751445086705202
21-05-11,"24 - 1153",124,125,122,2,1,0.983870967741935
21-05-12,"62 - 1011",59,61,55,4,2,0.932203389830508
21-05-12,"3 - 1008",168,201,158,10,33,0.94047619047619
21-05-12,"16 - 1022",50,50,46,4,0,0.92
21-05-12,"24 - 1150",173,173,135,38,0,0.780346820809249
21-05-12,"24 - 1153",124,125,124,0,1,1
21-05-13,"62 - 1011",59,61,55,4,2,0.932203389830508
21-05-13,"3 - 1008",168,201,157,11,33,0.93452380952381
21-05-13,"16 - 1022",50,50,44,6,0,0.88
21-05-13,"24 - 1150",173,173,136,37,0,0.786127167630058
21-05-13,"24 - 1153",124,125,120,4,1,0.967741935483871
21-05-14,"62 - 1011",59,61,56,3,2,0.949152542372881
21-05-14,"3 - 1008",168,201,158,10,33,0.94047619047619
21-05-14,"16 - 1022",50,50,46,4,0,0.92
21-05-14,"24 - 1150",172,173,128,44,1,0.744186046511628
21-05-14,"24 - 1153",124,125,117,7,1,0.943548387096774
21-05-15,"62 - 1011",60,61,58,2,1,0.966666666666667
21-05-15,"3 - 1008",168,201,157,11,33,0.93452380952381
21-05-15,"16 - 1022",50,50,45,5,0,0.9
21-05-15,"24 - 1150",173,173,130,43,0,0.751445086705202
21-05-15,"24 - 1153",124,125,118,6,1,0.951612903225806
21-05-16,"62 - 1011",60,61,59,1,1,0.983333333333333
21-05-16,"3 - 1008",167,201,161,6,34,0.964071856287425
21-05-16,"16 - 1022",50,50,45,5,0,0.9
21-05-16,"24 - 1150",173,173,137,36,0,0.791907514450867
21-05-16,"24 - 1153",120,125,119,1,5,0.991666666666667
21-05-17,"62 - 1011",60,61,59,1,1,0.983333333333333
21-05-17,"3 - 1008",168,201,160,8,33,0.952380952380952
21-05-17,"16 - 1022",50,50,45,5,0,0.9
21-05-17,"24 - 1150",173,173,134,39,0,0.774566473988439
21-05-17,"24 - 1153",116,125,116,0,9,1
21-05-18,"62 - 1011",60,61,59,1,1,0.983333333333333
21-05-18,"3 - 1008",168,201,157,11,33,0.93452380952381
21-05-18,"16 - 1022",50,50,45,5,0,0.9
21-05-18,"24 - 1150",173,173,140,33,0,0.809248554913295
21-05-18,"24 - 1153",111,125,111,0,14,1
21-05-19,"62 - 1011",60,61,59,1,1,0.983333333333333
21-05-19,"3 - 1008",167,201,156,11,34,0.934131736526946
21-05-19,"16 - 1022",50,50,45,5,0,0.9
21-05-19,"24 - 1150",173,173,134,39,0,0.774566473988439
21-05-19,"24 - 1153",110,125,110,0,15,1
21-05-20,"62 - 1011",60,61,59,1,1,0.983333333333333
21-05-20,"3 - 1008",165,201,155,10,36,0.939393939393939
21-05-20,"16 - 1022",50,50,44,6,0,0.88
21-05-20,"24 - 1150",173,173,141,32,0,0.815028901734104
21-05-20,"24 - 1153",108,125,108,0,17,1
21-05-21,"62 - 1011",60,61,57,3,1,0.95
21-05-21,"3 - 1008",166,201,155,11,35,0.933734939759036
21-05-21,"16 - 1022",50,50,41,9,0,0.82
21-05-21,"24 - 1150",173,173,137,36,0,0.791907514450867
21-05-21,"24 - 1153",106,125,106,0,19,1
21-05-22,"62 - 1011",60,61,57,3,1,0.95
21-05-22,"3 - 1008",166,201,155,11,35,0.933734939759036
21-05-22,"16 - 1022",50,50,43,7,0,0.86
21-05-22,"24 - 1150",173,173,140,33,0,0.809248554913295
21-05-22,"24 - 1153",105,125,105,0,20,1
21-05-23,"62 - 1011",60,61,57,3,1,0.95
21-05-23,"3 - 1008",165,201,155,10,36,0.939393939393939
21-05-23,"16 - 1022",50,50,43,7,0,0.86
21-05-23,"24 - 1150",173,173,142,31,0,0.820809248554913
21-05-23,"24 - 1153",103,125,103,0,22,1
21-05-24,"62 - 1011",60,61,57,3,1,0.95
21-05-24,"3 - 1008",165,201,155,10,36,0.939393939393939
21-05-24,"16 - 1022",50,50,41,9,0,0.82
21-05-24,"24 - 1150",173,173,145,28,0,0.838150289017341
21-05-24,"24 - 1153",102,125,102,0,23,1
21-05-25,"62 - 1011",60,61,57,3,1,0.95
21-05-25,"3 - 1008",165,201,155,10,36,0.939393939393939
21-05-25,"16 - 1022",50,50,43,7,0,0.86
21-05-25,"24 - 1150",173,173,145,28,0,0.838150289017341
21-05-25,"24 - 1153",125,125,109,16,0,0.872
21-05-26,"62 - 1011",60,61,57,3,1,0.95
21-05-26,"3 - 1008",165,201,155,10,36,0.939393939393939
21-05-26,"16 - 1022",50,50,49,1,0,0.98
21-05-26,"24 - 1150",173,173,147,26,0,0.84971098265896
21-05-26,"24 - 1153",125,125,112,13,0,0.896
21-05-27,"62 - 1011",60,61,57,3,1,0.95
21-05-27,"3 - 1008",169,201,158,11,32,0.93491124260355
21-05-27,"16 - 1022",50,50,49,1,0,0.98
21-05-27,"24 - 1150",172,173,143,29,1,0.831395348837209
21-05-27,"24 - 1153",125,125,115,10,0,0.92
21-05-28,"62 - 1011",60,61,58,2,1,0.966666666666667
21-05-28,"3 - 1008",171,201,161,10,30,0.941520467836257
21-05-28,"16 - 1022",50,50,49,1,0,0.98
21-05-28,"24 - 1150",172,173,144,28,1,0.837209302325581
21-05-28,"24 - 1153",125,125,124,1,0,0.992
21-05-29,"62 - 1011",60,61,58,2,1,0.966666666666667
21-05-29,"3 - 1008",171,201,161,10,30,0.941520467836257
21-05-29,"16 - 1022",50,50,48,2,0,0.96
21-05-29,"24 - 1150",172,173,145,27,1,0.843023255813954
21-05-29,"24 - 1153",125,125,122,3,0,0.976
21-05-30,"62 - 1011",60,61,57,3,1,0.95
21-05-30,"3 - 1008",172,201,163,9,29,0.947674418604651
21-05-30,"16 - 1022",47,50,45,2,3,0.957446808510638
21-05-30,"24 - 1150",173,173,140,33,0,0.809248554913295
21-05-30,"24 - 1153",125,125,123,2,0,0.984
21-05-31,"62 - 1011",60,61,58,2,1,0.966666666666667
21-05-31,"3 - 1008",171,201,164,7,30,0.95906432748538
21-05-31,"16 - 1022",47,50,41,6,3,0.872340425531915
21-05-31,"24 - 1150",173,173,143,30,0,0.826589595375723
21-05-31,"24 - 1153",125,125,121,4,0,0.968
21-06-01,"62 - 1011",60,61,58,2,1,0.966666666666667
21-06-01,"3 - 1008",171,201,165,6,30,0.964912280701754
21-06-01,"16 - 1022",45,50,35,10,5,0.777777777777778
21-06-01,"24 - 1150",173,173,142,31,0,0.820809248554913
21-06-01,"24 - 1153",125,125,123,2,0,0.984
21-06-02,"62 - 1011",60,61,58,2,1,0.966666666666667
21-06-02,"3 - 1008",170,201,165,5,31,0.970588235294118
21-06-02,"16 - 1022",40,50,34,6,10,0.85
21-06-02,"24 - 1150",173,173,140,33,0,0.809248554913295
21-06-02,"24 - 1153",125,125,121,4,0,0.968
21-06-03,"62 - 1011",60,61,57,3,1,0.95
21-06-03,"3 - 1008",169,201,158,11,32,0.93491124260355
21-06-03,"16 - 1022",38,50,32,6,12,0.842105263157895
21-06-03,"24 - 1150",173,173,139,34,0,0.803468208092486
21-06-03,"24 - 1153",125,125,121,4,0,0.968
21-06-04,"62 - 1011",60,61,56,4,1,0.933333333333333
21-06-04,"3 - 1008",171,201,163,8,30,0.953216374269006
21-06-04,"16 - 1022",39,50,31,8,11,0.794871794871795
21-06-04,"24 - 1150",173,173,135,38,0,0.780346820809249
21-06-04,"24 - 1153",125,125,124,1,0,0.992
21-06-05,"62 - 1011",60,61,55,5,1,0.916666666666667
21-06-05,"3 - 1008",171,201,166,5,30,0.970760233918129
21-06-05,"16 - 1022",39,50,28,11,11,0.717948717948718
21-06-05,"24 - 1150",173,173,140,33,0,0.809248554913295
21-06-05,"24 - 1153",125,125,118,7,0,0.944
21-06-06,"62 - 1011",60,61,55,5,1,0.916666666666667
21-06-06,"3 - 1008",171,201,166,5,30,0.970760233918129
21-06-06,"16 - 1022",34,50,24,10,16,0.705882352941177
21-06-06,"24 - 1150",173,173,145,28,0,0.838150289017341
21-06-06,"24 - 1153",125,125,120,5,0,0.96
21-06-07,"62 - 1011",60,61,54,6,1,0.9
21-06-07,"3 - 1008",173,201,167,6,28,0.965317919075145
21-06-07,"16 - 1022",34,50,23,11,16,0.676470588235294
21-06-07,"24 - 1150",173,173,148,25,0,0.855491329479769
21-06-07,"24 - 1153",125,125,120,5,0,0.96
21-06-08,"62 - 1011",60,61,55,5,1,0.916666666666667
21-06-08,"3 - 1008",173,201,168,5,28,0.971098265895954
21-06-08,"16 - 1022",30,50,22,8,20,0.733333333333333
21-06-08,"24 - 1150",173,173,153,20,0,0.884393063583815
21-06-08,"24 - 1153",125,135,117,8,10,0.936
21-06-09,"62 - 1011",60,61,56,4,1,0.933333333333333
21-06-09,"3 - 1008",168,201,163,5,33,0.970238095238095
21-06-09,"16 - 1022",31,50,22,9,19,0.709677419354839
21-06-09,"24 - 1150",173,173,157,16,0,0.907514450867052
21-06-09,"24 - 1153",125,135,119,6,10,0.952
21-06-10,"62 - 1011",60,61,55,5,1,0.916666666666667
21-06-10,"3 - 1008",171,201,162,9,30,0.947368421052632
21-06-10,"16 - 1022",31,50,22,9,19,0.709677419354839
21-06-10,"24 - 1150",172,173,156,16,1,0.906976744186046
21-06-10,"24 - 1153",125,135,123,2,10,0.984
21-06-11,"62 - 1011",60,61,56,4,1,0.933333333333333
21-06-11,"3 - 1008",171,201,164,7,30,0.95906432748538
21-06-11,"16 - 1022",31,50,23,8,19,0.741935483870968
21-06-11,"24 - 1150",172,173,154,18,1,0.895348837209302
21-06-11,"24 - 1153",125,135,124,1,10,0.992
21-06-12,"62 - 1011",60,61,57,3,1,0.95
21-06-12,"3 - 1008",171,201,161,10,30,0.941520467836257
21-06-12,"16 - 1022",31,50,23,8,19,0.741935483870968
21-06-12,"24 - 1150",172,173,159,13,1,0.924418604651163
21-06-12,"24 - 1153",125,135,123,2,10,0.984
21-06-13,"62 - 1011",60,61,58,2,1,0.966666666666667
21-06-13,"3 - 1008",171,201,162,9,30,0.947368421052632
21-06-13,"16 - 1022",30,50,22,8,20,0.733333333333333
21-06-13,"24 - 1150",172,173,159,13,1,0.924418604651163
21-06-13,"24 - 1153",125,135,124,1,10,0.992
21-06-14,"62 - 1011",60,61,59,1,1,0.983333333333333
21-06-14,"3 - 1008",171,201,162,9,30,0.947368421052632
21-06-14,"16 - 1022",41,50,30,11,9,0.731707317073171
21-06-14,"24 - 1150",169,173,153,16,4,0.905325443786982
21-06-14,"24 - 1153",125,135,124,1,10,0.992
21-06-15,"62 - 1011",60,61,60,0,1,1
21-06-15,"3 - 1008",171,201,161,10,30,0.941520467836257
21-06-15,"16 - 1022",42,50,37,5,8,0.880952380952381
21-06-15,"24 - 1150",168,173,154,14,5,0.916666666666667
21-06-15,"24 - 1153",125,135,123,2,10,0.984
21-06-16,"62 - 1011",60,61,60,0,1,1
21-06-16,"3 - 1008",174,201,159,15,27,0.913793103448276
21-06-16,"16 - 1022",38,50,35,3,12,0.921052631578947
21-06-16,"24 - 1150",165,173,150,15,8,0.909090909090909
21-06-16,"24 - 1153",125,135,124,1,10,0.992
21-06-17,"62 - 1011",60,61,59,1,1,0.983333333333333
21-06-17,"3 - 1008",175,201,159,16,26,0.908571428571429
21-06-17,"16 - 1022",46,50,42,4,4,0.91304347826087
21-06-17,"24 - 1150",170,173,151,19,3,0.888235294117647
21-06-17,"24 - 1153",125,135,117,8,10,0.936
21-06-18,"62 - 1011",60,61,60,0,1,1
21-06-18,"3 - 1008",175,201,163,12,26,0.931428571428571
21-06-18,"16 - 1022",50,50,47,3,0,0.94
21-06-18,"24 - 1150",170,173,151,19,3,0.888235294117647
21-06-18,"24 - 1153",125,135,112,13,10,0.896
21-06-19,"62 - 1011",60,61,59,1,1,0.983333333333333
21-06-19,"3 - 1008",175,201,163,12,26,0.931428571428571
21-06-19,"16 - 1022",50,50,50,0,0,1
21-06-19,"24 - 1150",170,173,148,22,3,0.870588235294118
21-06-19,"24 - 1153",125,135,117,8,10,0.936
21-06-20,"62 - 1011",60,61,59,1,1,0.983333333333333
21-06-20,"3 - 1008",175,201,166,9,26,0.948571428571429
21-06-20,"16 - 1022",50,50,50,0,0,1
21-06-20,"24 - 1150",169,173,145,24,4,0.857988165680473
21-06-20,"24 - 1153",125,135,115,10,10,0.92
21-06-21,"62 - 1011",60,61,60,0,1,1
21-06-21,"3 - 1008",174,201,163,11,27,0.936781609195402
21-06-21,"16 - 1022",50,50,49,1,0,0.98
21-06-21,"24 - 1150",170,173,140,30,3,0.823529411764706
21-06-21,"24 - 1153",125,135,116,9,10,0.928
21-06-22,"62 - 1011",60,61,60,0,1,1
21-06-22,"3 - 1008",177,201,164,13,24,0.926553672316384
21-06-22,"16 - 1022",50,50,49,1,0,0.98
21-06-22,"24 - 1150",170,173,142,28,3,0.835294117647059
21-06-22,"24 - 1153",125,135,117,8,10,0.936
21-06-23,"62 - 1011",60,61,59,1,1,0.983333333333333
21-06-23,"3 - 1008",177,201,164,13,24,0.926553672316384
21-06-23,"16 - 1022",50,50,49,1,0,0.98
21-06-23,"24 - 1150",170,173,146,24,3,0.858823529411765
21-06-23,"24 - 1153",125,135,114,11,10,0.912
21-06-24,"62 - 1011",60,61,60,0,1,1
21-06-24,"3 - 1008",176,201,164,12,25,0.931818181818182
21-06-24,"16 - 1022",50,50,47,3,0,0.94
21-06-24,"24 - 1150",170,173,148,22,3,0.870588235294118
21-06-24,"24 - 1153",125,135,114,11,10,0.912
21-06-25,"62 - 1011",60,61,60,0,1,1
21-06-25,"3 - 1008",175,201,164,11,26,0.937142857142857
21-06-25,"16 - 1022",50,50,49,1,0,0.98
21-06-25,"24 - 1150",170,173,145,25,3,0.852941176470588
21-06-25,"24 - 1153",125,135,116,9,10,0.928
21-06-26,"62 - 1011",60,61,59,1,1,0.983333333333333
21-06-26,"3 - 1008",175,201,163,12,26,0.931428571428571
21-06-26,"16 - 1022",50,50,47,3,0,0.94
21-06-26,"24 - 1150",170,173,149,21,3,0.876470588235294
21-06-26,"24 - 1153",125,135,115,10,10,0.92
21-06-27,"62 - 1011",60,61,58,2,1,0.966666666666667
21-06-27,"3 - 1008",174,201,165,9,27,0.948275862068966
21-06-27,"16 - 1022",50,50,46,4,0,0.92
21-06-27,"24 - 1150",170,173,154,16,3,0.905882352941176
21-06-27,"24 - 1153",125,135,117,8,10,0.936
21-06-28,"62 - 1011",60,61,58,2,1,0.966666666666667
21-06-28,"3 - 1008",178,201,162,16,23,0.910112359550562
21-06-28,"16 - 1022",50,50,48,2,0,0.96
21-06-28,"24 - 1150",170,173,153,17,3,0.9
21-06-28,"24 - 1153",125,135,115,10,10,0.92
21-06-29,"62 - 1011",60,61,53,7,1,0.883333333333333
21-06-29,"3 - 1008",175,201,161,14,26,0.92
21-06-29,"16 - 1022",50,50,48,2,0,0.96
21-06-29,"24 - 1150",170,173,153,17,3,0.9
21-06-29,"24 - 1153",124,135,112,12,11,0.903225806451613
21-06-30,"62 - 1011",60,61,53,7,1,0.883333333333333
21-06-30,"3 - 1008",176,201,163,13,25,0.926136363636364
21-06-30,"16 - 1022",50,50,45,5,0,0.9
21-06-30,"24 - 1150",170,173,153,17,3,0.9
21-06-30,"24 - 1153",124,135,115,9,11,0.92741935483871
21-07-01,"62 - 1011",60,61,57,3,1,0.95
21-07-01,"3 - 1008",176,201,165,11,25,0.9375
21-07-01,"16 - 1022",50,50,44,6,0,0.88
21-07-01,"24 - 1150",170,173,157,13,3,0.923529411764706
21-07-01,"24 - 1153",124,135,116,8,11,0.935483870967742
21-07-02,"62 - 1011",60,61,55,5,1,0.916666666666667
21-07-02,"3 - 1008",178,201,165,13,23,0.926966292134832
21-07-02,"16 - 1022",50,50,46,4,0,0.92
21-07-02,"24 - 1150",170,173,151,19,3,0.888235294117647
21-07-02,"24 - 1153",124,135,118,6,11,0.951612903225806
21-07-03,"62 - 1011",60,61,55,5,1,0.916666666666667
21-07-03,"3 - 1008",180,201,167,13,21,0.927777777777778
21-07-03,"16 - 1022",50,50,45,5,0,0.9
21-07-03,"24 - 1150",170,173,163,7,3,0.958823529411765
21-07-03,"24 - 1153",124,135,118,6,11,0.951612903225806
21-07-04,"62 - 1011",60,61,55,5,1,0.916666666666667
21-07-04,"3 - 1008",179,201,168,11,22,0.93854748603352
21-07-04,"16 - 1022",50,50,44,6,0,0.88
21-07-04,"24 - 1150",170,173,157,13,3,0.923529411764706
21-07-04,"24 - 1153",124,135,119,5,11,0.959677419354839
21-07-05,"62 - 1011",60,61,56,4,1,0.933333333333333
21-07-05,"3 - 1008",179,201,167,12,22,0.932960893854749
21-07-05,"16 - 1022",50,50,39,11,0,0.78
21-07-05,"24 - 1150",170,173,144,26,3,0.847058823529412
21-07-05,"24 - 1153",124,135,122,2,11,0.983870967741935
21-07-06,"62 - 1011",60,61,56,4,1,0.933333333333333
21-07-06,"3 - 1008",182,201,171,11,19,0.93956043956044
21-07-06,"16 - 1022",50,50,45,5,0,0.9
21-07-06,"24 - 1150",170,173,140,30,3,0.823529411764706
21-07-06,"24 - 1153",124,135,122,2,11,0.983870967741935
21-07-07,"62 - 1011",60,61,55,5,1,0.916666666666667
21-07-07,"3 - 1008",185,201,171,14,16,0.924324324324324
21-07-07,"16 - 1022",50,50,46,4,0,0.92
21-07-07,"24 - 1150",170,173,145,25,3,0.852941176470588
21-07-07,"24 - 1153",124,135,123,1,11,0.991935483870968
21-07-08,"62 - 1011",60,61,55,5,1,0.916666666666667
21-07-08,"3 - 1008",184,201,175,9,17,0.951086956521739
21-07-08,"16 - 1022",50,50,46,4,0,0.92
21-07-08,"24 - 1150",170,173,148,22,3,0.870588235294118
21-07-08,"24 - 1153",125,135,122,3,10,0.976
21-07-09,"62 - 1011",60,61,56,4,1,0.933333333333333
21-07-09,"3 - 1008",185,201,176,9,16,0.951351351351351
21-07-09,"16 - 1022",50,50,45,5,0,0.9
21-07-09,"24 - 1150",170,173,146,24,3,0.858823529411765
21-07-09,"24 - 1153",125,135,120,5,10,0.96
21-07-10,"62 - 1011",60,61,56,4,1,0.933333333333333
21-07-10,"3 - 1008",185,201,176,9,16,0.951351351351351
21-07-10,"16 - 1022",50,50,45,5,0,0.9
21-07-10,"24 - 1150",170,173,145,25,3,0.852941176470588
21-07-10,"24 - 1153",125,135,122,3,10,0.976
21-07-11,"62 - 1011",60,61,56,4,1,0.933333333333333
21-07-11,"3 - 1008",184,201,174,10,17,0.945652173913043
21-07-11,"16 - 1022",50,50,43,7,0,0.86
21-07-11,"24 - 1150",170,173,145,25,3,0.852941176470588
21-07-11,"24 - 1153",125,135,120,5,10,0.96
21-07-12,"62 - 1011",60,61,56,4,1,0.933333333333333
21-07-12,"3 - 1008",183,201,175,8,18,0.956284153005464
21-07-12,"16 - 1022",50,50,45,5,0,0.9
21-07-12,"24 - 1150",170,173,148,22,3,0.870588235294118
21-07-12,"24 - 1153",125,135,123,2,10,0.984
21-07-13,"62 - 1011",60,61,56,4,1,0.933333333333333
21-07-13,"3 - 1008",190,201,174,16,11,0.91578947368421
21-07-13,"16 - 1022",50,50,47,3,0,0.94
21-07-13,"24 - 1150",168,173,146,22,5,0.869047619047619
21-07-13,"24 - 1153",125,135,124,1,10,0.992
21-07-14,"62 - 1011",60,61,56,4,1,0.933333333333333
21-07-14,"3 - 1008",190,201,177,13,11,0.931578947368421
21-07-14,"16 - 1022",50,50,47,3,0,0.94
21-07-14,"24 - 1150",163,173,140,23,10,0.858895705521472
21-07-14,"24 - 1153",125,135,123,2,10,0.984
21-07-15,"62 - 1011",60,61,57,3,1,0.95
21-07-15,"3 - 1008",190,201,179,11,11,0.942105263157895
21-07-15,"16 - 1022",50,50,44,6,0,0.88
21-07-15,"24 - 1150",164,173,133,31,9,0.810975609756098
21-07-15,"24 - 1153",125,135,125,0,10,1
21-07-16,"62 - 1011",60,61,56,4,1,0.933333333333333
21-07-16,"3 - 1008",190,201,178,12,11,0.936842105263158
21-07-16,"16 - 1022",50,50,43,7,0,0.86
21-07-16,"24 - 1150",162,173,132,30,11,0.814814814814815
21-07-16,"24 - 1153",125,135,123,2,10,0.984
21-07-17,"62 - 1011",60,61,56,4,1,0.933333333333333
21-07-17,"3 - 1008",190,201,178,12,11,0.936842105263158
21-07-17,"16 - 1022",50,50,45,5,0,0.9
21-07-17,"24 - 1150",160,173,129,31,13,0.80625
21-07-17,"24 - 1153",125,135,125,0,10,1
21-07-18,"62 - 1011",60,61,57,3,1,0.95
21-07-18,"3 - 1008",190,201,179,11,11,0.942105263157895
21-07-18,"16 - 1022",50,50,42,8,0,0.84
21-07-18,"24 - 1150",159,173,134,25,14,0.842767295597484
21-07-18,"24 - 1153",125,135,125,0,10,1
21-07-19,"62 - 1011",60,61,58,2,1,0.966666666666667
21-07-19,"3 - 1008",190,201,178,12,11,0.936842105263158
21-07-19,"16 - 1022",50,50,49,1,0,0.98
21-07-19,"24 - 1150",156,173,129,27,17,0.826923076923077
21-07-19,"24 - 1153",125,135,122,3,10,0.976
21-07-20,"62 - 1011",60,61,58,2,1,0.966666666666667
21-07-20,"3 - 1008",190,201,170,20,11,0.894736842105263
21-07-20,"16 - 1022",50,50,49,1,0,0.98
21-07-20,"24 - 1150",153,173,127,26,20,0.830065359477124
21-07-20,"24 - 1153",125,135,125,0,10,1
21-07-21,"62 - 1011",60,61,59,1,1,0.983333333333333
21-07-21,"3 - 1008",190,201,175,15,11,0.921052631578947
21-07-21,"16 - 1022",50,50,50,0,0,1
21-07-21,"24 - 1150",148,173,121,27,25,0.817567567567568
21-07-21,"24 - 1153",125,135,125,0,10,1
21-07-22,"62 - 1011",60,61,59,1,1,0.983333333333333
21-07-22,"3 - 1008",190,201,176,14,11,0.926315789473684
21-07-22,"16 - 1022",50,50,50,0,0,1
21-07-22,"24 - 1150",147,173,124,23,26,0.843537414965986
21-07-22,"24 - 1153",125,135,124,1,10,0.992
21-07-23,"62 - 1011",60,61,59,1,1,0.983333333333333
21-07-23,"3 - 1008",195,201,175,20,6,0.897435897435897
21-07-23,"16 - 1022",50,50,50,0,0,1
21-07-23,"24 - 1150",145,173,121,24,28,0.83448275862069
21-07-23,"24 - 1153",125,135,124,1,10,0.992
21-07-24,"62 - 1011",60,61,59,1,1,0.983333333333333
21-07-24,"3 - 1008",195,201,176,19,6,0.902564102564103
21-07-24,"16 - 1022",50,50,50,0,0,1
21-07-24,"24 - 1150",145,173,122,23,28,0.841379310344828
21-07-24,"24 - 1153",125,135,125,0,10,1
21-07-25,"62 - 1011",60,61,57,3,1,0.95
21-07-25,"3 - 1008",195,201,174,21,6,0.892307692307692
21-07-25,"16 - 1022",50,50,50,0,0,1
21-07-25,"24 - 1150",144,173,129,15,29,0.895833333333333
21-07-25,"24 - 1153",125,135,125,0,10,1
21-07-26,"62 - 1011",60,61,57,3,1,0.95
21-07-26,"3 - 1008",195,201,171,24,6,0.876923076923077
21-07-26,"16 - 1022",50,50,46,4,0,0.92
21-07-26,"24 - 1150",137,173,119,18,36,0.868613138686131
21-07-26,"24 - 1153",125,135,123,2,10,0.984
21-07-27,"62 - 1011",60,61,58,2,1,0.966666666666667
21-07-27,"3 - 1008",195,201,175,20,6,0.897435897435897
21-07-27,"16 - 1022",50,50,48,2,0,0.96
21-07-27,"24 - 1150",137,173,117,20,36,0.854014598540146
21-07-27,"24 - 1153",125,135,121,4,10,0.968
21-07-28,"62 - 1011",60,61,59,1,1,0.983333333333333
21-07-28,"3 - 1008",195,201,173,22,6,0.887179487179487
21-07-28,"16 - 1022",50,50,48,2,0,0.96
21-07-28,"24 - 1150",137,173,113,24,36,0.824817518248175
21-07-28,"24 - 1153",125,135,121,4,10,0.968
21-07-29,"62 - 1011",60,61,59,1,1,0.983333333333333
21-07-29,"3 - 1008",194,201,175,19,7,0.902061855670103
21-07-29,"16 - 1022",50,50,50,0,0,1
21-07-29,"24 - 1150",136,173,126,10,37,0.926470588235294
21-07-29,"24 - 1153",125,135,122,3,10,0.976
21-07-30,"62 - 1011",61,61,59,2,0,0.967213114754098
21-07-30,"3 - 1008",194,201,174,20,7,0.896907216494845
21-07-30,"16 - 1022",50,50,48,2,0,0.96
21-07-30,"24 - 1150",135,173,127,8,38,0.940740740740741
21-07-30,"24 - 1153",125,135,125,0,10,1
21-07-31,"62 - 1011",61,61,57,4,0,0.934426229508197
21-07-31,"3 - 1008",194,201,174,20,7,0.896907216494845
21-07-31,"16 - 1022",50,50,47,3,0,0.94
21-07-31,"24 - 1150",135,173,131,4,38,0.97037037037037
21-07-31,"24 - 1153",125,135,121,4,10,0.968
21-08-01,"62 - 1011",61,61,59,2,0,0.967213114754098
21-08-01,"3 - 1008",194,201,171,23,7,0.881443298969072
21-08-01,"16 - 1022",50,50,46,4,0,0.92
21-08-01,"24 - 1150",134,173,131,3,39,0.977611940298508
21-08-01,"24 - 1153",125,135,122,3,10,0.976
21-08-02,"62 - 1011",60,61,59,1,1,0.983333333333333
21-08-02,"3 - 1008",194,201,172,22,7,0.88659793814433
21-08-02,"16 - 1022",50,50,47,3,0,0.94
21-08-02,"24 - 1150",134,173,127,7,39,0.947761194029851
21-08-02,"24 - 1153",125,135,122,3,10,0.976
21-08-03,"62 - 1011",60,61,60,0,1,1
21-08-03,"3 - 1008",190,201,171,19,11,0.9
21-08-03,"16 - 1022",50,50,48,2,0,0.96
21-08-03,"24 - 1150",132,173,123,9,41,0.931818181818182
21-08-03,"24 - 1153",125,135,122,3,10,0.976
21-08-04,"62 - 1011",60,61,59,1,1,0.983333333333333
21-08-04,"3 - 1008",190,201,175,15,11,0.921052631578947
21-08-04,"16 - 1022",50,50,48,2,0,0.96
21-08-04,"24 - 1150",130,173,123,7,43,0.946153846153846
21-08-04,"24 - 1153",125,135,123,2,10,0.984
21-08-05,"62 - 1011",60,61,59,1,1,0.983333333333333
21-08-05,"3 - 1008",191,201,171,20,10,0.895287958115183
21-08-05,"16 - 1022",50,50,46,4,0,0.92
21-08-05,"24 - 1150",128,173,112,16,45,0.875
21-08-05,"24 - 1153",125,135,124,1,10,0.992
21-08-06,"62 - 1011",60,61,59,1,1,0.983333333333333
21-08-06,"3 - 1008",190,201,169,21,11,0.889473684210526
21-08-06,"16 - 1022",50,50,47,3,0,0.94
21-08-06,"24 - 1150",128,173,106,22,45,0.828125
21-08-06,"24 - 1153",125,135,124,1,10,0.992
21-08-07,"62 - 1011",60,61,60,0,1,1
21-08-07,"3 - 1008",190,201,170,20,11,0.894736842105263
21-08-07,"16 - 1022",50,50,49,1,0,0.98
21-08-07,"24 - 1150",127,173,113,14,46,0.889763779527559
21-08-07,"24 - 1153",125,135,124,1,10,0.992
21-08-08,"62 - 1011",60,61,59,1,1,0.983333333333333
21-08-08,"3 - 1008",190,201,172,18,11,0.905263157894737
21-08-08,"16 - 1022",50,50,49,1,0,0.98
21-08-08,"24 - 1150",127,173,110,17,46,0.866141732283465
21-08-08,"24 - 1153",125,135,125,0,10,1
21-08-09,"62 - 1011",60,61,58,2,1,0.966666666666667
21-08-09,"3 - 1008",190,201,176,14,11,0.926315789473684
21-08-09,"16 - 1022",50,50,50,0,0,1
21-08-09,"24 - 1150",125,173,106,19,48,0.848
21-08-09,"24 - 1153",125,135,125,0,10,1
21-08-10,"62 - 1011",60,61,59,1,1,0.983333333333333
21-08-10,"3 - 1008",190,201,174,16,11,0.91578947368421
21-08-10,"16 - 1022",50,50,49,1,0,0.98
21-08-10,"24 - 1150",124,173,106,18,49,0.854838709677419
21-08-10,"24 - 1153",125,135,124,1,10,0.992
21-08-11,"62 - 1011",60,61,60,0,1,1
21-08-11,"3 - 1008",190,201,177,13,11,0.931578947368421
21-08-11,"16 - 1022",50,50,50,0,0,1
21-08-11,"24 - 1150",120,120,95,25,0,0.791666666666667
21-08-11,"24 - 1153",125,135,125,0,10,1
21-08-12,"62 - 1011",60,61,60,0,1,1
21-08-12,"3 - 1008",190,201,175,15,11,0.921052631578947
21-08-12,"16 - 1022",50,50,49,1,0,0.98
21-08-12,"24 - 1150",120,120,94,26,0,0.783333333333333
21-08-12,"24 - 1153",125,135,123,2,10,0.984
21-08-13,"62 - 1011",60,61,60,0,1,1
21-08-13,"3 - 1008",190,201,175,15,11,0.921052631578947
21-08-13,"16 - 1022",50,50,50,0,0,1
21-08-13,"24 - 1150",120,120,95,25,0,0.791666666666667
21-08-13,"24 - 1153",125,135,125,0,10,1
21-08-14,"62 - 1011",60,61,60,0,1,1
21-08-14,"3 - 1008",190,201,178,12,11,0.936842105263158
21-08-14,"16 - 1022",50,50,49,1,0,0.98
21-08-14,"24 - 1150",120,120,94,26,0,0.783333333333333
21-08-14,"24 - 1153",125,135,124,1,10,0.992
21-08-15,"62 - 1011",60,61,60,0,1,1
21-08-15,"3 - 1008",190,201,178,12,11,0.936842105263158
21-08-15,"16 - 1022",50,50,47,3,0,0.94
21-08-15,"24 - 1150",120,120,94,26,0,0.783333333333333
21-08-15,"24 - 1153",125,135,123,2,10,0.984
21-08-16,"62 - 1011",60,61,60,0,1,1
21-08-16,"3 - 1008",190,201,178,12,11,0.936842105263158
21-08-16,"16 - 1022",50,50,49,1,0,0.98
21-08-16,"24 - 1150",120,120,94,26,0,0.783333333333333
21-08-16,"24 - 1153",125,135,121,4,10,0.968
21-08-17,"62 - 1011",60,61,59,1,1,0.983333333333333
21-08-17,"3 - 1008",190,201,175,15,11,0.921052631578947
21-08-17,"16 - 1022",50,50,50,0,0,1
21-08-17,"24 - 1150",120,120,99,21,0,0.825
21-08-17,"24 - 1153",125,135,124,1,10,0.992
21-08-18,"62 - 1011",60,61,58,2,1,0.966666666666667
21-08-18,"3 - 1008",190,201,177,13,11,0.931578947368421
21-08-18,"16 - 1022",50,50,48,2,0,0.96
21-08-18,"24 - 1150",120,120,99,21,0,0.825
21-08-18,"24 - 1153",125,135,124,1,10,0.992
21-08-19,"62 - 1011",60,61,59,1,1,0.983333333333333
21-08-19,"3 - 1008",190,201,174,16,11,0.91578947368421
21-08-19,"16 - 1022",50,50,49,1,0,0.98
21-08-19,"24 - 1150",120,120,98,22,0,0.816666666666667
21-08-19,"24 - 1153",125,135,125,0,10,1
21-08-20,"62 - 1011",60,61,58,2,1,0.966666666666667
21-08-20,"3 - 1008",190,201,171,19,11,0.9
21-08-20,"16 - 1022",50,50,48,2,0,0.96
21-08-20,"24 - 1150",120,120,96,24,0,0.8
21-08-20,"24 - 1153",125,135,122,3,10,0.976
21-08-21,"62 - 1011",60,61,59,1,1,0.983333333333333
21-08-21,"3 - 1008",190,201,167,23,11,0.878947368421053
21-08-21,"16 - 1022",50,50,49,1,0,0.98
21-08-21,"24 - 1150",120,120,96,24,0,0.8
21-08-21,"24 - 1153",125,135,125,0,10,1
21-08-22,"62 - 1011",60,61,60,0,1,1
21-08-22,"3 - 1008",190,201,168,22,11,0.884210526315789
21-08-22,"16 - 1022",50,50,48,2,0,0.96
21-08-22,"24 - 1150",120,120,105,15,0,0.875
21-08-22,"24 - 1153",125,135,125,0,10,1
21-08-23,"62 - 1011",60,61,59,1,1,0.983333333333333
21-08-23,"3 - 1008",190,201,170,20,11,0.894736842105263
21-08-23,"16 - 1022",50,50,49,1,0,0.98
21-08-23,"24 - 1150",119,120,100,19,1,0.840336134453782
21-08-23,"24 - 1153",125,135,124,1,10,0.992
21-08-24,"62 - 1011",60,61,59,1,1,0.983333333333333
21-08-24,"3 - 1008",190,201,175,15,11,0.921052631578947
21-08-24,"16 - 1022",50,50,49,1,0,0.98
21-08-24,"24 - 1150",120,120,102,18,0,0.85
21-08-24,"24 - 1153",125,135,125,0,10,1
21-08-25,"62 - 1011",60,61,59,1,1,0.983333333333333
21-08-25,"3 - 1008",190,201,179,11,11,0.942105263157895
21-08-25,"16 - 1022",50,50,50,0,0,1
21-08-25,"24 - 1150",120,120,103,17,0,0.858333333333333
21-08-25,"24 - 1153",125,135,123,2,10,0.984
21-08-26,"62 - 1011",60,61,60,0,1,1
21-08-26,"3 - 1008",190,201,178,12,11,0.936842105263158
21-08-26,"16 - 1022",50,50,50,0,0,1
21-08-26,"24 - 1150",120,120,103,17,0,0.858333333333333
21-08-26,"24 - 1153",125,135,124,1,10,0.992
21-08-27,"62 - 1011",60,61,60,0,1,1
21-08-27,"3 - 1008",188,201,177,11,13,0.941489361702128
21-08-27,"16 - 1022",50,50,50,0,0,1
21-08-27,"24 - 1150",120,120,103,17,0,0.858333333333333
21-08-27,"24 - 1153",125,135,125,0,10,1
21-08-28,"62 - 1011",60,61,59,1,1,0.983333333333333
21-08-28,"3 - 1008",188,201,178,10,13,0.946808510638298
21-08-28,"16 - 1022",50,50,50,0,0,1
21-08-28,"24 - 1150",120,120,105,15,0,0.875
21-08-28,"24 - 1153",125,135,125,0,10,1
21-08-29,"62 - 1011",60,61,60,0,1,1
21-08-29,"3 - 1008",188,201,178,10,13,0.946808510638298
21-08-29,"16 - 1022",50,50,46,4,0,0.92
21-08-29,"24 - 1150",119,120,109,10,1,0.915966386554622
21-08-29,"24 - 1153",125,135,125,0,10,1
21-08-30,"62 - 1011",60,61,60,0,1,1
21-08-30,"3 - 1008",188,201,177,11,13,0.941489361702128
21-08-30,"16 - 1022",50,50,49,1,0,0.98
21-08-30,"24 - 1150",119,120,105,14,1,0.882352941176471
21-08-30,"24 - 1153",125,135,123,2,10,0.984
21-08-31,"62 - 1011",60,61,60,0,1,1
21-08-31,"3 - 1008",193,201,181,12,8,0.937823834196891
21-08-31,"16 - 1022",50,50,48,2,0,0.96
21-08-31,"24 - 1150",120,120,105,15,0,0.875
21-08-31,"24 - 1153",125,135,124,1,10,0.992
21-09-01,"62 - 1011",60,61,60,0,1,1
21-09-01,"3 - 1008",192,201,179,13,9,0.932291666666667
21-09-01,"16 - 1022",50,50,47,3,0,0.94
21-09-01,"24 - 1150",119,120,95,24,1,0.798319327731092
21-09-01,"24 - 1153",125,135,125,0,10,1
21-09-02,"62 - 1011",60,61,58,2,1,0.966666666666667
21-09-02,"3 - 1008",190,201,177,13,11,0.931578947368421
21-09-02,"16 - 1022",50,50,47,3,0,0.94
21-09-02,"24 - 1150",119,120,90,29,1,0.756302521008403
21-09-02,"24 - 1153",125,135,122,3,10,0.976
21-09-03,"62 - 1011",60,61,58,2,1,0.966666666666667
21-09-03,"3 - 1008",190,201,176,14,11,0.926315789473684
21-09-03,"16 - 1022",50,50,46,4,0,0.92
21-09-03,"24 - 1150",120,120,86,34,0,0.716666666666667
21-09-03,"24 - 1153",125,135,123,2,10,0.984
21-09-04,"62 - 1011",60,61,58,2,1,0.966666666666667
21-09-04,"3 - 1008",190,201,179,11,11,0.942105263157895
21-09-04,"16 - 1022",50,50,46,4,0,0.92
21-09-04,"24 - 1150",120,120,87,33,0,0.725
21-09-04,"24 - 1153",125,135,125,0,10,1
21-09-05,"62 - 1011",60,61,58,2,1,0.966666666666667
21-09-05,"3 - 1008",189,201,178,11,12,0.941798941798942
21-09-05,"16 - 1022",50,50,43,7,0,0.86
21-09-05,"24 - 1150",120,120,84,36,0,0.7
21-09-05,"24 - 1153",125,135,125,0,10,1
21-09-06,"62 - 1011",60,61,60,0,1,1
21-09-06,"3 - 1008",189,201,178,11,12,0.941798941798942
21-09-06,"16 - 1022",50,50,44,6,0,0.88
21-09-06,"24 - 1150",120,120,85,35,0,0.708333333333333
21-09-06,"24 - 1153",125,135,125,0,10,1
21-09-07,"62 - 1011",60,61,60,0,1,1
21-09-07,"3 - 1008",189,201,176,13,12,0.931216931216931
21-09-07,"16 - 1022",50,50,50,0,0,1
21-09-07,"24 - 1150",120,120,93,27,0,0.775
21-09-07,"24 - 1153",125,135,125,0,10,1
21-09-08,"62 - 1011",60,61,60,0,1,1
21-09-08,"3 - 1008",188,201,175,13,13,0.930851063829787
21-09-08,"16 - 1022",50,50,50,0,0,1
21-09-08,"24 - 1150",120,120,85,35,0,0.708333333333333
21-09-08,"24 - 1153",125,135,124,1,10,0.992
21-09-09,"62 - 1011",60,61,59,1,1,0.983333333333333
21-09-09,"3 - 1008",188,201,175,13,13,0.930851063829787
21-09-09,"16 - 1022",50,50,50,0,0,1
21-09-09,"24 - 1150",81,120,81,0,39,1
21-09-09,"24 - 1153",125,135,125,0,10,1
21-09-10,"62 - 1011",60,61,60,0,1,1
21-09-10,"3 - 1008",186,201,174,12,15,0.935483870967742
21-09-10,"16 - 1022",50,50,48,2,0,0.96
21-09-10,"24 - 1150",79,120,79,0,41,1
21-09-10,"24 - 1153",125,135,125,0,10,1
21-09-11,"62 - 1011",60,61,60,0,1,1
21-09-11,"3 - 1008",186,201,175,11,15,0.940860215053763
21-09-11,"16 - 1022",50,50,49,1,0,0.98
21-09-11,"24 - 1150",77,120,77,0,43,1
21-09-11,"24 - 1153",125,135,124,1,10,0.992
21-09-12,"62 - 1011",60,61,60,0,1,1
21-09-12,"3 - 1008",186,201,175,11,15,0.940860215053763
21-09-12,"16 - 1022",50,50,50,0,0,1
21-09-12,"24 - 1150",79,120,79,0,41,1
21-09-12,"24 - 1153",125,135,125,0,10,1
21-09-13,"62 - 1011",60,61,60,0,1,1
21-09-13,"3 - 1008",184,201,174,10,17,0.945652173913043
21-09-13,"16 - 1022",50,50,49,1,0,0.98
21-09-13,"24 - 1150",78,120,78,0,42,1
21-09-13,"24 - 1153",125,135,125,0,10,1
21-09-14,"62 - 1011",60,61,59,1,1,0.983333333333333
21-09-14,"3 - 1008",184,201,172,12,17,0.934782608695652
21-09-14,"16 - 1022",50,50,50,0,0,1
21-09-14,"24 - 1150",76,120,73,3,44,0.960526315789474
21-09-14,"24 - 1153",125,135,124,1,10,0.992
21-09-15,"62 - 1011",60,61,60,0,1,1
21-09-15,"3 - 1008",172,201,171,1,29,0.994186046511628
21-09-15,"16 - 1022",50,50,48,2,0,0.96
21-09-15,"24 - 1150",69,120,69,0,51,1
21-09-15,"24 - 1153",125,135,125,0,10,1
21-09-16,"62 - 1011",60,61,60,0,1,1
21-09-16,"3 - 1008",172,201,170,2,29,0.988372093023256
21-09-16,"16 - 1022",50,50,48,2,0,0.96
21-09-16,"24 - 1150",69,120,69,0,51,1
21-09-16,"24 - 1153",125,135,123,2,10,0.984
21-09-17,"62 - 1011",60,61,60,0,1,1
21-09-17,"3 - 1008",172,201,170,2,29,0.988372093023256
21-09-17,"16 - 1022",50,50,48,2,0,0.96
21-09-17,"24 - 1150",67,120,67,0,53,1
21-09-17,"24 - 1153",125,135,124,1,10,0.992
21-09-18,"62 - 1011",60,61,60,0,1,1
21-09-18,"3 - 1008",172,201,171,1,29,0.994186046511628
21-09-18,"16 - 1022",50,50,47,3,0,0.94
21-09-18,"24 - 1150",67,120,67,0,53,1
21-09-18,"24 - 1153",124,135,123,1,11,0.991935483870968
21-09-19,"62 - 1011",60,61,60,0,1,1
21-09-19,"3 - 1008",173,201,172,1,28,0.994219653179191
21-09-19,"16 - 1022",50,50,47,3,0,0.94
21-09-19,"24 - 1150",67,120,67,0,53,1
21-09-19,"24 - 1153",125,135,124,1,10,0.992
21-09-20,"62 - 1011",60,61,60,0,1,1
21-09-20,"3 - 1008",174,201,172,2,27,0.988505747126437
21-09-20,"16 - 1022",50,50,48,2,0,0.96
21-09-20,"24 - 1150",65,120,65,0,55,1
21-09-20,"24 - 1153",125,135,125,0,10,1
21-09-21,"62 - 1011",60,61,59,1,1,0.983333333333333
21-09-21,"3 - 1008",177,201,173,4,24,0.977401129943503
21-09-21,"16 - 1022",50,50,49,1,0,0.98
21-09-21,"24 - 1150",119,120,74,45,1,0.621848739495798
21-09-21,"24 - 1153",125,135,125,0,10,1
21-09-22,"62 - 1011",60,61,60,0,1,1
21-09-22,"3 - 1008",176,201,170,6,25,0.965909090909091
21-09-22,"16 - 1022",50,50,49,1,0,0.98
21-09-22,"24 - 1150",119,120,78,41,1,0.65546218487395
21-09-22,"24 - 1153",125,135,125,0,10,1
21-09-23,"62 - 1011",60,61,57,3,1,0.95
21-09-23,"3 - 1008",177,201,170,7,24,0.96045197740113
21-09-23,"16 - 1022",50,50,49,1,0,0.98
21-09-23,"24 - 1150",119,120,84,35,1,0.705882352941177
21-09-23,"24 - 1153",125,135,124,1,10,0.992
21-09-24,"62 - 1011",60,61,58,2,1,0.966666666666667
21-09-24,"3 - 1008",177,201,170,7,24,0.96045197740113
21-09-24,"16 - 1022",50,50,50,0,0,1
21-09-24,"24 - 1150",119,120,87,32,1,0.73109243697479
21-09-24,"24 - 1153",125,135,124,1,10,0.992
21-09-25,"62 - 1011",60,61,58,2,1,0.966666666666667
21-09-25,"3 - 1008",177,201,169,8,24,0.954802259887006
21-09-25,"16 - 1022",50,50,50,0,0,1
21-09-25,"24 - 1150",119,120,87,32,1,0.73109243697479
21-09-25,"24 - 1153",125,135,125,0,10,1
21-09-26,"62 - 1011",60,61,58,2,1,0.966666666666667
21-09-26,"3 - 1008",178,201,170,8,23,0.955056179775281
21-09-26,"16 - 1022",50,50,49,1,0,0.98
21-09-26,"24 - 1150",119,120,92,27,1,0.773109243697479
21-09-26,"24 - 1153",125,135,125,0,10,1
21-09-27,"62 - 1011",60,61,60,0,1,1
21-09-27,"3 - 1008",175,201,170,5,26,0.971428571428571
21-09-27,"16 - 1022",50,50,45,5,0,0.9
21-09-27,"24 - 1150",119,120,95,24,1,0.798319327731092
21-09-27,"24 - 1153",125,135,124,1,10,0.992
21-09-28,"62 - 1011",60,61,60,0,1,1
21-09-28,"3 - 1008",189,201,176,13,12,0.931216931216931
21-09-28,"16 - 1022",50,50,47,3,0,0.94
21-09-28,"24 - 1150",119,120,93,26,1,0.781512605042017
21-09-28,"24 - 1153",125,135,124,1,10,0.992
21-09-29,"62 - 1011",60,61,59,1,1,0.983333333333333
21-09-29,"3 - 1008",190,201,178,12,11,0.936842105263158
21-09-29,"16 - 1022",50,50,48,2,0,0.96
21-09-29,"24 - 1150",119,120,96,23,1,0.80672268907563
21-09-29,"24 - 1153",125,135,124,1,10,0.992
21-09-30,"62 - 1011",60,61,60,0,1,1
21-09-30,"3 - 1008",191,201,177,14,10,0.926701570680628
21-09-30,"16 - 1022",50,50,47,3,0,0.94
21-09-30,"24 - 1150",119,120,92,27,1,0.773109243697479
21-09-30,"24 - 1153",125,135,124,1,10,0.992
21-10-01,"62 - 1011",60,61,59,1,1,0.983333333333333
21-10-01,"3 - 1008",191,201,177,14,10,0.926701570680628
21-10-01,"16 - 1022",50,50,48,2,0,0.96
21-10-01,"24 - 1150",119,120,95,24,1,0.798319327731092
21-10-01,"24 - 1153",125,135,123,2,10,0.984
21-10-02,"62 - 1011",60,61,59,1,1,0.983333333333333
21-10-02,"3 - 1008",192,201,177,15,9,0.921875
21-10-02,"16 - 1022",50,50,48,2,0,0.96
21-10-02,"24 - 1150",119,120,93,26,1,0.781512605042017
21-10-02,"24 - 1153",125,135,125,0,10,1
21-10-03,"62 - 1011",60,61,59,1,1,0.983333333333333
21-10-03,"3 - 1008",192,201,180,12,9,0.9375
21-10-03,"16 - 1022",50,50,48,2,0,0.96
21-10-03,"24 - 1150",119,120,95,24,1,0.798319327731092
21-10-03,"24 - 1153",125,135,125,0,10,1
21-10-04,"62 - 1011",60,61,59,1,1,0.983333333333333
21-10-04,"3 - 1008",193,201,181,12,8,0.937823834196891
21-10-04,"16 - 1022",50,50,48,2,0,0.96
21-10-04,"24 - 1150",119,120,93,26,1,0.781512605042017
21-10-04,"24 - 1153",125,135,125,0,10,1
21-10-05,"62 - 1011",60,61,59,1,1,0.983333333333333
21-10-05,"3 - 1008",193,201,177,16,8,0.917098445595855
21-10-05,"16 - 1022",50,50,46,4,0,0.92
21-10-05,"24 - 1150",118,120,99,19,2,0.838983050847458
21-10-05,"24 - 1153",125,135,124,1,10,0.992
21-10-06,"62 - 1011",60,61,58,2,1,0.966666666666667
21-10-06,"3 - 1008",193,201,178,15,8,0.922279792746114
21-10-06,"16 - 1022",50,50,47,3,0,0.94
21-10-06,"24 - 1150",120,120,103,17,0,0.858333333333333
21-10-06,"24 - 1153",125,135,123,2,10,0.984
21-10-07,"62 - 1011",60,61,57,3,1,0.95
21-10-07,"3 - 1008",193,201,180,13,8,0.932642487046632
21-10-07,"16 - 1022",50,50,49,1,0,0.98
21-10-07,"24 - 1150",120,120,102,18,0,0.85
21-10-07,"24 - 1153",125,135,125,0,10,1
21-10-08,"62 - 1011",60,61,57,3,1,0.95
21-10-08,"3 - 1008",193,201,182,11,8,0.94300518134715
21-10-08,"16 - 1022",50,50,49,1,0,0.98
21-10-08,"24 - 1150",120,120,103,17,0,0.858333333333333
21-10-08,"24 - 1153",125,135,125,0,10,1
21-10-09,"62 - 1011",60,61,57,3,1,0.95
21-10-09,"3 - 1008",193,201,180,13,8,0.932642487046632
21-10-09,"16 - 1022",50,50,50,0,0,1
21-10-09,"24 - 1150",120,120,116,4,0,0.966666666666667
21-10-09,"24 - 1153",125,135,124,1,10,0.992
21-10-10,"62 - 1011",60,61,58,2,1,0.966666666666667
21-10-10,"3 - 1008",192,201,180,12,9,0.9375
21-10-10,"16 - 1022",50,50,49,1,0,0.98
21-10-10,"24 - 1150",120,120,111,9,0,0.925
21-10-10,"24 - 1153",125,135,125,0,10,1
21-10-11,"62 - 1011",60,61,58,2,1,0.966666666666667
21-10-11,"3 - 1008",192,201,180,12,9,0.9375
21-10-11,"16 - 1022",50,50,48,2,0,0.96
21-10-11,"24 - 1150",120,120,113,7,0,0.941666666666667
21-10-11,"24 - 1153",125,135,125,0,10,1
21-10-12,"62 - 1011",60,61,56,4,1,0.933333333333333
21-10-12,"3 - 1008",194,201,178,16,7,0.917525773195876
21-10-12,"16 - 1022",50,50,49,1,0,0.98
21-10-12,"24 - 1150",120,120,109,11,0,0.908333333333333
21-10-12,"24 - 1153",125,135,125,0,10,1
21-10-13,"62 - 1011",60,61,55,5,1,0.916666666666667
21-10-13,"3 - 1008",194,201,178,16,7,0.917525773195876
21-10-13,"16 - 1022",50,50,50,0,0,1
21-10-13,"24 - 1150",120,120,106,14,0,0.883333333333333
21-10-13,"24 - 1153",125,135,125,0,10,1
21-10-14,"62 - 1011",60,61,58,2,1,0.966666666666667
21-10-14,"3 - 1008",195,201,181,14,6,0.928205128205128
21-10-14,"16 - 1022",50,50,47,3,0,0.94
21-10-14,"24 - 1150",120,120,104,16,0,0.866666666666667
21-10-14,"24 - 1153",125,135,125,0,10,1
21-10-15,"62 - 1011",60,61,59,1,1,0.983333333333333
21-10-15,"3 - 1008",194,201,182,12,7,0.938144329896907
21-10-15,"16 - 1022",50,50,50,0,0,1
21-10-15,"24 - 1150",120,120,106,14,0,0.883333333333333
21-10-15,"24 - 1153",125,135,125,0,10,1
21-10-16,"62 - 1011",60,61,57,3,1,0.95
21-10-16,"3 - 1008",193,201,184,9,8,0.953367875647668
21-10-16,"16 - 1022",50,50,48,2,0,0.96
21-10-16,"24 - 1150",120,120,112,8,0,0.933333333333333
21-10-16,"24 - 1153",125,135,125,0,10,1
21-10-17,"62 - 1011",60,61,59,1,1,0.983333333333333
21-10-17,"3 - 1008",193,201,184,9,8,0.953367875647668
21-10-17,"16 - 1022",50,50,47,3,0,0.94
21-10-17,"24 - 1150",120,120,100,20,0,0.833333333333333
21-10-17,"24 - 1153",125,135,125,0,10,1
21-10-18,"62 - 1011",60,61,59,1,1,0.983333333333333
21-10-18,"3 - 1008",193,201,185,8,8,0.958549222797927
21-10-18,"16 - 1022",50,50,50,0,0,1
21-10-18,"24 - 1150",120,120,99,21,0,0.825
21-10-18,"24 - 1153",125,135,125,0,10,1
21-10-19,"62 - 1011",60,61,59,1,1,0.983333333333333
21-10-19,"3 - 1008",193,201,185,8,8,0.958549222797927
21-10-19,"16 - 1022",50,50,48,2,0,0.96
21-10-19,"24 - 1150",120,120,100,20,0,0.833333333333333
21-10-19,"24 - 1153",125,135,124,1,10,0.992
21-10-20,"62 - 1011",60,61,60,0,1,1
21-10-20,"3 - 1008",193,201,183,10,8,0.948186528497409
21-10-20,"16 - 1022",50,50,49,1,0,0.98
21-10-20,"24 - 1150",120,120,89,31,0,0.741666666666667
21-10-20,"24 - 1153",123,135,123,0,12,1
21-10-21,"62 - 1011",60,61,60,0,1,1
21-10-21,"3 - 1008",193,201,182,11,8,0.94300518134715
21-10-21,"16 - 1022",50,50,50,0,0,1
21-10-21,"24 - 1150",118,120,94,24,2,0.796610169491525
21-10-21,"24 - 1153",125,135,124,1,10,0.992
21-10-22,"62 - 1011",60,61,60,0,1,1
21-10-22,"3 - 1008",193,201,183,10,8,0.948186528497409
21-10-22,"16 - 1022",50,50,49,1,0,0.98
21-10-22,"24 - 1150",120,120,97,23,0,0.808333333333333
21-10-22,"24 - 1153",125,135,124,1,10,0.992
21-10-23,"62 - 1011",60,61,59,1,1,0.983333333333333
21-10-23,"3 - 1008",192,201,185,7,9,0.963541666666667
21-10-23,"16 - 1022",50,50,49,1,0,0.98
21-10-23,"24 - 1150",120,120,95,25,0,0.791666666666667
21-10-23,"24 - 1153",125,135,125,0,10,1
21-10-24,"62 - 1011",60,61,58,2,1,0.966666666666667
21-10-24,"3 - 1008",192,201,185,7,9,0.963541666666667
21-10-24,"16 - 1022",50,50,50,0,0,1
21-10-24,"24 - 1150",120,120,100,20,0,0.833333333333333
21-10-24,"24 - 1153",125,135,125,0,10,1
21-10-25,"62 - 1011",60,61,60,0,1,1
21-10-25,"3 - 1008",192,201,187,5,9,0.973958333333333
21-10-25,"16 - 1022",50,50,49,1,0,0.98
21-10-25,"24 - 1150",120,120,103,17,0,0.858333333333333
21-10-25,"24 - 1153",125,135,124,1,10,0.992
21-10-26,"62 - 1011",60,61,60,0,1,1
21-10-26,"3 - 1008",192,201,187,5,9,0.973958333333333
21-10-26,"16 - 1022",50,50,48,2,0,0.96
21-10-26,"24 - 1150",120,120,98,22,0,0.816666666666667
21-10-26,"24 - 1153",125,135,124,1,10,0.992
21-10-27,"62 - 1011",60,61,59,1,1,0.983333333333333
21-10-27,"3 - 1008",192,201,186,6,9,0.96875
21-10-27,"16 - 1022",50,50,48,2,0,0.96
21-10-27,"24 - 1150",120,120,102,18,0,0.85
21-10-27,"24 - 1153",125,135,124,1,10,0.992
21-10-28,"62 - 1011",60,61,60,0,1,1
21-10-28,"3 - 1008",192,201,188,4,9,0.979166666666667
21-10-28,"16 - 1022",50,50,48,2,0,0.96
21-10-28,"24 - 1150",120,120,95,25,0,0.791666666666667
21-10-28,"24 - 1153",125,135,125,0,10,1
21-10-29,"62 - 1011",60,61,60,0,1,1
21-10-29,"3 - 1008",192,201,190,2,9,0.989583333333333
21-10-29,"16 - 1022",50,50,49,1,0,0.98
21-10-29,"24 - 1150",120,120,96,24,0,0.8
21-10-29,"24 - 1153",125,135,125,0,10,1
21-10-30,"62 - 1011",60,61,60,0,1,1
21-10-30,"3 - 1008",192,201,190,2,9,0.989583333333333
21-10-30,"16 - 1022",50,50,49,1,0,0.98
21-10-30,"24 - 1150",120,120,101,19,0,0.841666666666667
21-10-30,"24 - 1153",125,135,125,0,10,1
21-10-31,"62 - 1011",60,61,60,0,1,1
21-10-31,"3 - 1008",192,201,190,2,9,0.989583333333333
21-10-31,"16 - 1022",50,50,48,2,0,0.96
21-10-31,"24 - 1150",120,120,99,21,0,0.825
21-10-31,"24 - 1153",125,135,125,0,10,1
21-11-01,"62 - 1011",60,61,60,0,1,1
21-11-01,"3 - 1008",192,201,189,3,9,0.984375
21-11-01,"16 - 1022",50,50,48,2,0,0.96
21-11-01,"24 - 1150",120,120,89,31,0,0.741666666666667
21-11-01,"24 - 1153",125,135,125,0,10,1
21-11-02,"62 - 1011",60,61,60,0,1,1
21-11-02,"3 - 1008",192,201,188,4,9,0.979166666666667
21-11-02,"16 - 1022",50,50,47,3,0,0.94
21-11-02,"24 - 1150",120,120,91,29,0,0.758333333333333
21-11-02,"24 - 1153",125,135,125,0,10,1
21-11-03,"62 - 1011",60,61,59,1,1,0.983333333333333
21-11-03,"3 - 1008",192,201,189,3,9,0.984375
21-11-03,"16 - 1022",50,50,45,5,0,0.9
21-11-03,"24 - 1150",120,120,96,24,0,0.8
21-11-03,"24 - 1153",125,135,125,0,10,1
21-11-04,"62 - 1011",60,61,59,1,1,0.983333333333333
21-11-04,"3 - 1008",192,201,190,2,9,0.989583333333333
21-11-04,"16 - 1022",50,50,47,3,0,0.94
21-11-04,"24 - 1150",119,120,91,28,1,0.764705882352941
21-11-04,"24 - 1153",125,135,125,0,10,1
21-11-05,"62 - 1011",60,61,59,1,1,0.983333333333333
21-11-05,"3 - 1008",192,201,190,2,9,0.989583333333333
21-11-05,"16 - 1022",50,50,47,3,0,0.94
21-11-05,"24 - 1150",120,120,96,24,0,0.8
21-11-05,"24 - 1153",124,135,124,0,11,1
21-11-06,"62 - 1011",60,61,59,1,1,0.983333333333333
21-11-06,"3 - 1008",192,201,190,2,9,0.989583333333333
21-11-06,"16 - 1022",50,50,46,4,0,0.92
21-11-06,"24 - 1150",120,120,102,18,0,0.85
21-11-06,"24 - 1153",124,135,124,0,11,1
21-11-07,"62 - 1011",60,61,59,1,1,0.983333333333333
21-11-07,"3 - 1008",192,201,189,3,9,0.984375
21-11-07,"16 - 1022",50,50,46,4,0,0.92
21-11-07,"24 - 1150",120,120,104,16,0,0.866666666666667
21-11-07,"24 - 1153",124,135,124,0,11,1
21-11-08,"62 - 1011",60,61,60,0,1,1
21-11-08,"3 - 1008",192,201,189,3,9,0.984375
21-11-08,"16 - 1022",50,50,48,2,0,0.96
21-11-08,"24 - 1150",120,120,106,14,0,0.883333333333333
21-11-08,"24 - 1153",124,135,124,0,11,1
21-11-09,"62 - 1011",60,61,60,0,1,1
21-11-09,"3 - 1008",192,201,189,3,9,0.984375
21-11-09,"16 - 1022",50,50,46,4,0,0.92
21-11-09,"24 - 1150",120,120,104,16,0,0.866666666666667
21-11-09,"24 - 1153",125,135,125,0,10,1
21-11-10,"62 - 1011",60,61,60,0,1,1
21-11-10,"3 - 1008",192,201,189,3,9,0.984375
21-11-10,"16 - 1022",49,50,46,3,1,0.938775510204082
21-11-10,"24 - 1150",120,120,103,17,0,0.858333333333333
21-11-10,"24 - 1153",125,135,124,1,10,0.992
21-11-11,"62 - 1011",60,61,60,0,1,1
21-11-11,"3 - 1008",192,201,189,3,9,0.984375
21-11-11,"16 - 1022",50,50,44,6,0,0.88
21-11-11,"24 - 1150",120,120,104,16,0,0.866666666666667
21-11-11,"24 - 1153",125,135,125,0,10,1
21-11-12,"62 - 1011",60,61,60,0,1,1
21-11-12,"3 - 1008",192,201,189,3,9,0.984375
21-11-12,"16 - 1022",50,50,45,5,0,0.9
21-11-12,"24 - 1150",120,120,101,19,0,0.841666666666667
21-11-12,"24 - 1153",125,135,125,0,10,1
21-11-13,"62 - 1011",60,61,60,0,1,1
21-11-13,"3 - 1008",192,201,187,5,9,0.973958333333333
21-11-13,"16 - 1022",50,50,46,4,0,0.92
21-11-13,"24 - 1150",120,120,106,14,0,0.883333333333333
21-11-13,"24 - 1153",125,135,125,0,10,1
21-11-14,"62 - 1011",60,61,60,0,1,1
21-11-14,"3 - 1008",192,201,187,5,9,0.973958333333333
21-11-14,"16 - 1022",50,50,46,4,0,0.92
21-11-14,"24 - 1150",119,120,105,14,1,0.882352941176471
21-11-14,"24 - 1153",125,135,125,0,10,1
21-11-15,"62 - 1011",60,61,60,0,1,1
21-11-15,"3 - 1008",192,201,185,7,9,0.963541666666667
21-11-15,"16 - 1022",50,50,43,7,0,0.86
21-11-15,"24 - 1150",119,120,112,7,1,0.941176470588235
21-11-15,"24 - 1153",125,135,125,0,10,1
21-11-16,"62 - 1011",60,61,60,0,1,1
21-11-16,"3 - 1008",192,201,185,7,9,0.963541666666667
21-11-16,"16 - 1022",50,50,44,6,0,0.88
21-11-16,"24 - 1150",119,120,111,8,1,0.932773109243697
21-11-16,"24 - 1153",125,135,125,0,10,1
21-11-17,"62 - 1011",60,61,59,1,1,0.983333333333333
21-11-17,"3 - 1008",192,201,185,7,9,0.963541666666667
21-11-17,"16 - 1022",49,50,45,4,1,0.918367346938776
21-11-17,"24 - 1150",119,120,109,10,1,0.915966386554622
21-11-17,"24 - 1153",124,135,124,0,11,1
21-11-18,"62 - 1011",60,61,58,2,1,0.966666666666667
21-11-18,"3 - 1008",192,201,183,9,9,0.953125
21-11-18,"16 - 1022",49,50,47,2,1,0.959183673469388
21-11-18,"24 - 1150",119,120,107,12,1,0.899159663865546
21-11-18,"24 - 1153",124,135,124,0,11,1
21-11-19,"62 - 1011",60,61,60,0,1,1
21-11-19,"3 - 1008",192,201,184,8,9,0.958333333333333
21-11-19,"16 - 1022",50,50,44,6,0,0.88
21-11-19,"24 - 1150",119,120,103,16,1,0.865546218487395
21-11-19,"24 - 1153",125,135,125,0,10,1
21-11-20,"62 - 1011",60,61,59,1,1,0.983333333333333
21-11-20,"3 - 1008",192,201,183,9,9,0.953125
21-11-20,"16 - 1022",50,50,45,5,0,0.9
21-11-20,"24 - 1150",119,120,115,4,1,0.966386554621849
21-11-20,"24 - 1153",125,135,125,0,10,1
21-11-21,"62 - 1011",60,61,59,1,1,0.983333333333333
21-11-21,"3 - 1008",192,201,184,8,9,0.958333333333333
21-11-21,"16 - 1022",50,50,46,4,0,0.92
21-11-21,"24 - 1150",120,120,113,7,0,0.941666666666667
21-11-21,"24 - 1153",125,135,125,0,10,1
21-11-22,"62 - 1011",60,61,60,0,1,1
21-11-22,"3 - 1008",192,201,185,7,9,0.963541666666667
21-11-22,"16 - 1022",50,50,48,2,0,0.96
21-11-22,"24 - 1150",120,120,115,5,0,0.958333333333333
21-11-22,"24 - 1153",125,135,125,0,10,1
21-11-23,"62 - 1011",60,61,59,1,1,0.983333333333333
21-11-23,"3 - 1008",192,201,185,7,9,0.963541666666667
21-11-23,"16 - 1022",50,50,48,2,0,0.96
21-11-23,"24 - 1150",120,120,118,2,0,0.983333333333333
21-11-23,"24 - 1153",125,135,125,0,10,1
21-11-24,"62 - 1011",60,61,60,0,1,1
21-11-24,"3 - 1008",192,201,184,8,9,0.958333333333333
21-11-24,"16 - 1022",50,50,48,2,0,0.96
21-11-24,"24 - 1150",120,120,102,18,0,0.85
21-11-24,"24 - 1153",124,135,124,0,11,1
21-11-25,"62 - 1011",60,61,60,0,1,1
21-11-25,"3 - 1008",198,204,189,9,6,0.954545454545455
21-11-25,"16 - 1022",50,50,47,3,0,0.94
21-11-25,"24 - 1150",120,120,110,10,0,0.916666666666667
21-11-25,"24 - 1153",124,135,124,0,11,1
21-11-26,"62 - 1011",60,61,60,0,1,1
21-11-26,"3 - 1008",212,215,196,16,3,0.924528301886792
21-11-26,"16 - 1022",50,50,49,1,0,0.98
21-11-26,"24 - 1150",120,120,103,17,0,0.858333333333333
21-11-26,"24 - 1153",124,135,124,0,11,1
21-11-27,"62 - 1011",60,61,60,0,1,1
21-11-27,"3 - 1008",212,215,199,13,3,0.938679245283019
21-11-27,"16 - 1022",50,50,48,2,0,0.96
21-11-27,"24 - 1150",120,120,103,17,0,0.858333333333333
21-11-27,"24 - 1153",124,135,124,0,11,1
21-11-28,"62 - 1011",60,61,60,0,1,1
21-11-28,"3 - 1008",212,215,200,12,3,0.943396226415094
21-11-28,"16 - 1022",50,50,47,3,0,0.94
21-11-28,"24 - 1150",120,120,112,8,0,0.933333333333333
21-11-28,"24 - 1153",125,135,125,0,10,1
21-11-29,"62 - 1011",60,61,59,1,1,0.983333333333333
21-11-29,"3 - 1008",212,215,201,11,3,0.94811320754717
21-11-29,"16 - 1022",50,50,49,1,0,0.98
21-11-29,"24 - 1150",120,120,110,10,0,0.916666666666667
21-11-29,"24 - 1153",125,135,124,1,10,0.992
21-11-30,"62 - 1011",60,61,59,1,1,0.983333333333333
21-11-30,"3 - 1008",212,215,203,9,3,0.957547169811321
21-11-30,"16 - 1022",50,50,50,0,0,1
21-11-30,"24 - 1150",120,120,110,10,0,0.916666666666667
21-11-30,"24 - 1153",125,135,125,0,10,1
21-12-01,"62 - 1011",60,61,59,1,1,0.983333333333333
21-12-01,"3 - 1008",212,215,202,10,3,0.952830188679245
21-12-01,"16 - 1022",50,50,48,2,0,0.96
21-12-01,"24 - 1150",120,120,108,12,0,0.9
21-12-01,"24 - 1153",125,135,125,0,10,1
21-12-02,"62 - 1011",60,61,59,1,1,0.983333333333333
21-12-02,"3 - 1008",212,215,199,13,3,0.938679245283019
21-12-02,"16 - 1022",50,50,48,2,0,0.96
21-12-02,"24 - 1150",120,120,104,16,0,0.866666666666667
21-12-02,"24 - 1153",125,135,124,1,10,0.992
21-12-03,"62 - 1011",60,61,60,0,1,1
21-12-03,"3 - 1008",212,215,202,10,3,0.952830188679245
21-12-03,"16 - 1022",50,50,47,3,0,0.94
21-12-03,"24 - 1150",120,120,103,17,0,0.858333333333333
21-12-03,"24 - 1153",125,135,123,2,10,0.984
21-12-04,"62 - 1011",60,61,60,0,1,1
21-12-04,"3 - 1008",212,215,203,9,3,0.957547169811321
21-12-04,"16 - 1022",50,50,46,4,0,0.92
21-12-04,"24 - 1150",120,120,100,20,0,0.833333333333333
21-12-04,"24 - 1153",125,135,125,0,10,1
21-12-05,"62 - 1011",60,61,59,1,1,0.983333333333333
21-12-05,"3 - 1008",212,215,203,9,3,0.957547169811321
21-12-05,"16 - 1022",50,50,46,4,0,0.92
21-12-05,"24 - 1150",120,120,101,19,0,0.841666666666667
21-12-05,"24 - 1153",125,135,125,0,10,1
21-12-06,"62 - 1011",60,61,58,2,1,0.966666666666667
21-12-06,"3 - 1008",212,215,199,13,3,0.938679245283019
21-12-06,"16 - 1022",50,50,48,2,0,0.96
21-12-06,"24 - 1150",120,120,105,15,0,0.875
21-12-06,"24 - 1153",175,185,134,41,10,0.765714285714286
21-12-07,"62 - 1011",60,61,58,2,1,0.966666666666667
21-12-07,"3 - 1008",211,215,201,10,4,0.95260663507109
21-12-07,"16 - 1022",50,50,50,0,0,1
21-12-07,"24 - 1150",120,120,105,15,0,0.875
21-12-07,"24 - 1153",175,185,156,19,10,0.891428571428571
21-12-08,"62 - 1011",60,61,59,1,1,0.983333333333333
21-12-08,"3 - 1008",212,215,201,11,3,0.94811320754717
21-12-08,"16 - 1022",50,50,49,1,0,0.98
21-12-08,"24 - 1150",120,120,106,14,0,0.883333333333333
21-12-08,"24 - 1153",175,185,168,7,10,0.96
21-12-09,"62 - 1011",60,61,60,0,1,1
21-12-09,"3 - 1008",212,215,206,6,3,0.971698113207547
21-12-09,"16 - 1022",50,50,48,2,0,0.96
21-12-09,"24 - 1150",120,120,111,9,0,0.925
21-12-09,"24 - 1153",160,185,158,2,25,0.9875
21-12-10,"62 - 1011",60,61,60,0,1,1
21-12-10,"3 - 1008",212,215,202,10,3,0.952830188679245
21-12-10,"16 - 1022",49,50,47,2,1,0.959183673469388
21-12-10,"24 - 1150",120,120,112,8,0,0.933333333333333
21-12-10,"24 - 1153",150,185,149,1,35,0.993333333333333
21-12-11,"62 - 1011",60,61,59,1,1,0.983333333333333
21-12-11,"3 - 1008",212,215,204,8,3,0.962264150943396
21-12-11,"16 - 1022",50,50,48,2,0,0.96
21-12-11,"24 - 1150",120,120,114,6,0,0.95
21-12-11,"24 - 1153",135,185,133,2,50,0.985185185185185
21-12-12,"62 - 1011",60,61,60,0,1,1
21-12-12,"3 - 1008",212,215,203,9,3,0.957547169811321
21-12-12,"16 - 1022",50,50,47,3,0,0.94
21-12-12,"24 - 1150",120,120,119,1,0,0.991666666666667
21-12-12,"24 - 1153",125,135,123,2,10,0.984
21-12-13,"62 - 1011",60,61,58,2,1,0.966666666666667
21-12-13,"3 - 1008",212,215,204,8,3,0.962264150943396
21-12-13,"16 - 1022",50,50,46,4,0,0.92
21-12-13,"24 - 1150",120,120,113,7,0,0.941666666666667
21-12-13,"24 - 1153",125,135,125,0,10,1
21-12-14,"62 - 1011",59,61,58,1,2,0.983050847457627
21-12-14,"3 - 1008",212,215,205,7,3,0.966981132075472
21-12-14,"16 - 1022",50,50,47,3,0,0.94
21-12-14,"24 - 1150",119,120,111,8,1,0.932773109243697
21-12-14,"24 - 1153",125,135,125,0,10,1
21-12-15,"62 - 1011",59,61,58,1,2,0.983050847457627
21-12-15,"3 - 1008",212,215,207,5,3,0.976415094339623
21-12-15,"16 - 1022",50,50,48,2,0,0.96
21-12-15,"24 - 1150",119,120,114,5,1,0.957983193277311
21-12-15,"24 - 1153",125,135,125,0,10,1
21-12-16,"62 - 1011",59,61,58,1,2,0.983050847457627
21-12-16,"3 - 1008",222,241,210,12,19,0.945945945945946
21-12-16,"16 - 1022",50,50,48,2,0,0.96
21-12-16,"24 - 1150",120,120,107,13,0,0.891666666666667
21-12-16,"24 - 1153",125,135,124,1,10,0.992
21-12-17,"62 - 1011",59,61,59,0,2,1
21-12-17,"3 - 1008",222,241,211,11,19,0.95045045045045
21-12-17,"16 - 1022",50,50,49,1,0,0.98
21-12-17,"24 - 1150",120,120,107,13,0,0.891666666666667
21-12-17,"24 - 1153",125,135,125,0,10,1
21-12-18,"62 - 1011",59,61,59,0,2,1
21-12-18,"3 - 1008",222,241,214,8,19,0.963963963963964
21-12-18,"16 - 1022",50,50,47,3,0,0.94
21-12-18,"24 - 1150",120,120,112,8,0,0.933333333333333
21-12-18,"24 - 1153",125,135,125,0,10,1
21-12-19,"62 - 1011",59,61,58,1,2,0.983050847457627
21-12-19,"3 - 1008",222,241,215,7,19,0.968468468468468
21-12-19,"16 - 1022",50,50,49,1,0,0.98
21-12-19,"24 - 1150",120,120,111,9,0,0.925
21-12-19,"24 - 1153",125,135,125,0,10,1
21-12-20,"62 - 1011",60,61,60,0,1,1
21-12-20,"3 - 1008",227,241,214,13,14,0.94273127753304
21-12-20,"16 - 1022",50,50,48,2,0,0.96
21-12-20,"24 - 1150",120,120,108,12,0,0.9
21-12-20,"24 - 1153",125,135,125,0,10,1
21-12-21,"62 - 1011",60,61,59,1,1,0.983333333333333
21-12-21,"3 - 1008",223,241,214,9,18,0.959641255605381
21-12-21,"16 - 1022",50,50,49,1,0,0.98
21-12-21,"24 - 1150",120,120,107,13,0,0.891666666666667
21-12-21,"24 - 1153",125,135,125,0,10,1
21-12-22,"62 - 1011",60,61,60,0,1,1
21-12-22,"3 - 1008",222,241,211,11,19,0.95045045045045
21-12-22,"16 - 1022",50,50,49,1,0,0.98
21-12-22,"24 - 1150",105,120,105,0,15,1
21-12-22,"24 - 1153",125,135,124,1,10,0.992
21-12-23,"62 - 1011",60,61,60,0,1,1
21-12-23,"3 - 1008",218,241,207,11,23,0.94954128440367
21-12-23,"16 - 1022",50,50,50,0,0,1
21-12-23,"24 - 1150",105,120,102,3,15,0.971428571428571
21-12-23,"24 - 1153",125,135,125,0,10,1
21-12-24,"62 - 1011",60,61,59,1,1,0.983333333333333
21-12-24,"3 - 1008",218,241,210,8,23,0.963302752293578
21-12-24,"16 - 1022",49,50,49,0,1,1
21-12-24,"24 - 1150",106,120,103,3,14,0.971698113207547
21-12-24,"24 - 1153",125,135,125,0,10,1
21-12-25,"62 - 1011",60,61,59,1,1,0.983333333333333
21-12-25,"3 - 1008",218,241,210,8,23,0.963302752293578
21-12-25,"16 - 1022",49,50,49,0,1,1
21-12-25,"24 - 1150",106,120,99,7,14,0.933962264150943
21-12-25,"24 - 1153",125,135,125,0,10,1
21-12-26,"62 - 1011",60,61,58,2,1,0.966666666666667
21-12-26,"3 - 1008",218,241,210,8,23,0.963302752293578
21-12-26,"16 - 1022",49,50,49,0,1,1
21-12-26,"24 - 1150",102,120,96,6,18,0.941176470588235
21-12-26,"24 - 1153",125,135,125,0,10,1
21-12-27,"62 - 1011",60,61,57,3,1,0.95
21-12-27,"3 - 1008",218,241,210,8,23,0.963302752293578
21-12-27,"16 - 1022",50,50,50,0,0,1
21-12-27,"24 - 1150",96,120,96,0,24,1
21-12-27,"24 - 1153",125,135,125,0,10,1
21-12-28,"62 - 1011",60,61,58,2,1,0.966666666666667
21-12-28,"3 - 1008",217,241,208,9,24,0.95852534562212
21-12-28,"16 - 1022",50,50,50,0,0,1
21-12-28,"24 - 1150",91,120,91,0,29,1
21-12-28,"24 - 1153",125,135,125,0,10,1
21-12-29,"62 - 1011",60,61,57,3,1,0.95
21-12-29,"3 - 1008",216,241,207,9,25,0.958333333333333
21-12-29,"16 - 1022",50,50,50,0,0,1
21-12-29,"24 - 1150",98,120,96,2,22,0.979591836734694
21-12-29,"24 - 1153",125,135,125,0,10,1
21-12-30,"62 - 1011",59,61,58,1,2,0.983050847457627
21-12-30,"3 - 1008",224,241,200,24,17,0.892857142857143
21-12-30,"16 - 1022",50,50,50,0,0,1
21-12-30,"24 - 1150",97,120,95,2,23,0.979381443298969
21-12-30,"24 - 1153",125,135,125,0,10,1
21-12-31,"62 - 1011",59,61,58,1,2,0.983050847457627
21-12-31,"3 - 1008",212,241,195,17,29,0.919811320754717
21-12-31,"16 - 1022",50,50,50,0,0,1
21-12-31,"24 - 1150",97,120,96,1,23,0.989690721649485
21-12-31,"24 - 1153",125,135,125,0,10,1
22-01-01,"62 - 1011",59,61,56,3,2,0.949152542372881
22-01-01,"3 - 1008",212,241,194,18,29,0.915094339622642
22-01-01,"16 - 1022",50,50,50,0,0,1
22-01-01,"24 - 1150",97,120,97,0,23,1
22-01-01,"24 - 1153",125,135,125,0,10,1
22-01-02,"62 - 1011",59,61,58,1,2,0.983050847457627
22-01-02,"3 - 1008",212,241,193,19,29,0.910377358490566
22-01-02,"16 - 1022",50,50,50,0,0,1
22-01-02,"24 - 1150",97,120,96,1,23,0.989690721649485
22-01-02,"24 - 1153",125,135,125,0,10,1
22-01-03,"62 - 1011",59,61,58,1,2,0.983050847457627
22-01-03,"3 - 1008",212,241,194,18,29,0.915094339622642
22-01-03,"16 - 1022",50,50,50,0,0,1
22-01-03,"24 - 1150",109,120,102,7,11,0.935779816513762
22-01-03,"24 - 1153",174,185,150,24,11,0.862068965517241
22-01-04,"62 - 1011",59,61,57,2,2,0.966101694915254
22-01-04,"3 - 1008",212,241,192,20,29,0.905660377358491
22-01-04,"16 - 1022",50,50,49,1,0,0.98
22-01-04,"24 - 1150",109,120,104,5,11,0.954128440366973
22-01-04,"24 - 1153",124,135,124,0,11,1
22-01-05,"62 - 1011",59,61,58,1,2,0.983050847457627
22-01-05,"3 - 1008",206,241,189,17,35,0.91747572815534
22-01-05,"16 - 1022",50,50,48,2,0,0.96
22-01-05,"24 - 1150",109,120,101,8,11,0.926605504587156
22-01-05,"24 - 1153",124,135,124,0,11,1
22-01-06,"62 - 1011",59,61,58,1,2,0.983050847457627
22-01-06,"3 - 1008",207,241,191,16,34,0.922705314009662
22-01-06,"16 - 1022",50,50,47,3,0,0.94
22-01-06,"24 - 1150",109,120,105,4,11,0.963302752293578
22-01-06,"24 - 1153",133,135,133,0,2,1
22-01-07,"62 - 1011",59,61,58,1,2,0.983050847457627
22-01-07,"3 - 1008",204,241,193,11,37,0.946078431372549
22-01-07,"16 - 1022",50,50,48,2,0,0.96
22-01-07,"24 - 1150",106,120,106,0,14,1
22-01-07,"24 - 1153",182,185,145,37,3,0.796703296703297
22-01-08,"62 - 1011",60,61,58,2,1,0.966666666666667
22-01-08,"3 - 1008",204,241,191,13,37,0.936274509803922
22-01-08,"16 - 1022",50,50,48,2,0,0.96
22-01-08,"24 - 1150",106,120,106,0,14,1
22-01-08,"24 - 1153",181,185,173,8,4,0.955801104972376
22-01-09,"62 - 1011",60,61,60,0,1,1
22-01-09,"3 - 1008",204,241,193,11,37,0.946078431372549
22-01-09,"16 - 1022",50,50,48,2,0,0.96
22-01-09,"24 - 1150",106,120,106,0,14,1
22-01-09,"24 - 1153",181,185,181,0,4,1
22-01-10,"62 - 1011",60,61,60,0,1,1
22-01-10,"3 - 1008",205,241,194,11,36,0.946341463414634
22-01-10,"16 - 1022",50,50,47,3,0,0.94
22-01-10,"24 - 1150",106,120,105,1,14,0.990566037735849
22-01-10,"24 - 1153",207,210,200,7,3,0.966183574879227
22-01-11,"62 - 1011",65,76,65,0,11,1
22-01-11,"3 - 1008",207,241,191,16,34,0.922705314009662
22-01-11,"16 - 1022",50,50,46,4,0,0.92
22-01-11,"24 - 1150",106,120,105,1,14,0.990566037735849
22-01-11,"24 - 1153",208,210,207,1,2,0.995192307692308
22-01-12,"62 - 1011",60,61,59,1,1,0.983333333333333
22-01-12,"3 - 1008",210,246,195,15,36,0.928571428571429
22-01-12,"16 - 1022",50,50,47,3,0,0.94
22-01-12,"24 - 1150",103,120,101,2,17,0.980582524271845
22-01-12,"24 - 1153",208,210,207,1,2,0.995192307692308
22-01-13,"62 - 1011",60,61,58,2,1,0.966666666666667
22-01-13,"3 - 1008",210,246,195,15,36,0.928571428571429
22-01-13,"16 - 1022",50,50,44,6,0,0.88
22-01-13,"24 - 1150",102,120,102,0,18,1
22-01-13,"24 - 1153",207,210,205,2,3,0.990338164251208
22-01-14,"62 - 1011",60,61,57,3,1,0.95
22-01-14,"3 - 1008",221,246,196,25,25,0.886877828054299
22-01-14,"16 - 1022",50,50,44,6,0,0.88
22-01-14,"24 - 1150",103,120,102,1,17,0.990291262135922
22-01-14,"24 - 1153",207,210,207,0,3,1
22-01-15,"62 - 1011",60,61,59,1,1,0.983333333333333
22-01-15,"3 - 1008",223,246,194,29,23,0.869955156950673
22-01-15,"16 - 1022",50,50,42,8,0,0.84
22-01-15,"24 - 1150",103,120,102,1,17,0.990291262135922
22-01-15,"24 - 1153",207,210,206,1,3,0.995169082125604
22-01-16,"62 - 1011",60,61,60,0,1,1
22-01-16,"3 - 1008",223,246,195,28,23,0.874439461883408
22-01-16,"16 - 1022",50,50,43,7,0,0.86
22-01-16,"24 - 1150",103,120,102,1,17,0.990291262135922
22-01-16,"24 - 1153",208,210,202,6,2,0.971153846153846
22-01-17,"62 - 1011",60,61,60,0,1,1
22-01-17,"3 - 1008",220,246,194,26,26,0.881818181818182
22-01-17,"16 - 1022",50,50,42,8,0,0.84
22-01-17,"24 - 1150",106,120,106,0,14,1
22-01-17,"24 - 1153",208,210,200,8,2,0.961538461538462
22-01-18,"62 - 1011",59,61,59,0,2,1
22-01-18,"3 - 1008",220,246,194,26,26,0.881818181818182
22-01-18,"16 - 1022",50,50,43,7,0,0.86
22-01-18,"24 - 1150",109,120,104,5,11,0.954128440366973
22-01-18,"24 - 1153",210,210,204,6,0,0.971428571428571
22-01-19,"62 - 1011",64,76,64,0,12,1
22-01-19,"3 - 1008",220,246,195,25,26,0.886363636363636
22-01-19,"16 - 1022",50,50,43,7,0,0.86
22-01-19,"24 - 1150",105,120,105,0,15,1
22-01-19,"24 - 1153",210,210,209,1,0,0.995238095238095
22-01-20,"62 - 1011",64,76,64,0,12,1
22-01-20,"3 - 1008",217,246,193,24,29,0.889400921658986
22-01-20,"16 - 1022",50,50,44,6,0,0.88
22-01-20,"24 - 1150",100,120,97,3,20,0.97
22-01-20,"24 - 1153",209,210,209,0,1,1
22-01-21,"62 - 1011",64,76,60,4,12,0.9375
22-01-21,"3 - 1008",216,246,194,22,30,0.898148148148148
22-01-21,"16 - 1022",50,50,44,6,0,0.88
22-01-21,"24 - 1150",101,120,99,2,19,0.98019801980198
22-01-21,"24 - 1153",210,210,209,1,0,0.995238095238095
22-01-22,"62 - 1011",64,76,62,2,12,0.96875
22-01-22,"3 - 1008",217,246,194,23,29,0.894009216589862
22-01-22,"16 - 1022",50,50,44,6,0,0.88
22-01-22,"24 - 1150",102,120,101,1,18,0.990196078431373
22-01-22,"24 - 1153",210,210,210,0,0,1
22-01-23,"62 - 1011",64,76,62,2,12,0.96875
22-01-23,"3 - 1008",210,246,192,18,36,0.914285714285714
22-01-23,"16 - 1022",50,50,45,5,0,0.9
22-01-23,"24 - 1150",107,120,107,0,13,1
22-01-23,"24 - 1153",210,210,208,2,0,0.990476190476191
22-01-24,"62 - 1011",64,76,62,2,12,0.96875
22-01-24,"3 - 1008",211,246,189,22,35,0.895734597156398
22-01-24,"16 - 1022",50,50,44,6,0,0.88
22-01-24,"24 - 1150",109,120,108,1,11,0.990825688073395
22-01-24,"24 - 1153",210,210,208,2,0,0.990476190476191
22-01-25,"62 - 1011",64,76,62,2,12,0.96875
22-01-25,"3 - 1008",194,246,188,6,52,0.969072164948454
22-01-25,"16 - 1022",50,50,45,5,0,0.9
22-01-25,"24 - 1150",108,120,104,4,12,0.962962962962963
22-01-25,"24 - 1153",210,210,209,1,0,0.995238095238095
22-01-26,"62 - 1011",64,76,63,1,12,0.984375
22-01-26,"3 - 1008",194,246,188,6,52,0.969072164948454
22-01-26,"16 - 1022",50,50,45,5,0,0.9
22-01-26,"24 - 1150",107,120,106,1,13,0.990654205607477
22-01-26,"24 - 1153",209,210,208,1,1,0.995215311004785
22-01-27,"62 - 1011",64,76,64,0,12,1
22-01-27,"3 - 1008",202,246,188,14,44,0.930693069306931
22-01-27,"16 - 1022",50,50,45,5,0,0.9
22-01-27,"24 - 1150",106,120,105,1,14,0.990566037735849
22-01-27,"24 - 1153",209,210,208,1,1,0.995215311004785
22-01-28,"62 - 1011",65,76,65,0,11,1
22-01-28,"3 - 1008",203,246,187,16,43,0.921182266009852
22-01-28,"16 - 1022",50,50,45,5,0,0.9
22-01-28,"24 - 1150",107,120,98,9,13,0.91588785046729
22-01-28,"24 - 1153",210,210,210,0,0,1
22-01-29,"62 - 1011",65,76,65,0,11,1
22-01-29,"3 - 1008",212,246,188,24,34,0.886792452830189
22-01-29,"16 - 1022",50,50,44,6,0,0.88
22-01-29,"24 - 1150",107,120,100,7,13,0.934579439252336
22-01-29,"24 - 1153",210,210,210,0,0,1
22-01-30,"62 - 1011",65,76,62,3,11,0.953846153846154
22-01-30,"3 - 1008",212,246,193,19,34,0.910377358490566
22-01-30,"16 - 1022",50,50,45,5,0,0.9
22-01-30,"24 - 1150",107,120,102,5,13,0.953271028037383
22-01-30,"24 - 1153",210,210,208,2,0,0.990476190476191
22-01-31,"62 - 1011",65,76,64,1,11,0.984615384615385
22-01-31,"3 - 1008",211,246,199,12,35,0.943127962085308
22-01-31,"16 - 1022",50,50,42,8,0,0.84
22-01-31,"24 - 1150",107,120,100,7,13,0.934579439252336
22-01-31,"24 - 1153",210,210,210,0,0,1
22-02-01,"62 - 1011",65,76,64,1,11,0.984615384615385
22-02-01,"3 - 1008",209,246,198,11,37,0.947368421052632
22-02-01,"16 - 1022",50,50,41,9,0,0.82
22-02-01,"24 - 1150",107,120,104,3,13,0.97196261682243
22-02-01,"24 - 1153",204,210,194,10,6,0.950980392156863
22-02-02,"62 - 1011",65,76,62,3,11,0.953846153846154
22-02-02,"3 - 1008",219,230,208,11,11,0.949771689497717
22-02-02,"16 - 1022",50,50,42,8,0,0.84
22-02-02,"24 - 1150",108,120,95,13,12,0.87962962962963
22-02-02,"24 - 1153",210,210,199,11,0,0.947619047619048
22-02-03,"62 - 1011",65,76,64,1,11,0.984615384615385
22-02-03,"3 - 1008",218,230,212,6,12,0.972477064220184
22-02-03,"16 - 1022",50,52,43,7,2,0.86
22-02-03,"24 - 1150",108,120,100,8,12,0.925925925925926
22-02-03,"24 - 1153",210,210,206,4,0,0.980952380952381
22-02-04,"62 - 1011",65,76,63,2,11,0.969230769230769
22-02-04,"3 - 1008",217,230,210,7,13,0.967741935483871
22-02-04,"16 - 1022",52,52,48,4,0,0.923076923076923
22-02-04,"24 - 1150",110,120,92,18,10,0.836363636363636
22-02-04,"24 - 1153",225,225,216,9,0,0.96
22-02-05,"62 - 1011",65,76,60,5,11,0.923076923076923
22-02-05,"3 - 1008",217,230,209,8,13,0.963133640552995
22-02-05,"16 - 1022",52,52,47,5,0,0.903846153846154
22-02-05,"24 - 1150",112,120,98,14,8,0.875
22-02-05,"24 - 1153",225,225,223,2,0,0.991111111111111
22-02-06,"62 - 1011",60,61,59,1,1,0.983333333333333
22-02-06,"3 - 1008",217,230,211,6,13,0.972350230414747
22-02-06,"16 - 1022",52,52,48,4,0,0.923076923076923
22-02-06,"24 - 1150",116,120,99,17,4,0.853448275862069
22-02-06,"24 - 1153",225,225,224,1,0,0.995555555555556
22-02-07,"62 - 1011",61,76,60,1,15,0.983606557377049
22-02-07,"3 - 1008",219,230,210,9,11,0.958904109589041
22-02-07,"16 - 1022",51,52,47,4,1,0.92156862745098
22-02-07,"24 - 1150",116,120,101,15,4,0.870689655172414
22-02-07,"24 - 1153",225,225,224,1,0,0.995555555555556
22-02-08,"62 - 1011",60,61,60,0,1,1
22-02-08,"3 - 1008",218,230,212,6,12,0.972477064220184
22-02-08,"16 - 1022",50,52,46,4,2,0.92
22-02-08,"24 - 1150",106,120,105,1,14,0.990566037735849
22-02-08,"24 - 1153",210,225,209,1,15,0.995238095238095
22-02-09,"62 - 1011",60,61,60,0,1,1
22-02-09,"3 - 1008",218,230,213,5,12,0.977064220183486
22-02-09,"16 - 1022",50,52,49,1,2,0.98
22-02-09,"24 - 1150",105,120,105,0,15,1
22-02-09,"24 - 1153",210,225,210,0,15,1
22-02-10,"62 - 1011",60,61,60,0,1,1
22-02-10,"3 - 1008",218,230,209,9,12,0.958715596330275
22-02-10,"16 - 1022",50,52,49,1,2,0.98
22-02-10,"24 - 1150",106,120,97,9,14,0.915094339622642
22-02-10,"24 - 1153",210,225,210,0,15,1
22-02-11,"62 - 1011",60,61,60,0,1,1
22-02-11,"3 - 1008",218,230,210,8,12,0.963302752293578
22-02-11,"16 - 1022",50,52,48,2,2,0.96
22-02-11,"24 - 1150",106,120,99,7,14,0.933962264150943
22-02-11,"24 - 1153",210,225,210,0,15,1
22-02-12,"62 - 1011",65,76,62,3,11,0.953846153846154
22-02-12,"3 - 1008",218,230,208,10,12,0.954128440366973
22-02-12,"16 - 1022",50,52,48,2,2,0.96
22-02-12,"24 - 1150",108,120,107,1,12,0.990740740740741
22-02-12,"24 - 1153",210,225,209,1,15,0.995238095238095
22-02-13,"62 - 1011",65,76,65,0,11,1
22-02-13,"3 - 1008",219,230,211,8,11,0.963470319634703
22-02-13,"16 - 1022",50,52,48,2,2,0.96
22-02-13,"24 - 1150",110,120,110,0,10,1
22-02-13,"24 - 1153",210,225,210,0,15,1
22-02-14,"62 - 1011",65,76,64,1,11,0.984615384615385
22-02-14,"3 - 1008",219,230,209,10,11,0.954337899543379
22-02-14,"16 - 1022",52,52,47,5,0,0.903846153846154
22-02-14,"24 - 1150",110,120,110,0,10,1
22-02-14,"24 - 1153",210,225,210,0,15,1
22-02-15,"62 - 1011",65,76,64,1,11,0.984615384615385
22-02-15,"3 - 1008",220,230,214,6,10,0.972727272727273
22-02-15,"16 - 1022",50,52,48,2,2,0.96
22-02-15,"24 - 1150",108,120,106,2,12,0.981481481481482
22-02-15,"24 - 1153",210,225,210,0,15,1
22-02-16,"62 - 1011",65,76,64,1,11,0.984615384615385
22-02-16,"3 - 1008",230,240,220,10,10,0.956521739130435
22-02-16,"16 - 1022",50,52,48,2,2,0.96
22-02-16,"24 - 1150",106,120,103,3,14,0.971698113207547
22-02-16,"24 - 1153",210,225,209,1,15,0.995238095238095
22-02-17,"62 - 1011",65,76,65,0,11,1
22-02-17,"3 - 1008",230,240,224,6,10,0.973913043478261
22-02-17,"16 - 1022",50,52,50,0,2,1
22-02-17,"24 - 1150",104,120,101,3,16,0.971153846153846
22-02-17,"24 - 1153",210,225,210,0,15,1
22-02-18,"62 - 1011",65,76,65,0,11,1
22-02-18,"3 - 1008",230,240,225,5,10,0.978260869565217
22-02-18,"16 - 1022",50,52,50,0,2,1
22-02-18,"24 - 1150",104,120,104,0,16,1
22-02-18,"24 - 1153",210,225,210,0,15,1
22-02-19,"62 - 1011",65,76,65,0,11,1
22-02-19,"3 - 1008",230,240,225,5,10,0.978260869565217
22-02-19,"16 - 1022",50,52,49,1,2,0.98
22-02-19,"24 - 1150",106,120,105,1,14,0.990566037735849
22-02-19,"24 - 1153",210,225,210,0,15,1
22-02-20,"62 - 1011",63,76,63,0,13,1
22-02-20,"3 - 1008",230,240,225,5,10,0.978260869565217
22-02-20,"16 - 1022",50,52,50,0,2,1
22-02-20,"24 - 1150",106,120,104,2,14,0.981132075471698
22-02-20,"24 - 1153",210,225,209,1,15,0.995238095238095
22-02-21,"62 - 1011",65,76,65,0,11,1
22-02-21,"3 - 1008",230,240,223,7,10,0.969565217391304
22-02-21,"16 - 1022",50,52,49,1,2,0.98
22-02-21,"24 - 1150",110,120,107,3,10,0.972727272727273
22-02-21,"24 - 1153",210,225,210,0,15,1
22-02-22,"62 - 1011",65,76,63,2,11,0.969230769230769
22-02-22,"3 - 1008",230,240,224,6,10,0.973913043478261
22-02-22,"16 - 1022",50,52,49,1,2,0.98
22-02-22,"24 - 1150",110,120,109,1,10,0.990909090909091
22-02-22,"24 - 1153",210,225,207,3,15,0.985714285714286
22-02-23,"62 - 1011",65,76,64,1,11,0.984615384615385
22-02-23,"3 - 1008",230,240,224,6,10,0.973913043478261
22-02-23,"16 - 1022",50,52,47,3,2,0.94
22-02-23,"24 - 1150",110,120,109,1,10,0.990909090909091
22-02-23,"24 - 1153",210,225,208,2,15,0.990476190476191
22-02-24,"62 - 1011",65,76,62,3,11,0.953846153846154
22-02-24,"3 - 1008",230,240,221,9,10,0.960869565217391
22-02-24,"16 - 1022",50,52,46,4,2,0.92
22-02-24,"24 - 1150",110,120,110,0,10,1
22-02-24,"24 - 1153",210,225,210,0,15,1
22-02-25,"62 - 1011",65,76,63,2,11,0.969230769230769
22-02-25,"3 - 1008",230,240,223,7,10,0.969565217391304
22-02-25,"16 - 1022",52,52,49,3,0,0.942307692307692
22-02-25,"24 - 1150",110,120,109,1,10,0.990909090909091
22-02-25,"24 - 1153",210,225,207,3,15,0.985714285714286
22-02-26,"62 - 1011",65,76,63,2,11,0.969230769230769
22-02-26,"3 - 1008",230,240,223,7,10,0.969565217391304
22-02-26,"16 - 1022",52,52,49,3,0,0.942307692307692
22-02-26,"24 - 1150",110,120,108,2,10,0.981818181818182
22-02-26,"24 - 1153",210,225,207,3,15,0.985714285714286
22-02-27,"62 - 1011",65,76,63,2,11,0.969230769230769
22-02-27,"3 - 1008",230,240,223,7,10,0.969565217391304
22-02-27,"16 - 1022",52,52,48,4,0,0.923076923076923
22-02-27,"24 - 1150",110,120,109,1,10,0.990909090909091
22-02-27,"24 - 1153",210,225,207,3,15,0.985714285714286
22-02-28,"62 - 1011",65,76,65,0,11,1
22-02-28,"3 - 1008",229,240,222,7,11,0.96943231441048
22-02-28,"16 - 1022",52,52,50,2,0,0.961538461538462
22-02-28,"24 - 1150",110,120,109,1,10,0.990909090909091
22-02-28,"24 - 1153",210,225,210,0,15,1
22-03-01,"62 - 1011",65,76,64,1,11,0.984615384615385
22-03-01,"3 - 1008",229,240,223,6,11,0.973799126637555
22-03-01,"16 - 1022",50,52,47,3,2,0.94
22-03-01,"24 - 1150",110,120,105,5,10,0.954545454545455
22-03-01,"24 - 1153",210,225,208,2,15,0.990476190476191
22-03-02,"62 - 1011",65,76,65,0,11,1
22-03-02,"3 - 1008",229,240,224,5,11,0.978165938864629
22-03-02,"16 - 1022",50,52,49,1,2,0.98
22-03-02,"24 - 1150",110,120,110,0,10,1
22-03-02,"24 - 1153",210,225,209,1,15,0.995238095238095
22-03-03,"62 - 1011",65,76,65,0,11,1
22-03-03,"3 - 1008",230,240,227,3,10,0.98695652173913
22-03-03,"16 - 1022",50,52,49,1,2,0.98
22-03-03,"24 - 1150",110,120,108,2,10,0.981818181818182
22-03-03,"24 - 1153",210,225,210,0,15,1
22-03-04,"62 - 1011",65,76,65,0,11,1
22-03-04,"3 - 1008",230,240,226,4,10,0.982608695652174
22-03-04,"16 - 1022",50,52,50,0,2,1
22-03-04,"24 - 1150",109,120,107,2,11,0.981651376146789
22-03-04,"24 - 1153",210,225,209,1,15,0.995238095238095
22-03-05,"62 - 1011",65,76,65,0,11,1
22-03-05,"3 - 1008",230,240,227,3,10,0.98695652173913
22-03-05,"16 - 1022",50,52,49,1,2,0.98
22-03-05,"24 - 1150",108,120,107,1,12,0.990740740740741
22-03-05,"24 - 1153",210,225,209,1,15,0.995238095238095
22-03-06,"62 - 1011",65,76,65,0,11,1
22-03-06,"3 - 1008",230,240,226,4,10,0.982608695652174
22-03-06,"16 - 1022",50,52,49,1,2,0.98
22-03-06,"24 - 1150",108,120,107,1,12,0.990740740740741
22-03-06,"24 - 1153",210,225,210,0,15,1
22-03-07,"62 - 1011",61,76,61,0,15,1
22-03-07,"3 - 1008",220,230,217,3,10,0.986363636363636
22-03-07,"16 - 1022",50,52,49,1,2,0.98
22-03-07,"24 - 1150",108,120,106,2,12,0.981481481481482
22-03-07,"24 - 1153",210,225,186,24,15,0.885714285714286
22-03-08,"62 - 1011",61,76,60,1,15,0.983606557377049
22-03-08,"3 - 1008",220,230,215,5,10,0.977272727272727
22-03-08,"16 - 1022",50,52,48,2,2,0.96
22-03-08,"24 - 1150",108,120,106,2,12,0.981481481481482
22-03-08,"24 - 1153",150,165,150,0,15,1
22-03-09,"62 - 1011",61,76,60,1,15,0.983606557377049
22-03-09,"3 - 1008",220,230,217,3,10,0.986363636363636
22-03-09,"16 - 1022",50,52,49,1,2,0.98
22-03-09,"24 - 1150",108,120,106,2,12,0.981481481481482
22-03-09,"24 - 1153",210,225,180,30,15,0.857142857142857
22-03-10,"62 - 1011",60,61,60,0,1,1
22-03-10,"3 - 1008",222,230,217,5,8,0.977477477477477
22-03-10,"16 - 1022",50,52,49,1,2,0.98
22-03-10,"24 - 1150",108,120,108,0,12,1
22-03-10,"24 - 1153",210,225,208,2,15,0.990476190476191
22-03-11,"62 - 1011",60,61,60,0,1,1
22-03-11,"3 - 1008",240,240,226,14,0,0.941666666666667
22-03-11,"16 - 1022",52,52,51,1,0,0.980769230769231
22-03-11,"24 - 1150",108,120,106,2,12,0.981481481481482
22-03-11,"24 - 1153",225,225,212,13,0,0.942222222222222
22-03-12,"62 - 1011",65,76,65,0,11,1
22-03-12,"3 - 1008",240,240,226,14,0,0.941666666666667
22-03-12,"16 - 1022",52,52,51,1,0,0.980769230769231
22-03-12,"24 - 1150",108,120,106,2,12,0.981481481481482
22-03-12,"24 - 1153",225,225,222,3,0,0.986666666666667
22-03-13,"62 - 1011",65,76,65,0,11,1
22-03-13,"3 - 1008",240,240,233,7,0,0.970833333333333
22-03-13,"16 - 1022",52,52,50,2,0,0.961538461538462
22-03-13,"24 - 1150",108,120,107,1,12,0.990740740740741
22-03-13,"24 - 1153",225,225,225,0,0,1
22-03-14,"62 - 1011",65,76,65,0,11,1
22-03-14,"3 - 1008",239,240,231,8,1,0.96652719665272
22-03-14,"16 - 1022",52,52,51,1,0,0.980769230769231
22-03-14,"24 - 1150",108,120,108,0,12,1
22-03-14,"24 - 1153",225,225,224,1,0,0.995555555555556
22-03-15,"62 - 1011",60,61,60,0,1,1
22-03-15,"3 - 1008",237,240,229,8,3,0.966244725738397
22-03-15,"16 - 1022",52,52,51,1,0,0.980769230769231
22-03-15,"24 - 1150",107,120,107,0,13,1
22-03-15,"24 - 1153",225,225,224,1,0,0.995555555555556
22-03-16,"62 - 1011",65,76,61,4,11,0.938461538461538
22-03-16,"3 - 1008",229,230,223,6,1,0.973799126637555
22-03-16,"16 - 1022",52,52,50,2,0,0.961538461538462
22-03-16,"24 - 1150",108,120,106,2,12,0.981481481481482
22-03-16,"24 - 1153",223,225,222,1,2,0.995515695067265
22-03-17,"62 - 1011",60,60,60,0,0,1
22-03-17,"3 - 1008",230,230,220,10,0,0.956521739130435
22-03-17,"16 - 1022",52,52,50,2,0,0.961538461538462
22-03-17,"24 - 1150",108,120,108,0,12,1
22-03-17,"24 - 1153",222,225,220,2,3,0.990990990990991
22-03-18,"62 - 1011",60,60,60,0,0,1
22-03-18,"3 - 1008",230,230,221,9,0,0.960869565217391
22-03-18,"16 - 1022",52,52,51,1,0,0.980769230769231
22-03-18,"24 - 1150",108,120,106,2,12,0.981481481481482
22-03-18,"24 - 1153",225,225,223,2,0,0.991111111111111
22-03-19,"62 - 1011",60,60,60,0,0,1
22-03-19,"3 - 1008",230,230,221,9,0,0.960869565217391
22-03-19,"16 - 1022",52,52,51,1,0,0.980769230769231
22-03-19,"24 - 1150",108,120,108,0,12,1
22-03-19,"24 - 1153",225,225,224,1,0,0.995555555555556
22-03-20,"62 - 1011",60,60,60,0,0,1
22-03-20,"3 - 1008",230,230,221,9,0,0.960869565217391
22-03-20,"16 - 1022",52,52,50,2,0,0.961538461538462
22-03-20,"24 - 1150",108,120,108,0,12,1
22-03-20,"24 - 1153",225,225,224,1,0,0.995555555555556
22-03-21,"62 - 1011",65,65,61,4,0,0.938461538461538
22-03-21,"3 - 1008",230,230,221,9,0,0.960869565217391
22-03-21,"16 - 1022",52,52,51,1,0,0.980769230769231
22-03-21,"24 - 1150",107,120,106,1,13,0.990654205607477
22-03-21,"24 - 1153",224,225,224,0,1,1
22-03-22,"62 - 1011",60,60,60,0,0,1
22-03-22,"3 - 1008",229,230,219,10,1,0.956331877729258
22-03-22,"16 - 1022",52,52,52,0,0,1
22-03-22,"24 - 1150",108,120,108,0,12,1
22-03-22,"24 - 1153",225,225,221,4,0,0.982222222222222
22-03-23,"62 - 1011",60,60,60,0,0,1
22-03-23,"3 - 1008",230,230,219,11,0,0.952173913043478
22-03-23,"16 - 1022",52,52,51,1,0,0.980769230769231
22-03-23,"24 - 1150",106,120,105,1,14,0.990566037735849
22-03-23,"24 - 1153",225,225,225,0,0,1
22-03-24,"62 - 1011",60,60,60,0,0,1
22-03-24,"3 - 1008",230,230,219,11,0,0.952173913043478
22-03-24,"16 - 1022",52,52,51,1,0,0.980769230769231
22-03-24,"24 - 1150",110,120,110,0,10,1
22-03-24,"24 - 1153",224,225,223,1,1,0.995535714285714
22-03-25,"62 - 1011",65,65,65,0,0,1
22-03-25,"3 - 1008",240,240,229,11,0,0.954166666666667
22-03-25,"16 - 1022",50,52,48,2,2,0.96
22-03-25,"24 - 1150",109,120,108,1,11,0.990825688073395
22-03-25,"24 - 1153",225,225,224,1,0,0.995555555555556
22-03-26,"62 - 1011",65,65,62,3,0,0.953846153846154
22-03-26,"3 - 1008",240,240,230,10,0,0.958333333333333
22-03-26,"16 - 1022",50,52,49,1,2,0.98
22-03-26,"24 - 1150",106,120,106,0,14,1
22-03-26,"24 - 1153",223,225,223,0,2,1
22-03-27,"62 - 1011",65,65,64,1,0,0.984615384615385
22-03-27,"3 - 1008",240,240,228,12,0,0.95
22-03-27,"16 - 1022",50,52,48,2,2,0.96
22-03-27,"24 - 1150",104,120,104,0,16,1
22-03-27,"24 - 1153",223,225,223,0,2,1
22-03-28,"62 - 1011",65,65,64,1,0,0.984615384615385
22-03-28,"3 - 1008",240,240,230,10,0,0.958333333333333
22-03-28,"16 - 1022",50,52,48,2,2,0.96
22-03-28,"24 - 1150",99,120,99,0,21,1
22-03-28,"24 - 1153",225,225,225,0,0,1
22-03-29,"62 - 1011",65,65,65,0,0,1
22-03-29,"3 - 1008",240,240,228,12,0,0.95
22-03-29,"16 - 1022",50,52,50,0,2,1
22-03-29,"24 - 1150",94,120,93,1,26,0.98936170212766
22-03-29,"24 - 1153",225,225,225,0,0,1
22-03-30,"62 - 1011",61,65,61,0,4,1
22-03-30,"3 - 1008",230,230,218,12,0,0.947826086956522
22-03-30,"16 - 1022",50,52,50,0,2,1
22-03-30,"24 - 1150",100,120,95,5,20,0.95
22-03-30,"24 - 1153",225,225,225,0,0,1
22-03-31,"62 - 1011",60,60,60,0,0,1
22-03-31,"3 - 1008",230,230,218,12,0,0.947826086956522
22-03-31,"16 - 1022",50,52,50,0,2,1
22-03-31,"24 - 1150",100,120,96,4,20,0.96
22-03-31,"24 - 1153",224,225,222,2,1,0.991071428571429
22-04-01,"62 - 1011",60,60,59,1,0,0.983333333333333
22-04-01,"3 - 1008",230,230,218,12,0,0.947826086956522
22-04-01,"16 - 1022",50,52,50,0,2,1
22-04-01,"24 - 1150",100,120,98,2,20,0.98
22-04-01,"24 - 1153",225,225,222,3,0,0.986666666666667
22-04-02,"62 - 1011",65,65,61,4,0,0.938461538461538
22-04-02,"3 - 1008",239,240,225,14,1,0.941422594142259
22-04-02,"16 - 1022",50,52,49,1,2,0.98
22-04-02,"24 - 1150",99,120,98,1,21,0.98989898989899
22-04-02,"24 - 1153",225,225,223,2,0,0.991111111111111
22-04-03,"62 - 1011",65,65,64,1,0,0.984615384615385
22-04-03,"3 - 1008",239,240,226,13,1,0.945606694560669
22-04-03,"16 - 1022",50,52,49,1,2,0.98
22-04-03,"24 - 1150",100,120,96,4,20,0.96
22-04-03,"24 - 1153",225,225,222,3,0,0.986666666666667
22-04-04,"62 - 1011",60,60,59,1,0,0.983333333333333
22-04-04,"3 - 1008",239,240,226,13,1,0.945606694560669
22-04-04,"16 - 1022",50,52,49,1,2,0.98
22-04-04,"24 - 1150",101,120,99,2,19,0.98019801980198
22-04-04,"24 - 1153",229,240,228,1,11,0.995633187772926
22-04-05,"62 - 1011",60,60,59,1,0,0.983333333333333
22-04-05,"3 - 1008",238,240,213,25,2,0.894957983193277
22-04-05,"16 - 1022",50,52,48,2,2,0.96
22-04-05,"24 - 1150",97,120,95,2,23,0.979381443298969
22-04-05,"24 - 1153",231,240,229,2,9,0.991341991341991
22-04-06,"62 - 1011",60,60,59,1,0,0.983333333333333
22-04-06,"3 - 1008",238,240,220,18,2,0.92436974789916
22-04-06,"16 - 1022",50,52,49,1,2,0.98
22-04-06,"24 - 1150",97,120,95,2,23,0.979381443298969
22-04-06,"24 - 1153",238,240,233,5,2,0.978991596638655
22-04-07,"62 - 1011",60,60,59,1,0,0.983333333333333
22-04-07,"3 - 1008",230,230,215,15,0,0.934782608695652
22-04-07,"16 - 1022",50,52,48,2,2,0.96
22-04-07,"24 - 1150",100,120,100,0,20,1
22-04-07,"24 - 1153",240,240,238,2,0,0.991666666666667
22-04-08,"62 - 1011",60,60,60,0,0,1
22-04-08,"3 - 1008",229,230,214,15,1,0.934497816593886
22-04-08,"16 - 1022",50,52,50,0,2,1
22-04-08,"24 - 1150",100,120,99,1,20,0.99
22-04-08,"24 - 1153",240,240,239,1,0,0.995833333333333
22-04-09,"62 - 1011",65,65,65,0,0,1
22-04-09,"3 - 1008",239,240,225,14,1,0.941422594142259
22-04-09,"16 - 1022",50,52,50,0,2,1
22-04-09,"24 - 1150",100,120,100,0,20,1
22-04-09,"24 - 1153",240,240,240,0,0,1
22-04-10,"62 - 1011",65,65,65,0,0,1
22-04-10,"3 - 1008",239,240,224,15,1,0.937238493723849
22-04-10,"16 - 1022",50,52,50,0,2,1
22-04-10,"24 - 1150",100,120,99,1,20,0.99
22-04-10,"24 - 1153",240,240,240,0,0,1
22-04-11,"62 - 1011",60,60,60,0,0,1
22-04-11,"3 - 1008",229,230,213,16,1,0.930131004366812
22-04-11,"16 - 1022",50,52,49,1,2,0.98
22-04-11,"24 - 1150",100,120,98,2,20,0.98
22-04-11,"24 - 1153",240,240,239,1,0,0.995833333333333
22-04-12,"62 - 1011",60,60,60,0,0,1
22-04-12,"3 - 1008",229,230,213,16,1,0.930131004366812
22-04-12,"16 - 1022",50,52,50,0,2,1
22-04-12,"24 - 1150",100,120,98,2,20,0.98
22-04-12,"24 - 1153",240,240,240,0,0,1
22-04-13,"62 - 1011",60,60,60,0,0,1
22-04-13,"3 - 1008",229,230,213,16,1,0.930131004366812
22-04-13,"16 - 1022",50,52,48,2,2,0.96
22-04-13,"24 - 1150",100,120,98,2,20,0.98
22-04-13,"24 - 1153",240,240,239,1,0,0.995833333333333
22-04-14,"62 - 1011",60,60,59,1,0,0.983333333333333
22-04-14,"3 - 1008",229,230,213,16,1,0.930131004366812
22-04-14,"16 - 1022",50,52,48,2,2,0.96
22-04-14,"24 - 1150",100,120,98,2,20,0.98
22-04-14,"24 - 1153",240,240,240,0,0,1
22-04-15,"62 - 1011",60,60,59,1,0,0.983333333333333
22-04-15,"3 - 1008",240,240,222,18,0,0.925
22-04-15,"16 - 1022",50,52,49,1,2,0.98
22-04-15,"24 - 1150",100,120,100,0,20,1
22-04-15,"24 - 1153",240,240,238,2,0,0.991666666666667
22-04-16,"62 - 1011",65,65,63,2,0,0.969230769230769
22-04-16,"3 - 1008",240,240,224,16,0,0.933333333333333
22-04-16,"16 - 1022",50,52,49,1,2,0.98
22-04-16,"24 - 1150",99,120,98,1,21,0.98989898989899
22-04-16,"24 - 1153",240,240,240,0,0,1
22-04-17,"62 - 1011",65,65,64,1,0,0.984615384615385
22-04-17,"3 - 1008",240,240,224,16,0,0.933333333333333
22-04-17,"16 - 1022",50,52,49,1,2,0.98
22-04-17,"24 - 1150",98,120,97,1,22,0.989795918367347
22-04-17,"24 - 1153",240,240,239,1,0,0.995833333333333
22-04-18,"62 - 1011",65,65,65,0,0,1
22-04-18,"3 - 1008",240,240,225,15,0,0.9375
22-04-18,"16 - 1022",50,52,50,0,2,1
22-04-18,"24 - 1150",98,120,96,2,22,0.979591836734694
22-04-18,"24 - 1153",240,240,239,1,0,0.995833333333333
22-04-19,"62 - 1011",65,65,65,0,0,1
22-04-19,"3 - 1008",240,240,227,13,0,0.945833333333333
22-04-19,"16 - 1022",50,52,49,1,2,0.98
22-04-19,"24 - 1150",100,120,97,3,20,0.97
22-04-19,"24 - 1153",240,240,240,0,0,1
22-04-20,"62 - 1011",60,60,60,0,0,1
22-04-20,"3 - 1008",230,230,220,10,0,0.956521739130435
22-04-20,"16 - 1022",50,52,48,2,2,0.96
22-04-20,"24 - 1150",98,120,98,0,22,1
22-04-20,"24 - 1153",240,240,240,0,0,1
22-04-21,"62 - 1011",60,60,60,0,0,1
22-04-21,"3 - 1008",230,230,221,9,0,0.960869565217391
22-04-21,"16 - 1022",50,52,49,1,2,0.98
22-04-21,"24 - 1150",100,120,96,4,20,0.96
22-04-21,"24 - 1153",240,240,240,0,0,1
22-04-22,"62 - 1011",60,60,60,0,0,1
22-04-22,"3 - 1008",230,230,222,8,0,0.965217391304348
22-04-22,"16 - 1022",49,52,49,0,3,1
22-04-22,"24 - 1150",97,120,96,1,23,0.989690721649485
22-04-22,"24 - 1153",239,240,239,0,1,1
22-04-23,"62 - 1011",60,60,60,0,0,1
22-04-23,"3 - 1008",230,230,221,9,0,0.960869565217391
22-04-23,"16 - 1022",49,52,48,1,3,0.979591836734694
22-04-23,"24 - 1150",97,120,95,2,23,0.979381443298969
22-04-23,"24 - 1153",239,240,239,0,1,1
22-04-24,"62 - 1011",60,60,60,0,0,1
22-04-24,"3 - 1008",230,230,222,8,0,0.965217391304348
22-04-24,"16 - 1022",49,52,47,2,3,0.959183673469388
22-04-24,"24 - 1150",98,120,93,5,22,0.948979591836735
22-04-24,"24 - 1153",238,240,238,0,2,1
22-04-25,"62 - 1011",60,60,60,0,0,1
22-04-25,"3 - 1008",230,230,222,8,0,0.965217391304348
22-04-25,"16 - 1022",49,50,47,2,1,0.959183673469388
22-04-25,"24 - 1150",100,120,98,2,20,0.98
22-04-25,"24 - 1153",240,240,238,2,0,0.991666666666667
22-04-26,"62 - 1011",60,60,60,0,0,1
22-04-26,"3 - 1008",229,230,222,7,1,0.96943231441048
22-04-26,"16 - 1022",49,50,48,1,1,0.979591836734694
22-04-26,"24 - 1150",100,120,94,6,20,0.94
22-04-26,"24 - 1153",240,240,239,1,0,0.995833333333333
22-04-27,"62 - 1011",65,65,65,0,0,1
22-04-27,"3 - 1008",239,240,231,8,1,0.96652719665272
22-04-27,"16 - 1022",49,50,48,1,1,0.979591836734694
22-04-27,"24 - 1150",100,120,96,4,20,0.96
22-04-27,"24 - 1153",240,240,240,0,0,1
22-04-28,"62 - 1011",65,65,63,2,0,0.969230769230769
22-04-28,"3 - 1008",238,240,230,8,2,0.966386554621849
22-04-28,"16 - 1022",49,50,45,4,1,0.918367346938776
22-04-28,"24 - 1150",100,120,96,4,20,0.96
22-04-28,"24 - 1153",240,240,239,1,0,0.995833333333333
22-04-29,"62 - 1011",60,60,60,0,0,1
22-04-29,"3 - 1008",228,230,219,9,2,0.960526315789474
22-04-29,"16 - 1022",49,50,47,2,1,0.959183673469388
22-04-29,"24 - 1150",100,120,98,2,20,0.98
22-04-29,"24 - 1153",240,240,239,1,0,0.995833333333333
22-04-30,"62 - 1011",60,60,59,1,0,0.983333333333333
22-04-30,"3 - 1008",223,230,213,10,7,0.955156950672646
22-04-30,"16 - 1022",49,50,45,4,1,0.918367346938776
22-04-30,"24 - 1150",100,120,99,1,20,0.99
22-04-30,"24 - 1153",240,240,240,0,0,1
22-05-01,"62 - 1011",60,60,55,5,0,0.916666666666667
22-05-01,"3 - 1008",223,230,211,12,7,0.946188340807175
22-05-01,"16 - 1022",49,50,45,4,1,0.918367346938776
22-05-01,"24 - 1150",100,120,95,5,20,0.95
22-05-01,"24 - 1153",240,240,239,1,0,0.995833333333333
22-05-02,"62 - 1011",60,60,54,6,0,0.9
22-05-02,"3 - 1008",220,230,211,9,10,0.959090909090909
22-05-02,"16 - 1022",50,50,46,4,0,0.92
22-05-02,"24 - 1150",100,120,100,0,20,1
22-05-02,"24 - 1153",240,240,240,0,0,1
22-05-03,"62 - 1011",60,60,56,4,0,0.933333333333333
22-05-03,"3 - 1008",208,230,205,3,22,0.985576923076923
22-05-03,"16 - 1022",50,50,48,2,0,0.96
22-05-03,"24 - 1150",100,120,96,4,20,0.96
22-05-03,"24 - 1153",240,240,240,0,0,1
22-05-04,"62 - 1011",60,60,57,3,0,0.95
22-05-04,"3 - 1008",203,230,200,3,27,0.985221674876847
22-05-04,"16 - 1022",50,50,47,3,0,0.94
22-05-04,"24 - 1150",100,120,99,1,20,0.99
22-05-04,"24 - 1153",240,240,240,0,0,1
22-05-05,"62 - 1011",60,60,58,2,0,0.966666666666667
22-05-05,"3 - 1008",200,230,199,1,30,0.995
22-05-05,"16 - 1022",50,50,45,5,0,0.9
22-05-05,"24 - 1150",100,120,100,0,20,1
22-05-05,"24 - 1153",240,240,239,1,0,0.995833333333333
22-05-06,"62 - 1011",60,60,57,3,0,0.95
22-05-06,"3 - 1008",201,230,201,0,29,1
22-05-06,"16 - 1022",50,50,47,3,0,0.94
22-05-06,"24 - 1150",100,120,98,2,20,0.98
22-05-06,"24 - 1153",240,240,240,0,0,1
22-05-07,"62 - 1011",60,60,57,3,0,0.95
22-05-07,"3 - 1008",200,230,200,0,30,1
22-05-07,"16 - 1022",50,50,47,3,0,0.94
22-05-07,"24 - 1150",100,120,100,0,20,1
22-05-07,"24 - 1153",240,240,239,1,0,0.995833333333333
22-05-08,"62 - 1011",60,60,58,2,0,0.966666666666667
22-05-08,"3 - 1008",198,230,198,0,32,1
22-05-08,"16 - 1022",50,50,46,4,0,0.92
22-05-08,"24 - 1150",100,120,98,2,20,0.98
22-05-08,"24 - 1153",240,240,238,2,0,0.991666666666667
22-05-09,"62 - 1011",60,60,58,2,0,0.966666666666667
22-05-09,"3 - 1008",198,230,196,2,32,0.98989898989899
22-05-09,"16 - 1022",50,50,46,4,0,0.92
22-05-09,"24 - 1150",100,120,100,0,20,1
22-05-09,"24 - 1153",240,240,240,0,0,1
22-05-10,"62 - 1011",60,60,58,2,0,0.966666666666667
22-05-10,"3 - 1008",195,230,194,1,35,0.994871794871795
22-05-10,"16 - 1022",50,50,45,5,0,0.9
22-05-10,"24 - 1150",100,120,100,0,20,1
22-05-10,"24 - 1153",240,240,240,0,0,1
22-05-11,"62 - 1011",60,60,59,1,0,0.983333333333333
22-05-11,"3 - 1008",196,230,195,1,34,0.994897959183674
22-05-11,"16 - 1022",50,50,48,2,0,0.96
22-05-11,"24 - 1150",100,120,100,0,20,1
22-05-11,"24 - 1153",240,240,240,0,0,1
22-05-12,"62 - 1011",60,60,60,0,0,1
22-05-12,"3 - 1008",196,230,195,1,34,0.994897959183674
22-05-12,"16 - 1022",50,50,49,1,0,0.98
22-05-12,"24 - 1150",100,120,93,7,20,0.93
22-05-12,"24 - 1153",240,240,239,1,0,0.995833333333333
22-05-13,"62 - 1011",60,60,60,0,0,1
22-05-13,"3 - 1008",195,230,192,3,35,0.984615384615385
22-05-13,"16 - 1022",50,50,49,1,0,0.98
22-05-13,"24 - 1150",95,120,95,0,25,1
22-05-13,"24 - 1153",237,240,237,0,3,1
22-05-14,"62 - 1011",60,60,60,0,0,1
22-05-14,"3 - 1008",193,230,189,4,37,0.979274611398964
22-05-14,"16 - 1022",50,50,47,3,0,0.94
22-05-14,"24 - 1150",96,120,94,2,24,0.979166666666667
22-05-14,"24 - 1153",236,240,235,1,4,0.995762711864407
22-05-15,"62 - 1011",60,60,60,0,0,1
22-05-15,"3 - 1008",197,230,192,5,33,0.974619289340102
22-05-15,"16 - 1022",50,50,48,2,0,0.96
22-05-15,"24 - 1150",96,120,96,0,24,1
22-05-15,"24 - 1153",232,240,232,0,8,1
22-05-16,"62 - 1011",60,60,60,0,0,1
22-05-16,"3 - 1008",191,230,190,1,39,0.994764397905759
22-05-16,"16 - 1022",50,50,49,1,0,0.98
22-05-16,"24 - 1150",97,120,95,2,23,0.979381443298969
22-05-16,"24 - 1153",235,240,233,2,5,0.991489361702128
22-05-17,"62 - 1011",60,60,59,1,0,0.983333333333333
22-05-17,"3 - 1008",192,230,192,0,38,1
22-05-17,"16 - 1022",50,50,48,2,0,0.96
22-05-17,"24 - 1150",94,120,92,2,26,0.978723404255319
22-05-17,"24 - 1153",234,240,234,0,6,1
22-05-18,"62 - 1011",60,60,60,0,0,1
22-05-18,"3 - 1008",169,220,169,0,51,1
22-05-18,"16 - 1022",50,50,48,2,0,0.96
22-05-18,"24 - 1150",95,120,91,4,25,0.957894736842105
22-05-18,"24 - 1153",235,240,235,0,5,1
22-05-19,"62 - 1011",60,60,60,0,0,1
22-05-19,"3 - 1008",159,220,159,0,61,1
22-05-19,"16 - 1022",50,50,48,2,0,0.96
22-05-19,"24 - 1150",96,120,95,1,24,0.989583333333333
22-05-19,"24 - 1153",236,240,236,0,4,1
22-05-20,"62 - 1011",60,60,60,0,0,1
22-05-20,"3 - 1008",154,154,141,13,0,0.915584415584416
22-05-20,"16 - 1022",50,50,48,2,0,0.96
22-05-20,"24 - 1150",106,120,100,6,14,0.943396226415094
22-05-20,"24 - 1153",234,310,234,0,76,1
22-05-21,"62 - 1011",60,60,60,0,0,1
22-05-21,"3 - 1008",154,154,142,12,0,0.922077922077922
22-05-21,"16 - 1022",50,50,47,3,0,0.94
22-05-21,"24 - 1150",108,120,105,3,12,0.972222222222222
22-05-21,"24 - 1153",234,310,234,0,76,1
22-05-22,"62 - 1011",60,60,60,0,0,1
22-05-22,"3 - 1008",154,154,142,12,0,0.922077922077922
22-05-22,"16 - 1022",50,50,47,3,0,0.94
22-05-22,"24 - 1150",108,120,104,4,12,0.962962962962963
22-05-22,"24 - 1153",234,310,234,0,76,1
22-05-23,"62 - 1011",60,60,59,1,0,0.983333333333333
22-05-23,"3 - 1008",154,154,141,13,0,0.915584415584416
22-05-23,"16 - 1022",50,50,47,3,0,0.94
22-05-23,"24 - 1150",108,120,104,4,12,0.962962962962963
22-05-23,"24 - 1153",235,310,235,0,75,1
22-05-24,"62 - 1011",60,60,59,1,0,0.983333333333333
22-05-24,"3 - 1008",154,154,140,14,0,0.909090909090909
22-05-24,"16 - 1022",50,50,48,2,0,0.96
22-05-24,"24 - 1150",104,120,101,3,16,0.971153846153846
22-05-24,"24 - 1153",235,240,235,0,5,1
22-05-25,"62 - 1011",60,60,60,0,0,1
22-05-25,"3 - 1008",154,154,142,12,0,0.922077922077922
22-05-25,"16 - 1022",50,50,48,2,0,0.96
22-05-25,"24 - 1150",104,120,102,2,16,0.980769230769231
22-05-25,"24 - 1153",240,240,237,3,0,0.9875
22-05-26,"62 - 1011",60,60,60,0,0,1
22-05-26,"3 - 1008",154,154,142,12,0,0.922077922077922
22-05-26,"16 - 1022",50,50,45,5,0,0.9
22-05-26,"24 - 1150",103,120,101,2,17,0.980582524271845
22-05-26,"24 - 1153",240,240,240,0,0,1
22-05-27,"62 - 1011",60,60,60,0,0,1
22-05-27,"3 - 1008",154,154,143,11,0,0.928571428571429
22-05-27,"16 - 1022",50,50,47,3,0,0.94
22-05-27,"24 - 1150",103,120,101,2,17,0.980582524271845
22-05-27,"24 - 1153",237,240,237,0,3,1
22-05-28,"62 - 1011",60,60,59,1,0,0.983333333333333
22-05-28,"3 - 1008",154,154,143,11,0,0.928571428571429
22-05-28,"16 - 1022",50,50,47,3,0,0.94
22-05-28,"24 - 1150",105,120,105,0,15,1
22-05-28,"24 - 1153",237,240,237,0,3,1
22-05-29,"62 - 1011",60,60,60,0,0,1
22-05-29,"3 - 1008",154,154,143,11,0,0.928571428571429
22-05-29,"16 - 1022",50,50,47,3,0,0.94
22-05-29,"24 - 1150",106,120,105,1,14,0.990566037735849
22-05-29,"24 - 1153",238,240,234,4,2,0.983193277310924
22-05-30,"62 - 1011",60,60,60,0,0,1
22-05-30,"3 - 1008",154,154,142,12,0,0.922077922077922
22-05-30,"16 - 1022",50,50,48,2,0,0.96
22-05-30,"24 - 1150",106,120,101,5,14,0.952830188679245
22-05-30,"24 - 1153",238,240,238,0,2,1
22-05-31,"62 - 1011",60,60,60,0,0,1
22-05-31,"3 - 1008",154,154,142,12,0,0.922077922077922
22-05-31,"16 - 1022",50,50,49,1,0,0.98
22-05-31,"24 - 1150",106,120,101,5,14,0.952830188679245
22-05-31,"24 - 1153",238,240,238,0,2,1
22-06-01,"62 - 1011",60,60,60,0,0,1
22-06-01,"3 - 1008",154,154,140,14,0,0.909090909090909
22-06-01,"16 - 1022",50,50,48,2,0,0.96
22-06-01,"24 - 1150",106,120,103,3,14,0.971698113207547
22-06-01,"24 - 1153",238,240,238,0,2,1
22-06-02,"62 - 1011",60,60,60,0,0,1
22-06-02,"3 - 1008",154,154,144,10,0,0.935064935064935
22-06-02,"16 - 1022",50,50,47,3,0,0.94
22-06-02,"24 - 1150",106,120,103,3,14,0.971698113207547
22-06-02,"24 - 1153",238,240,238,0,2,1
22-06-03,"62 - 1011",60,60,60,0,0,1
22-06-03,"3 - 1008",154,154,144,10,0,0.935064935064935
22-06-03,"16 - 1022",50,50,46,4,0,0.92
22-06-03,"24 - 1150",106,120,106,0,14,1
22-06-03,"24 - 1153",238,240,238,0,2,1
22-06-04,"62 - 1011",60,60,60,0,0,1
22-06-04,"3 - 1008",154,154,144,10,0,0.935064935064935
22-06-04,"16 - 1022",50,50,46,4,0,0.92
22-06-04,"24 - 1150",105,120,105,0,15,1
22-06-04,"24 - 1153",238,240,238,0,2,1
22-06-05,"62 - 1011",60,60,60,0,0,1
22-06-05,"3 - 1008",154,154,144,10,0,0.935064935064935
22-06-05,"16 - 1022",50,50,45,5,0,0.9
22-06-05,"24 - 1150",105,120,105,0,15,1
22-06-05,"24 - 1153",238,240,238,0,2,1
22-06-06,"62 - 1011",60,60,60,0,0,1
22-06-06,"3 - 1008",154,154,144,10,0,0.935064935064935
22-06-06,"16 - 1022",50,50,47,3,0,0.94
22-06-06,"24 - 1150",107,120,107,0,13,1
22-06-06,"24 - 1153",238,240,238,0,2,1
22-06-07,"62 - 1011",60,60,59,1,0,0.983333333333333
22-06-07,"3 - 1008",154,154,145,9,0,0.941558441558442
22-06-07,"16 - 1022",50,50,49,1,0,0.98
22-06-07,"24 - 1150",107,120,106,1,13,0.990654205607477
22-06-07,"24 - 1153",238,240,238,0,2,1
22-06-08,"62 - 1011",60,60,59,1,0,0.983333333333333
22-06-08,"3 - 1008",154,154,143,11,0,0.928571428571429
22-06-08,"16 - 1022",50,50,50,0,0,1
22-06-08,"24 - 1150",108,120,106,2,12,0.981481481481482
22-06-08,"24 - 1153",238,240,237,1,2,0.995798319327731
22-06-09,"62 - 1011",60,60,60,0,0,1
22-06-09,"3 - 1008",154,154,143,11,0,0.928571428571429
22-06-09,"16 - 1022",50,50,50,0,0,1
22-06-09,"24 - 1150",108,120,108,0,12,1
22-06-09,"24 - 1153",239,240,239,0,1,1
22-06-10,"62 - 1011",60,60,60,0,0,1
22-06-10,"3 - 1008",154,154,144,10,0,0.935064935064935
22-06-10,"16 - 1022",49,50,49,0,1,1
22-06-10,"24 - 1150",108,120,108,0,12,1
22-06-10,"24 - 1153",239,240,239,0,1,1
22-06-11,"62 - 1011",60,60,60,0,0,1
22-06-11,"3 - 1008",154,154,144,10,0,0.935064935064935
22-06-11,"16 - 1022",50,50,50,0,0,1
22-06-11,"24 - 1150",108,120,108,0,12,1
22-06-11,"24 - 1153",239,240,238,1,1,0.99581589958159
22-06-12,"62 - 1011",60,60,60,0,0,1
22-06-12,"3 - 1008",154,154,143,11,0,0.928571428571429
22-06-12,"16 - 1022",50,50,48,2,0,0.96
22-06-12,"24 - 1150",108,120,107,1,12,0.990740740740741
22-06-12,"24 - 1153",239,240,239,0,1,1
22-06-13,"62 - 1011",60,60,60,0,0,1
22-06-13,"3 - 1008",154,154,144,10,0,0.935064935064935
22-06-13,"16 - 1022",50,50,49,1,0,0.98
22-06-13,"24 - 1150",108,120,108,0,12,1
22-06-13,"24 - 1153",239,240,239,0,1,1
22-06-14,"62 - 1011",60,60,60,0,0,1
22-06-14,"3 - 1008",154,154,144,10,0,0.935064935064935
22-06-14,"16 - 1022",50,50,49,1,0,0.98
22-06-14,"24 - 1150",108,120,107,1,12,0.990740740740741
22-06-14,"24 - 1153",239,240,239,0,1,1
22-06-15,"62 - 1011",60,60,60,0,0,1
22-06-15,"3 - 1008",154,154,142,12,0,0.922077922077922
22-06-15,"16 - 1022",50,50,49,1,0,0.98
22-06-15,"24 - 1150",108,120,106,2,12,0.981481481481482
22-06-15,"24 - 1153",239,240,239,0,1,1
22-06-16,"62 - 1011",60,60,59,1,0,0.983333333333333
22-06-16,"3 - 1008",154,154,142,12,0,0.922077922077922
22-06-16,"16 - 1022",50,50,49,1,0,0.98
22-06-16,"24 - 1150",106,120,104,2,14,0.981132075471698
22-06-16,"24 - 1153",240,240,240,0,0,1
22-06-17,"62 - 1011",60,60,59,1,0,0.983333333333333
22-06-17,"3 - 1008",154,154,142,12,0,0.922077922077922
22-06-17,"16 - 1022",50,50,50,0,0,1
22-06-17,"24 - 1150",105,120,105,0,15,1
22-06-17,"24 - 1153",240,240,240,0,0,1
22-06-18,"62 - 1011",60,60,60,0,0,1
22-06-18,"3 - 1008",154,154,142,12,0,0.922077922077922
22-06-18,"16 - 1022",50,50,50,0,0,1
22-06-18,"24 - 1150",105,120,105,0,15,1
22-06-18,"24 - 1153",240,240,240,0,0,1
22-06-19,"62 - 1011",60,60,59,1,0,0.983333333333333
22-06-19,"3 - 1008",154,154,142,12,0,0.922077922077922
22-06-19,"16 - 1022",50,50,50,0,0,1
22-06-19,"24 - 1150",105,120,105,0,15,1
22-06-19,"24 - 1153",240,240,240,0,0,1
22-06-20,"62 - 1011",60,60,60,0,0,1
22-06-20,"3 - 1008",154,154,142,12,0,0.922077922077922
22-06-20,"16 - 1022",50,50,49,1,0,0.98
22-06-20,"24 - 1150",105,120,101,4,15,0.961904761904762
22-06-20,"24 - 1153",240,240,240,0,0,1
22-06-21,"62 - 1011",60,60,60,0,0,1
22-06-21,"3 - 1008",154,154,140,14,0,0.909090909090909
22-06-21,"16 - 1022",50,50,50,0,0,1
22-06-21,"24 - 1150",105,120,105,0,15,1
22-06-21,"24 - 1153",240,240,239,1,0,0.995833333333333
22-06-22,"62 - 1011",60,60,60,0,0,1
22-06-22,"3 - 1008",154,154,140,14,0,0.909090909090909
22-06-22,"16 - 1022",50,50,50,0,0,1
22-06-22,"24 - 1150",105,120,105,0,15,1
22-06-22,"24 - 1153",240,240,239,1,0,0.995833333333333
22-06-23,"62 - 1011",60,60,59,1,0,0.983333333333333
22-06-23,"3 - 1008",154,154,139,15,0,0.902597402597403
22-06-23,"16 - 1022",49,50,48,1,1,0.979591836734694
22-06-23,"24 - 1150",105,120,105,0,15,1
22-06-23,"24 - 1153",240,240,240,0,0,1
22-06-24,"62 - 1011",60,60,60,0,0,1
22-06-24,"3 - 1008",154,154,140,14,0,0.909090909090909
22-06-24,"16 - 1022",50,50,48,2,0,0.96
22-06-24,"24 - 1150",105,120,105,0,15,1
22-06-24,"24 - 1153",240,240,240,0,0,1
22-06-25,"62 - 1011",60,60,60,0,0,1
22-06-25,"3 - 1008",154,154,140,14,0,0.909090909090909
22-06-25,"16 - 1022",50,50,46,4,0,0.92
22-06-25,"24 - 1150",105,120,105,0,15,1
22-06-25,"24 - 1153",240,240,240,0,0,1
22-06-26,"62 - 1011",60,60,60,0,0,1
22-06-26,"3 - 1008",154,154,139,15,0,0.902597402597403
22-06-26,"16 - 1022",50,50,47,3,0,0.94
22-06-26,"24 - 1150",105,120,105,0,15,1
22-06-26,"24 - 1153",240,240,238,2,0,0.991666666666667
22-06-27,"62 - 1011",60,60,59,1,0,0.983333333333333
22-06-27,"3 - 1008",154,154,139,15,0,0.902597402597403
22-06-27,"16 - 1022",50,50,48,2,0,0.96
22-06-27,"24 - 1150",105,120,105,0,15,1
22-06-27,"24 - 1153",240,240,240,0,0,1
22-06-28,"62 - 1011",60,60,60,0,0,1
22-06-28,"3 - 1008",154,154,139,15,0,0.902597402597403
22-06-28,"16 - 1022",50,50,49,1,0,0.98
22-06-28,"24 - 1150",104,120,104,0,16,1
22-06-28,"24 - 1153",240,240,240,0,0,1
22-06-29,"62 - 1011",60,60,60,0,0,1
22-06-29,"3 - 1008",154,154,140,14,0,0.909090909090909
22-06-29,"16 - 1022",50,50,49,1,0,0.98
22-06-29,"24 - 1150",104,120,104,0,16,1
22-06-29,"24 - 1153",240,240,240,0,0,1
22-06-30,"62 - 1011",60,60,60,0,0,1
22-06-30,"3 - 1008",154,154,141,13,0,0.915584415584416
22-06-30,"16 - 1022",50,50,49,1,0,0.98
22-06-30,"24 - 1150",103,120,102,1,17,0.990291262135922
22-06-30,"24 - 1153",239,240,238,1,1,0.99581589958159
22-07-01,"62 - 1011",60,60,57,3,0,0.95
22-07-01,"3 - 1008",154,154,140,14,0,0.909090909090909
22-07-01,"16 - 1022",50,50,49,1,0,0.98
22-07-01,"24 - 1150",103,120,102,1,17,0.990291262135922
22-07-01,"24 - 1153",240,240,240,0,0,1
22-07-02,"62 - 1011",60,60,57,3,0,0.95
22-07-02,"3 - 1008",154,154,140,14,0,0.909090909090909
22-07-02,"16 - 1022",50,50,47,3,0,0.94
22-07-02,"24 - 1150",103,120,102,1,17,0.990291262135922
22-07-02,"24 - 1153",240,240,240,0,0,1
22-07-03,"62 - 1011",57,60,57,0,3,1
22-07-03,"3 - 1008",154,154,141,13,0,0.915584415584416
22-07-03,"16 - 1022",50,50,47,3,0,0.94
22-07-03,"24 - 1150",103,120,103,0,17,1
22-07-03,"24 - 1153",239,240,238,1,1,0.99581589958159
22-07-04,"62 - 1011",56,60,56,0,4,1
22-07-04,"3 - 1008",154,154,140,14,0,0.909090909090909
22-07-04,"16 - 1022",50,50,47,3,0,0.94
22-07-04,"24 - 1150",103,120,103,0,17,1
22-07-04,"24 - 1153",237,240,236,1,3,0.9957805907173
22-07-05,"62 - 1011",56,56,56,0,0,1
22-07-05,"3 - 1008",154,154,139,15,0,0.902597402597403
22-07-05,"16 - 1022",50,50,48,2,0,0.96
22-07-05,"24 - 1150",103,120,102,1,17,0.990291262135922
22-07-05,"24 - 1153",239,240,239,0,1,1
22-07-06,"62 - 1011",56,56,56,0,0,1
22-07-06,"3 - 1008",154,154,136,18,0,0.883116883116883
22-07-06,"16 - 1022",50,50,48,2,0,0.96
22-07-06,"24 - 1150",106,120,99,7,14,0.933962264150943
22-07-06,"24 - 1153",239,240,239,0,1,1
22-07-07,"62 - 1011",56,56,55,1,0,0.982142857142857
22-07-07,"3 - 1008",154,154,137,17,0,0.88961038961039
22-07-07,"16 - 1022",50,50,48,2,0,0.96
22-07-07,"24 - 1150",106,120,102,4,14,0.962264150943396
22-07-07,"24 - 1153",239,240,239,0,1,1
22-07-08,"62 - 1011",56,56,54,2,0,0.964285714285714
22-07-08,"3 - 1008",154,154,138,16,0,0.896103896103896
22-07-08,"16 - 1022",50,50,49,1,0,0.98
22-07-08,"24 - 1150",106,120,102,4,14,0.962264150943396
22-07-08,"24 - 1153",239,240,239,0,1,1
22-07-09,"62 - 1011",56,56,54,2,0,0.964285714285714
22-07-09,"3 - 1008",154,154,138,16,0,0.896103896103896
22-07-09,"16 - 1022",50,50,49,1,0,0.98
22-07-09,"24 - 1150",106,120,105,1,14,0.990566037735849
22-07-09,"24 - 1153",239,240,239,0,1,1
22-07-10,"62 - 1011",56,56,53,3,0,0.946428571428571
22-07-10,"3 - 1008",154,154,137,17,0,0.88961038961039
22-07-10,"16 - 1022",50,50,48,2,0,0.96
22-07-10,"24 - 1150",106,120,106,0,14,1
22-07-10,"24 - 1153",237,240,236,1,3,0.9957805907173
22-07-11,"62 - 1011",56,56,54,2,0,0.964285714285714
22-07-11,"3 - 1008",154,154,137,17,0,0.88961038961039
22-07-11,"16 - 1022",50,50,48,2,0,0.96
22-07-11,"24 - 1150",106,120,106,0,14,1
22-07-11,"24 - 1153",237,240,237,0,3,1
22-07-12,"62 - 1011",56,56,53,3,0,0.946428571428571
22-07-12,"3 - 1008",154,154,137,17,0,0.88961038961039
22-07-12,"16 - 1022",50,50,47,3,0,0.94
22-07-12,"24 - 1150",107,120,106,1,13,0.990654205607477
22-07-12,"24 - 1153",237,240,237,0,3,1
22-07-13,"62 - 1011",56,56,54,2,0,0.964285714285714
22-07-13,"3 - 1008",154,154,137,17,0,0.88961038961039
22-07-13,"16 - 1022",50,50,46,4,0,0.92
22-07-13,"24 - 1150",107,120,105,2,13,0.981308411214953
22-07-13,"24 - 1153",238,240,238,0,2,1
22-07-14,"62 - 1011",56,56,53,3,0,0.946428571428571
22-07-14,"3 - 1008",154,154,135,19,0,0.876623376623377
22-07-14,"16 - 1022",50,50,47,3,0,0.94
22-07-14,"24 - 1150",108,120,104,4,12,0.962962962962963
22-07-14,"24 - 1153",238,240,238,0,2,1
22-07-15,"62 - 1011",56,56,54,2,0,0.964285714285714
22-07-15,"3 - 1008",154,154,136,18,0,0.883116883116883
22-07-15,"16 - 1022",50,50,47,3,0,0.94
22-07-15,"24 - 1150",106,120,104,2,14,0.981132075471698
22-07-15,"24 - 1153",238,240,238,0,2,1
22-07-16,"62 - 1011",56,56,54,2,0,0.964285714285714
22-07-16,"3 - 1008",154,154,135,19,0,0.876623376623377
22-07-16,"16 - 1022",50,50,46,4,0,0.92
22-07-16,"24 - 1150",106,120,106,0,14,1
22-07-16,"24 - 1153",238,240,237,1,2,0.995798319327731
22-07-17,"62 - 1011",56,56,55,1,0,0.982142857142857
22-07-17,"3 - 1008",154,154,135,19,0,0.876623376623377
22-07-17,"16 - 1022",50,50,44,6,0,0.88
22-07-17,"24 - 1150",105,120,101,4,15,0.961904761904762
22-07-17,"24 - 1153",238,240,238,0,2,1
22-07-18,"62 - 1011",56,56,55,1,0,0.982142857142857
22-07-18,"3 - 1008",154,154,135,19,0,0.876623376623377
22-07-18,"16 - 1022",50,50,44,6,0,0.88
22-07-18,"24 - 1150",107,120,107,0,13,1
22-07-18,"24 - 1153",238,240,237,1,2,0.995798319327731
22-07-19,"62 - 1011",56,56,56,0,0,1
22-07-19,"3 - 1008",154,154,137,17,0,0.88961038961039
22-07-19,"16 - 1022",50,50,46,4,0,0.92
22-07-19,"24 - 1150",107,120,105,2,13,0.981308411214953
22-07-19,"24 - 1153",238,240,238,0,2,1
22-07-20,"62 - 1011",56,56,56,0,0,1
22-07-20,"3 - 1008",154,154,137,17,0,0.88961038961039
22-07-20,"16 - 1022",50,50,47,3,0,0.94
22-07-20,"24 - 1150",109,120,103,6,11,0.944954128440367
22-07-20,"24 - 1153",240,240,239,1,0,0.995833333333333
22-07-21,"62 - 1011",56,56,56,0,0,1
22-07-21,"3 - 1008",153,154,136,17,1,0.888888888888889
22-07-21,"16 - 1022",49,50,45,4,1,0.918367346938776
22-07-21,"24 - 1150",109,120,107,2,11,0.981651376146789
22-07-21,"24 - 1153",240,240,240,0,0,1
22-07-22,"62 - 1011",56,56,56,0,0,1
22-07-22,"3 - 1008",153,154,137,16,1,0.895424836601307
22-07-22,"16 - 1022",49,50,48,1,1,0.979591836734694
22-07-22,"24 - 1150",109,120,107,2,11,0.981651376146789
22-07-22,"24 - 1153",240,240,240,0,0,1
22-07-23,"62 - 1011",56,56,56,0,0,1
22-07-23,"3 - 1008",153,154,137,16,1,0.895424836601307
22-07-23,"16 - 1022",49,50,47,2,1,0.959183673469388
22-07-23,"24 - 1150",110,120,107,3,10,0.972727272727273
22-07-23,"24 - 1153",240,240,240,0,0,1
22-07-24,"62 - 1011",56,56,56,0,0,1
22-07-24,"3 - 1008",153,154,137,16,1,0.895424836601307
22-07-24,"16 - 1022",49,50,47,2,1,0.959183673469388
22-07-24,"24 - 1150",110,120,110,0,10,1
22-07-24,"24 - 1153",240,240,240,0,0,1
22-07-25,"62 - 1011",56,56,56,0,0,1
22-07-25,"3 - 1008",153,154,139,14,1,0.908496732026144
22-07-25,"16 - 1022",49,50,45,4,1,0.918367346938776
22-07-25,"24 - 1150",110,120,110,0,10,1
22-07-25,"24 - 1153",240,240,240,0,0,1
22-07-26,"62 - 1011",56,56,56,0,0,1
22-07-26,"3 - 1008",153,154,140,13,1,0.915032679738562
22-07-26,"16 - 1022",49,50,46,3,1,0.938775510204082
22-07-26,"24 - 1150",110,120,110,0,10,1
22-07-26,"24 - 1153",240,240,240,0,0,1
22-07-27,"62 - 1011",56,56,56,0,0,1
22-07-27,"3 - 1008",151,154,139,12,3,0.920529801324503
22-07-27,"16 - 1022",49,50,46,3,1,0.938775510204082
22-07-27,"24 - 1150",113,120,101,12,7,0.893805309734513
22-07-27,"24 - 1153",240,240,240,0,0,1
22-07-28,"62 - 1011",56,56,56,0,0,1
22-07-28,"3 - 1008",151,154,140,11,3,0.927152317880795
22-07-28,"16 - 1022",49,50,47,2,1,0.959183673469388
22-07-28,"24 - 1150",114,120,108,6,6,0.947368421052632
22-07-28,"24 - 1153",237,240,237,0,3,1
22-07-29,"62 - 1011",56,56,56,0,0,1
22-07-29,"3 - 1008",151,154,142,9,3,0.940397350993378
22-07-29,"16 - 1022",49,50,47,2,1,0.959183673469388
22-07-29,"24 - 1150",115,120,113,2,5,0.982608695652174
22-07-29,"24 - 1153",231,240,231,0,9,1
22-07-30,"62 - 1011",56,56,56,0,0,1
22-07-30,"3 - 1008",151,154,142,9,3,0.940397350993378
22-07-30,"16 - 1022",49,50,46,3,1,0.938775510204082
22-07-30,"24 - 1150",115,120,114,1,5,0.991304347826087
22-07-30,"24 - 1153",220,240,220,0,20,1
22-07-31,"62 - 1011",56,56,56,0,0,1
22-07-31,"3 - 1008",152,154,143,9,2,0.940789473684211
22-07-31,"16 - 1022",49,50,46,3,1,0.938775510204082
22-07-31,"24 - 1150",114,120,114,0,6,1
22-07-31,"24 - 1153",218,240,218,0,22,1
22-08-01,"62 - 1011",56,56,56,0,0,1
22-08-01,"3 - 1008",150,154,141,9,4,0.94
22-08-01,"16 - 1022",49,50,44,5,1,0.897959183673469
22-08-01,"24 - 1150",114,120,114,0,6,1
22-08-01,"24 - 1153",214,240,214,0,26,1
22-08-02,"62 - 1011",56,56,56,0,0,1
22-08-02,"3 - 1008",149,154,141,8,5,0.946308724832215
22-08-02,"16 - 1022",50,50,47,3,0,0.94
22-08-02,"24 - 1150",115,120,115,0,5,1
22-08-02,"24 - 1153",236,240,235,1,4,0.995762711864407
22-08-03,"62 - 1011",61,61,60,1,0,0.983606557377049
22-08-03,"3 - 1008",148,154,140,8,6,0.945945945945946
22-08-03,"16 - 1022",50,50,47,3,0,0.94
22-08-03,"24 - 1150",117,120,117,0,3,1
22-08-03,"24 - 1153",237,240,237,0,3,1
22-08-04,"62 - 1011",61,61,59,2,0,0.967213114754098
22-08-04,"3 - 1008",157,164,150,7,7,0.955414012738854
22-08-04,"16 - 1022",50,50,47,3,0,0.94
22-08-04,"24 - 1150",119,120,117,2,1,0.983193277310924
22-08-04,"24 - 1153",237,240,237,0,3,1
22-08-05,"62 - 1011",61,61,61,0,0,1
22-08-05,"3 - 1008",157,164,149,8,7,0.949044585987261
22-08-05,"16 - 1022",50,50,47,3,0,0.94
22-08-05,"24 - 1150",119,120,119,0,1,1
22-08-05,"24 - 1153",238,240,235,3,2,0.987394957983193
22-08-06,"62 - 1011",61,61,61,0,0,1
22-08-06,"3 - 1008",159,164,151,8,5,0.949685534591195
22-08-06,"16 - 1022",50,50,47,3,0,0.94
22-08-06,"24 - 1150",119,120,119,0,1,1
22-08-06,"24 - 1153",239,240,239,0,1,1
22-08-07,"62 - 1011",61,61,60,1,0,0.983606557377049
22-08-07,"3 - 1008",149,154,141,8,5,0.946308724832215
22-08-07,"16 - 1022",50,50,47,3,0,0.94
22-08-07,"24 - 1150",119,120,119,0,1,1
22-08-07,"24 - 1153",239,240,239,0,1,1
22-08-08,"62 - 1011",61,61,60,1,0,0.983606557377049
22-08-08,"3 - 1008",159,164,147,12,5,0.924528301886792
22-08-08,"16 - 1022",50,50,46,4,0,0.92
22-08-08,"24 - 1150",119,120,119,0,1,1
22-08-08,"24 - 1153",239,240,237,2,1,0.99163179916318
22-08-09,"62 - 1011",61,61,61,0,0,1
22-08-09,"3 - 1008",159,164,148,11,5,0.930817610062893
22-08-09,"16 - 1022",50,50,47,3,0,0.94
22-08-09,"24 - 1150",119,120,119,0,1,1
22-08-09,"24 - 1153",239,240,239,0,1,1
22-08-10,"62 - 1011",61,61,60,1,0,0.983606557377049
22-08-10,"3 - 1008",159,164,151,8,5,0.949685534591195
22-08-10,"16 - 1022",50,50,48,2,0,0.96
22-08-10,"24 - 1150",117,120,117,0,3,1
22-08-10,"24 - 1153",239,240,238,1,1,0.99581589958159
22-08-11,"62 - 1011",58,61,58,0,3,1
22-08-11,"3 - 1008",159,164,149,10,5,0.937106918238994
22-08-11,"16 - 1022",50,50,49,1,0,0.98
22-08-11,"24 - 1150",117,120,117,0,3,1
22-08-11,"24 - 1153",239,240,239,0,1,1
22-08-12,"62 - 1011",61,61,60,1,0,0.983606557377049
22-08-12,"3 - 1008",160,164,154,6,4,0.9625
22-08-12,"16 - 1022",50,50,49,1,0,0.98
22-08-12,"24 - 1150",117,120,116,1,3,0.991452991452991
22-08-12,"24 - 1153",239,240,238,1,1,0.99581589958159
22-08-13,"62 - 1011",61,61,58,3,0,0.950819672131147
22-08-13,"3 - 1008",161,164,155,6,3,0.962732919254658
22-08-13,"16 - 1022",50,50,48,2,0,0.96
22-08-13,"24 - 1150",117,120,117,0,3,1
22-08-13,"24 - 1153",237,240,237,0,3,1
22-08-14,"62 - 1011",61,61,58,3,0,0.950819672131147
22-08-14,"3 - 1008",158,164,155,3,6,0.981012658227848
22-08-14,"16 - 1022",50,50,46,4,0,0.92
22-08-14,"24 - 1150",117,120,117,0,3,1
22-08-14,"24 - 1153",238,240,237,1,2,0.995798319327731
22-08-15,"62 - 1011",61,61,59,2,0,0.967213114754098
22-08-15,"3 - 1008",162,164,157,5,2,0.969135802469136
22-08-15,"16 - 1022",50,50,48,2,0,0.96
22-08-15,"24 - 1150",117,120,117,0,3,1
22-08-15,"24 - 1153",239,240,239,0,1,1
22-08-16,"62 - 1011",61,61,58,3,0,0.950819672131147
22-08-16,"3 - 1008",161,164,158,3,3,0.981366459627329
22-08-16,"16 - 1022",50,50,49,1,0,0.98
22-08-16,"24 - 1150",117,120,117,0,3,1
22-08-16,"24 - 1153",239,240,239,0,1,1
22-08-17,"62 - 1011",61,61,58,3,0,0.950819672131147
22-08-17,"3 - 1008",161,164,158,3,3,0.981366459627329
22-08-17,"16 - 1022",50,50,50,0,0,1
22-08-17,"24 - 1150",116,120,114,2,4,0.982758620689655
22-08-17,"24 - 1153",239,240,239,0,1,1
22-08-18,"62 - 1011",61,61,60,1,0,0.983606557377049
22-08-18,"3 - 1008",161,164,157,4,3,0.975155279503106
22-08-18,"16 - 1022",50,50,50,0,0,1
22-08-18,"24 - 1150",116,120,116,0,4,1
22-08-18,"24 - 1153",238,240,238,0,2,1
22-08-19,"62 - 1011",61,61,61,0,0,1
22-08-19,"3 - 1008",161,164,157,4,3,0.975155279503106
22-08-19,"16 - 1022",50,50,50,0,0,1
22-08-19,"24 - 1150",113,120,113,0,7,1
22-08-19,"24 - 1153",238,240,238,0,2,1
22-08-20,"62 - 1011",61,61,60,1,0,0.983606557377049
22-08-20,"3 - 1008",162,164,158,4,2,0.975308641975309
22-08-20,"16 - 1022",50,50,49,1,0,0.98
22-08-20,"24 - 1150",113,120,113,0,7,1
22-08-20,"24 - 1153",238,240,238,0,2,1
22-08-21,"62 - 1011",61,61,60,1,0,0.983606557377049
22-08-21,"3 - 1008",162,164,157,5,2,0.969135802469136
22-08-21,"16 - 1022",50,50,45,5,0,0.9
22-08-21,"24 - 1150",114,120,112,2,6,0.982456140350877
22-08-21,"24 - 1153",238,240,238,0,2,1
22-08-22,"62 - 1011",61,61,61,0,0,1
22-08-22,"3 - 1008",162,164,156,6,2,0.962962962962963
22-08-22,"16 - 1022",50,50,46,4,0,0.92
22-08-22,"24 - 1150",113,120,111,2,7,0.982300884955752
22-08-22,"24 - 1153",238,240,237,1,2,0.995798319327731
22-08-23,"62 - 1011",61,61,60,1,0,0.983606557377049
22-08-23,"3 - 1008",162,164,156,6,2,0.962962962962963
22-08-23,"16 - 1022",50,50,45,5,0,0.9
22-08-23,"24 - 1150",113,120,111,2,7,0.982300884955752
22-08-23,"24 - 1153",236,240,235,1,4,0.995762711864407
22-08-24,"62 - 1011",61,61,60,1,0,0.983606557377049
22-08-24,"3 - 1008",163,164,156,7,1,0.957055214723926
22-08-24,"16 - 1022",50,50,47,3,0,0.94
22-08-24,"24 - 1150",114,120,114,0,6,1
22-08-24,"24 - 1153",236,240,236,0,4,1
22-08-25,"62 - 1011",62,64,59,3,2,0.951612903225806
22-08-25,"3 - 1008",153,154,147,6,1,0.96078431372549
22-08-25,"16 - 1022",50,50,47,3,0,0.94
22-08-25,"24 - 1150",113,120,113,0,7,1
22-08-25,"24 - 1153",235,240,235,0,5,1
22-08-26,"62 - 1011",57,57,56,1,0,0.982456140350877
22-08-26,"3 - 1008",153,154,146,7,1,0.954248366013072
22-08-26,"16 - 1022",50,50,48,2,0,0.96
22-08-26,"24 - 1150",114,120,110,4,6,0.964912280701754
22-08-26,"24 - 1153",235,240,235,0,5,1
22-08-27,"62 - 1011",57,57,56,1,0,0.982456140350877
22-08-27,"3 - 1008",153,154,148,5,1,0.967320261437909
22-08-27,"16 - 1022",50,50,47,3,0,0.94
22-08-27,"24 - 1150",114,120,114,0,6,1
22-08-27,"24 - 1153",235,240,234,1,5,0.995744680851064
22-08-28,"62 - 1011",57,57,56,1,0,0.982456140350877
22-08-28,"3 - 1008",153,154,148,5,1,0.967320261437909
22-08-28,"16 - 1022",50,50,47,3,0,0.94
22-08-28,"24 - 1150",115,120,114,1,5,0.991304347826087
22-08-28,"24 - 1153",235,240,234,1,5,0.995744680851064
22-08-29,"62 - 1011",57,57,56,1,0,0.982456140350877
22-08-29,"3 - 1008",154,154,146,8,0,0.948051948051948
22-08-29,"16 - 1022",50,50,49,1,0,0.98
22-08-29,"24 - 1150",115,120,114,1,5,0.991304347826087
22-08-29,"24 - 1153",234,240,234,0,6,1
22-08-30,"62 - 1011",57,57,57,0,0,1
22-08-30,"3 - 1008",154,154,149,5,0,0.967532467532468
22-08-30,"16 - 1022",50,50,50,0,0,1
22-08-30,"24 - 1150",115,120,114,1,5,0.991304347826087
22-08-30,"24 - 1153",237,240,237,0,3,1
22-08-31,"62 - 1011",57,57,56,1,0,0.982456140350877
22-08-31,"3 - 1008",154,154,149,5,0,0.967532467532468
22-08-31,"16 - 1022",50,50,49,1,0,0.98
22-08-31,"24 - 1150",114,120,114,0,6,1
22-08-31,"24 - 1153",233,240,233,0,7,1
22-09-01,"62 - 1011",57,57,56,1,0,0.982456140350877
22-09-01,"3 - 1008",154,154,148,6,0,0.961038961038961
22-09-01,"16 - 1022",50,50,48,2,0,0.96
22-09-01,"24 - 1150",114,120,114,0,6,1
22-09-01,"24 - 1153",231,240,231,0,9,1
22-09-02,"62 - 1011",57,57,55,2,0,0.964912280701754
22-09-02,"3 - 1008",154,154,148,6,0,0.961038961038961
22-09-02,"16 - 1022",50,50,46,4,0,0.92
22-09-02,"24 - 1150",114,120,113,1,6,0.991228070175439
22-09-02,"24 - 1153",230,240,230,0,10,1
22-09-03,"62 - 1011",57,57,56,1,0,0.982456140350877
22-09-03,"3 - 1008",154,154,149,5,0,0.967532467532468
22-09-03,"16 - 1022",50,50,46,4,0,0.92
22-09-03,"24 - 1150",112,120,112,0,8,1
22-09-03,"24 - 1153",230,240,230,0,10,1
22-09-04,"62 - 1011",57,57,56,1,0,0.982456140350877
22-09-04,"3 - 1008",154,154,149,5,0,0.967532467532468
22-09-04,"16 - 1022",50,50,45,5,0,0.9
22-09-04,"24 - 1150",112,120,111,1,8,0.991071428571429
22-09-04,"24 - 1153",230,240,230,0,10,1
22-09-05,"62 - 1011",57,57,57,0,0,1
22-09-05,"3 - 1008",154,154,148,6,0,0.961038961038961
22-09-05,"16 - 1022",50,50,44,6,0,0.88
22-09-05,"24 - 1150",111,120,111,0,9,1
22-09-05,"24 - 1153",230,240,230,0,10,1
22-09-06,"62 - 1011",57,57,57,0,0,1
22-09-06,"3 - 1008",154,154,149,5,0,0.967532467532468
22-09-06,"16 - 1022",50,50,47,3,0,0.94
22-09-06,"24 - 1150",114,120,113,1,6,0.991228070175439
22-09-06,"24 - 1153",228,240,228,0,12,1
22-09-07,"62 - 1011",57,57,56,1,0,0.982456140350877
22-09-07,"3 - 1008",154,154,149,5,0,0.967532467532468
22-09-07,"16 - 1022",50,50,47,3,0,0.94
22-09-07,"24 - 1150",114,120,113,1,6,0.991228070175439
22-09-07,"24 - 1153",225,240,224,1,15,0.995555555555556
22-09-08,"62 - 1011",57,57,55,2,0,0.964912280701754
22-09-08,"3 - 1008",153,154,149,4,1,0.973856209150327
22-09-08,"16 - 1022",50,50,48,2,0,0.96
22-09-08,"24 - 1150",114,120,114,0,6,1
22-09-08,"24 - 1153",227,240,226,1,13,0.995594713656388
22-09-09,"62 - 1011",57,57,53,4,0,0.929824561403509
22-09-09,"3 - 1008",154,154,150,4,0,0.974025974025974
22-09-09,"16 - 1022",50,50,49,1,0,0.98
22-09-09,"24 - 1150",114,120,114,0,6,1
22-09-09,"24 - 1153",239,240,239,0,1,1
22-09-10,"62 - 1011",57,57,52,5,0,0.912280701754386
22-09-10,"3 - 1008",154,154,151,3,0,0.980519480519481
22-09-10,"16 - 1022",50,50,49,1,0,0.98
22-09-10,"24 - 1150",114,120,114,0,6,1
22-09-10,"24 - 1153",238,240,238,0,2,1
22-09-11,"62 - 1011",57,57,51,6,0,0.894736842105263
22-09-11,"3 - 1008",154,154,151,3,0,0.980519480519481
22-09-11,"16 - 1022",50,50,49,1,0,0.98
22-09-11,"24 - 1150",113,120,112,1,7,0.991150442477876
22-09-11,"24 - 1153",238,240,238,0,2,1
22-09-12,"62 - 1011",56,57,54,2,1,0.964285714285714
22-09-12,"3 - 1008",154,154,148,6,0,0.961038961038961
22-09-12,"16 - 1022",50,50,49,1,0,0.98
22-09-12,"24 - 1150",106,120,105,1,14,0.990566037735849
22-09-12,"24 - 1153",236,240,236,0,4,1
22-09-13,"62 - 1011",56,57,53,3,1,0.946428571428571
22-09-13,"3 - 1008",154,154,147,7,0,0.954545454545455
22-09-13,"16 - 1022",50,50,49,1,0,0.98
22-09-13,"24 - 1150",106,120,103,3,14,0.971698113207547
22-09-13,"24 - 1153",236,240,236,0,4,1
22-09-14,"62 - 1011",56,57,53,3,1,0.946428571428571
22-09-14,"3 - 1008",154,154,148,6,0,0.961038961038961
22-09-14,"16 - 1022",50,50,50,0,0,1
22-09-14,"24 - 1150",102,120,98,4,18,0.96078431372549
22-09-14,"24 - 1153",236,240,236,0,4,1
22-09-15,"62 - 1011",56,57,53,3,1,0.946428571428571
22-09-15,"3 - 1008",154,154,148,6,0,0.961038961038961
22-09-15,"16 - 1022",50,50,50,0,0,1
22-09-15,"24 - 1150",112,120,103,9,8,0.919642857142857
22-09-15,"24 - 1153",235,240,235,0,5,1
22-09-16,"62 - 1011",56,57,53,3,1,0.946428571428571
22-09-16,"3 - 1008",154,154,148,6,0,0.961038961038961
22-09-16,"16 - 1022",50,50,50,0,0,1
22-09-16,"24 - 1150",109,120,109,0,11,1
22-09-16,"24 - 1153",235,240,235,0,5,1
22-09-17,"62 - 1011",56,57,53,3,1,0.946428571428571
22-09-17,"3 - 1008",154,154,148,6,0,0.961038961038961
22-09-17,"16 - 1022",50,50,50,0,0,1
22-09-17,"24 - 1150",113,120,113,0,7,1
22-09-17,"24 - 1153",235,240,235,0,5,1
22-09-18,"62 - 1011",56,57,56,0,1,1
22-09-18,"3 - 1008",154,154,149,5,0,0.967532467532468
22-09-18,"16 - 1022",50,50,50,0,0,1
22-09-18,"24 - 1150",113,120,113,0,7,1
22-09-18,"24 - 1153",235,240,235,0,5,1
22-09-19,"62 - 1011",56,57,55,1,1,0.982142857142857
22-09-19,"3 - 1008",154,154,149,5,0,0.967532467532468
22-09-19,"16 - 1022",50,50,50,0,0,1
22-09-19,"24 - 1150",104,120,102,2,16,0.980769230769231
22-09-19,"24 - 1153",236,240,236,0,4,1
22-09-20,"62 - 1011",56,57,55,1,1,0.982142857142857
22-09-20,"3 - 1008",154,154,148,6,0,0.961038961038961
22-09-20,"16 - 1022",50,50,49,1,0,0.98
22-09-20,"24 - 1150",108,120,104,4,12,0.962962962962963
22-09-20,"24 - 1153",236,240,236,0,4,1
22-09-21,"62 - 1011",56,57,56,0,1,1
22-09-21,"3 - 1008",154,154,147,7,0,0.954545454545455
22-09-21,"16 - 1022",50,50,49,1,0,0.98
22-09-21,"24 - 1150",103,120,103,0,17,1
22-09-21,"24 - 1153",238,240,238,0,2,1
22-09-22,"62 - 1011",56,57,56,0,1,1
22-09-22,"3 - 1008",154,154,148,6,0,0.961038961038961
22-09-22,"16 - 1022",50,50,48,2,0,0.96
22-09-22,"24 - 1150",103,120,103,0,17,1
22-09-22,"24 - 1153",238,240,238,0,2,1
22-09-23,"62 - 1011",56,57,56,0,1,1
22-09-23,"3 - 1008",154,154,150,4,0,0.974025974025974
22-09-23,"16 - 1022",50,50,50,0,0,1
22-09-23,"24 - 1150",105,120,100,5,15,0.952380952380952
22-09-23,"24 - 1153",239,240,239,0,1,1
22-09-24,"62 - 1011",56,57,56,0,1,1
22-09-24,"3 - 1008",154,154,150,4,0,0.974025974025974
22-09-24,"16 - 1022",50,50,50,0,0,1
22-09-24,"24 - 1150",105,120,105,0,15,1
22-09-24,"24 - 1153",239,240,239,0,1,1
22-09-25,"62 - 1011",56,57,56,0,1,1
22-09-25,"3 - 1008",154,154,150,4,0,0.974025974025974
22-09-25,"16 - 1022",50,50,50,0,0,1
22-09-25,"24 - 1150",104,120,99,5,16,0.951923076923077
22-09-25,"24 - 1153",239,240,239,0,1,1
22-09-26,"62 - 1011",56,57,56,0,1,1
22-09-26,"3 - 1008",154,154,149,5,0,0.967532467532468
22-09-26,"16 - 1022",50,50,49,1,0,0.98
22-09-26,"24 - 1150",109,120,107,2,11,0.981651376146789
22-09-26,"24 - 1153",240,240,240,0,0,1
22-09-27,"62 - 1011",56,57,56,0,1,1
22-09-27,"3 - 1008",154,154,150,4,0,0.974025974025974
22-09-27,"16 - 1022",50,50,50,0,0,1
22-09-27,"24 - 1150",113,120,111,2,7,0.982300884955752
22-09-27,"24 - 1153",240,240,240,0,0,1
22-09-28,"62 - 1011",61,62,61,0,1,1
22-09-28,"3 - 1008",164,164,158,6,0,0.963414634146341
22-09-28,"16 - 1022",50,50,50,0,0,1
22-09-28,"24 - 1150",113,120,113,0,7,1
22-09-28,"24 - 1153",240,240,240,0,0,1
22-09-29,"62 - 1011",61,62,61,0,1,1
22-09-29,"3 - 1008",154,154,150,4,0,0.974025974025974
22-09-29,"16 - 1022",50,50,50,0,0,1
22-09-29,"24 - 1150",112,120,110,2,8,0.982142857142857
22-09-29,"24 - 1153",240,240,240,0,0,1
22-09-30,"62 - 1011",61,62,60,1,1,0.983606557377049
22-09-30,"3 - 1008",163,164,156,7,1,0.957055214723926
22-09-30,"16 - 1022",50,50,50,0,0,1
22-09-30,"24 - 1150",112,120,112,0,8,1
22-09-30,"24 - 1153",240,240,240,0,0,1
22-10-01,"62 - 1011",61,62,60,1,1,0.983606557377049
22-10-01,"3 - 1008",163,164,155,8,1,0.950920245398773
22-10-01,"16 - 1022",50,50,50,0,0,1
22-10-01,"24 - 1150",112,120,112,0,8,1
22-10-01,"24 - 1153",240,240,240,0,0,1
22-10-02,"62 - 1011",61,62,61,0,1,1
22-10-02,"3 - 1008",162,164,156,6,2,0.962962962962963
22-10-02,"16 - 1022",50,50,50,0,0,1
22-10-02,"24 - 1150",111,120,111,0,9,1
22-10-02,"24 - 1153",240,240,239,1,0,0.995833333333333
22-10-03,"62 - 1011",56,57,56,0,1,1
22-10-03,"3 - 1008",152,154,146,6,2,0.960526315789474
22-10-03,"16 - 1022",50,50,49,1,0,0.98
22-10-03,"24 - 1150",113,120,111,2,7,0.982300884955752
22-10-03,"24 - 1153",240,240,240,0,0,1
22-10-04,"62 - 1011",56,57,56,0,1,1
22-10-04,"3 - 1008",152,154,144,8,2,0.947368421052632
22-10-04,"16 - 1022",50,50,49,1,0,0.98
22-10-04,"24 - 1150",117,120,114,3,3,0.974358974358974
22-10-04,"24 - 1153",240,240,240,0,0,1
22-10-05,"62 - 1011",56,57,56,0,1,1
22-10-05,"3 - 1008",152,154,142,10,2,0.934210526315789
22-10-05,"16 - 1022",50,50,50,0,0,1
22-10-05,"24 - 1150",118,120,116,2,2,0.983050847457627
22-10-05,"24 - 1153",240,240,239,1,0,0.995833333333333
22-10-06,"62 - 1011",56,57,55,1,1,0.982142857142857
22-10-06,"3 - 1008",152,154,139,13,2,0.914473684210526
22-10-06,"16 - 1022",50,50,50,0,0,1
22-10-06,"24 - 1150",118,120,116,2,2,0.983050847457627
22-10-06,"24 - 1153",239,240,238,1,1,0.99581589958159
22-10-07,"62 - 1011",56,57,56,0,1,1
22-10-07,"3 - 1008",152,154,142,10,2,0.934210526315789
22-10-07,"16 - 1022",50,50,50,0,0,1
22-10-07,"24 - 1150",118,120,118,0,2,1
22-10-07,"24 - 1153",240,240,240,0,0,1
22-10-08,"62 - 1011",56,57,56,0,1,1
22-10-08,"3 - 1008",152,154,142,10,2,0.934210526315789
22-10-08,"16 - 1022",50,50,50,0,0,1
22-10-08,"24 - 1150",116,120,116,0,4,1
22-10-08,"24 - 1153",240,240,240,0,0,1
22-10-09,"62 - 1011",56,57,56,0,1,1
22-10-09,"3 - 1008",152,154,143,9,2,0.940789473684211
22-10-09,"16 - 1022",50,50,50,0,0,1
22-10-09,"24 - 1150",114,120,114,0,6,1
22-10-09,"24 - 1153",240,240,240,0,0,1
22-10-10,"62 - 1011",56,57,56,0,1,1
22-10-10,"3 - 1008",152,154,146,6,2,0.960526315789474
22-10-10,"16 - 1022",50,50,50,0,0,1
22-10-10,"24 - 1150",113,120,113,0,7,1
22-10-10,"24 - 1153",240,240,240,0,0,1
22-10-11,"62 - 1011",56,57,56,0,1,1
22-10-11,"3 - 1008",154,154,147,7,0,0.954545454545455
22-10-11,"16 - 1022",50,50,50,0,0,1
22-10-11,"24 - 1150",115,120,113,2,5,0.982608695652174
22-10-11,"24 - 1153",239,240,239,0,1,1
22-10-12,"62 - 1011",56,57,56,0,1,1
22-10-12,"3 - 1008",154,154,149,5,0,0.967532467532468
22-10-12,"16 - 1022",50,50,50,0,0,1
22-10-12,"24 - 1150",116,120,110,6,4,0.948275862068966
22-10-12,"24 - 1153",240,240,240,0,0,1
22-10-13,"62 - 1011",56,57,54,2,1,0.964285714285714
22-10-13,"3 - 1008",153,154,148,5,1,0.967320261437909
22-10-13,"16 - 1022",50,50,49,1,0,0.98
22-10-13,"24 - 1150",118,120,116,2,2,0.983050847457627
22-10-13,"24 - 1153",238,240,238,0,2,1
22-10-14,"62 - 1011",61,62,60,1,1,0.983606557377049
22-10-14,"3 - 1008",163,164,152,11,1,0.932515337423313
22-10-14,"16 - 1022",50,50,50,0,0,1
22-10-14,"24 - 1150",115,120,115,0,5,1
22-10-14,"24 - 1153",240,240,240,0,0,1
22-10-15,"62 - 1011",61,62,61,0,1,1
22-10-15,"3 - 1008",153,154,148,5,1,0.967320261437909
22-10-15,"16 - 1022",50,50,50,0,0,1
22-10-15,"24 - 1150",115,120,115,0,5,1
22-10-15,"24 - 1153",240,240,240,0,0,1
22-10-16,"62 - 1011",61,62,60,1,1,0.983606557377049
22-10-16,"3 - 1008",163,164,152,11,1,0.932515337423313
22-10-16,"16 - 1022",50,50,50,0,0,1
22-10-16,"24 - 1150",115,120,115,0,5,1
22-10-16,"24 - 1153",240,240,240,0,0,1
22-10-17,"62 - 1011",62,63,61,1,1,0.983870967741935
22-10-17,"3 - 1008",163,164,154,9,1,0.94478527607362
22-10-17,"16 - 1022",50,50,48,2,0,0.96
22-10-17,"24 - 1150",118,120,118,0,2,1
22-10-17,"24 - 1153",240,240,240,0,0,1
22-10-18,"62 - 1011",62,63,62,0,1,1
22-10-18,"3 - 1008",164,164,159,5,0,0.969512195121951
22-10-18,"16 - 1022",50,50,48,2,0,0.96
22-10-18,"24 - 1150",120,120,120,0,0,1
22-10-18,"24 - 1153",240,240,239,1,0,0.995833333333333
22-10-19,"62 - 1011",62,63,61,1,1,0.983870967741935
22-10-19,"3 - 1008",164,164,159,5,0,0.969512195121951
22-10-19,"16 - 1022",50,50,48,2,0,0.96
22-10-19,"24 - 1150",120,120,120,0,0,1
22-10-19,"24 - 1153",240,240,240,0,0,1
22-10-20,"62 - 1011",62,63,61,1,1,0.983870967741935
22-10-20,"3 - 1008",164,164,160,4,0,0.975609756097561
22-10-20,"16 - 1022",50,50,46,4,0,0.92
22-10-20,"24 - 1150",117,120,117,0,3,1
22-10-20,"24 - 1153",240,240,240,0,0,1
22-10-21,"62 - 1011",59,60,55,4,1,0.932203389830508
22-10-21,"3 - 1008",154,154,151,3,0,0.980519480519481
22-10-21,"16 - 1022",50,50,46,4,0,0.92
22-10-21,"24 - 1150",117,120,117,0,3,1
22-10-21,"24 - 1153",240,240,240,0,0,1
22-10-22,"62 - 1011",59,60,56,3,1,0.949152542372881
22-10-22,"3 - 1008",154,154,151,3,0,0.980519480519481
22-10-22,"16 - 1022",50,50,46,4,0,0.92
22-10-22,"24 - 1150",117,120,117,0,3,1
22-10-22,"24 - 1153",240,240,240,0,0,1
22-10-23,"62 - 1011",59,60,57,2,1,0.966101694915254
22-10-23,"3 - 1008",154,154,151,3,0,0.980519480519481
22-10-23,"16 - 1022",50,50,48,2,0,0.96
22-10-23,"24 - 1150",119,120,116,3,1,0.974789915966387
22-10-23,"24 - 1153",240,240,240,0,0,1
22-10-24,"62 - 1011",59,60,57,2,1,0.966101694915254
22-10-24,"3 - 1008",154,154,149,5,0,0.967532467532468
22-10-24,"16 - 1022",50,50,49,1,0,0.98
22-10-24,"24 - 1150",119,120,118,1,1,0.991596638655462
22-10-24,"24 - 1153",238,240,238,0,2,1
22-10-25,"62 - 1011",59,60,56,3,1,0.949152542372881
22-10-25,"3 - 1008",154,154,152,2,0,0.987012987012987
22-10-25,"16 - 1022",50,50,49,1,0,0.98
22-10-25,"24 - 1150",118,120,116,2,2,0.983050847457627
22-10-25,"24 - 1153",237,240,237,0,3,1
22-10-26,"62 - 1011",59,60,55,4,1,0.932203389830508
22-10-26,"3 - 1008",154,154,149,5,0,0.967532467532468
22-10-26,"16 - 1022",50,50,50,0,0,1
22-10-26,"24 - 1150",113,120,113,0,7,1
22-10-26,"24 - 1153",237,240,237,0,3,1
22-10-27,"62 - 1011",59,60,54,5,1,0.915254237288136
22-10-27,"3 - 1008",154,154,151,3,0,0.980519480519481
22-10-27,"16 - 1022",50,50,50,0,0,1
22-10-27,"24 - 1150",112,120,112,0,8,1
22-10-27,"24 - 1153",237,240,237,0,3,1
22-10-28,"62 - 1011",59,60,55,4,1,0.932203389830508
22-10-28,"3 - 1008",154,154,152,2,0,0.987012987012987
22-10-28,"16 - 1022",50,50,48,2,0,0.96
22-10-28,"24 - 1150",114,120,114,0,6,1
22-10-28,"24 - 1153",236,240,236,0,4,1
22-10-29,"62 - 1011",59,60,56,3,1,0.949152542372881
22-10-29,"3 - 1008",154,154,152,2,0,0.987012987012987
22-10-29,"16 - 1022",50,50,48,2,0,0.96
22-10-29,"24 - 1150",114,120,114,0,6,1
22-10-29,"24 - 1153",235,240,235,0,5,1
22-10-30,"62 - 1011",59,60,53,6,1,0.898305084745763
22-10-30,"3 - 1008",154,154,152,2,0,0.987012987012987
22-10-30,"16 - 1022",50,50,47,3,0,0.94
22-10-30,"24 - 1150",112,120,109,3,8,0.973214285714286
22-10-30,"24 - 1153",235,240,235,0,5,1
22-10-31,"62 - 1011",59,60,56,3,1,0.949152542372881
22-10-31,"3 - 1008",164,164,155,9,0,0.945121951219512
22-10-31,"16 - 1022",50,50,48,2,0,0.96
22-10-31,"24 - 1150",108,120,108,0,12,1
22-10-31,"24 - 1153",232,240,232,0,8,1
22-11-01,"62 - 1011",64,65,62,2,1,0.96875
22-11-01,"3 - 1008",163,164,156,7,1,0.957055214723926
22-11-01,"16 - 1022",50,50,49,1,0,0.98
22-11-01,"24 - 1150",106,120,106,0,14,1
22-11-01,"24 - 1153",231,240,231,0,9,1
22-11-02,"62 - 1011",59,60,56,3,1,0.949152542372881
22-11-02,"3 - 1008",154,154,150,4,0,0.974025974025974
22-11-02,"16 - 1022",50,50,46,4,0,0.92
22-11-02,"24 - 1150",100,120,100,0,20,1
22-11-02,"24 - 1153",226,240,226,0,14,1
22-11-03,"62 - 1011",59,60,55,4,1,0.932203389830508
22-11-03,"3 - 1008",154,154,149,5,0,0.967532467532468
22-11-03,"16 - 1022",50,50,43,7,0,0.86
22-11-03,"24 - 1150",103,120,103,0,17,1
22-11-03,"24 - 1153",223,240,223,0,17,1
22-11-04,"62 - 1011",79,84,54,25,5,0.683544303797468
22-11-04,"3 - 1008",154,154,149,5,0,0.967532467532468
22-11-04,"16 - 1022",50,50,42,8,0,0.84
22-11-04,"24 - 1150",96,120,96,0,24,1
22-11-04,"24 - 1153",222,240,222,0,18,1
22-11-05,"62 - 1011",79,84,55,24,5,0.69620253164557
22-11-05,"3 - 1008",154,154,151,3,0,0.980519480519481
22-11-05,"16 - 1022",49,50,39,10,1,0.795918367346939
22-11-05,"24 - 1150",96,120,96,0,24,1
22-11-05,"24 - 1153",220,240,220,0,20,1
22-11-06,"62 - 1011",79,84,54,25,5,0.683544303797468
22-11-06,"3 - 1008",154,154,152,2,0,0.987012987012987
22-11-06,"16 - 1022",50,50,41,9,0,0.82
22-11-06,"24 - 1150",91,120,91,0,29,1
22-11-06,"24 - 1153",220,240,220,0,20,1
22-11-07,"62 - 1011",79,84,57,22,5,0.721518987341772
22-11-07,"3 - 1008",154,154,152,2,0,0.987012987012987
22-11-07,"16 - 1022",50,50,40,10,0,0.8
22-11-07,"24 - 1150",95,120,95,0,25,1
22-11-07,"24 - 1153",230,240,230,0,10,1
22-11-08,"62 - 1011",79,84,57,22,5,0.721518987341772
22-11-08,"3 - 1008",154,154,153,1,0,0.993506493506494
22-11-08,"16 - 1022",50,50,40,10,0,0.8
22-11-08,"24 - 1150",97,120,97,0,23,1
22-11-08,"24 - 1153",230,240,230,0,10,1
22-11-09,"62 - 1011",79,84,57,22,5,0.721518987341772
22-11-09,"3 - 1008",154,154,152,2,0,0.987012987012987
22-11-09,"16 - 1022",50,50,40,10,0,0.8
22-11-09,"24 - 1150",95,120,95,0,25,1
22-11-09,"24 - 1153",230,240,230,0,10,1
22-11-10,"62 - 1011",79,84,57,22,5,0.721518987341772
22-11-10,"3 - 1008",154,154,152,2,0,0.987012987012987
22-11-10,"16 - 1022",50,50,39,11,0,0.78
22-11-10,"24 - 1150",96,120,96,0,24,1
22-11-10,"24 - 1153",226,240,226,0,14,1
22-11-11,"62 - 1011",79,84,57,22,5,0.721518987341772
22-11-11,"3 - 1008",154,154,151,3,0,0.980519480519481
22-11-11,"16 - 1022",50,50,38,12,0,0.76
22-11-11,"24 - 1150",95,120,95,0,25,1
22-11-11,"24 - 1153",222,240,222,0,18,1
22-11-12,"62 - 1011",79,84,58,21,5,0.734177215189873
22-11-12,"3 - 1008",154,154,151,3,0,0.980519480519481
22-11-12,"16 - 1022",50,50,38,12,0,0.76
22-11-12,"24 - 1150",95,120,95,0,25,1
22-11-12,"24 - 1153",219,240,219,0,21,1
22-11-13,"62 - 1011",79,84,59,20,5,0.746835443037975
22-11-13,"3 - 1008",154,154,152,2,0,0.987012987012987
22-11-13,"16 - 1022",50,50,38,12,0,0.76
22-11-13,"24 - 1150",92,120,92,0,28,1
22-11-13,"24 - 1153",216,240,216,0,24,1
22-11-14,"62 - 1011",79,84,60,19,5,0.759493670886076
22-11-14,"3 - 1008",154,154,152,2,0,0.987012987012987
22-11-14,"16 - 1022",50,50,42,8,0,0.84
22-11-14,"24 - 1150",94,120,94,0,26,1
22-11-14,"24 - 1153",232,240,227,5,8,0.978448275862069
22-11-15,"62 - 1011",84,89,69,15,5,0.821428571428571
22-11-15,"3 - 1008",154,154,151,3,0,0.980519480519481
22-11-15,"16 - 1022",50,50,42,8,0,0.84
22-11-15,"24 - 1150",98,140,98,0,42,1
22-11-15,"24 - 1153",240,240,237,3,0,0.9875
22-11-16,"62 - 1011",84,89,65,19,5,0.773809523809524
22-11-16,"3 - 1008",164,174,161,3,10,0.981707317073171
22-11-16,"16 - 1022",53,53,45,8,0,0.849056603773585
22-11-16,"24 - 1150",104,140,104,0,36,1
22-11-16,"24 - 1153",240,240,240,0,0,1
22-11-17,"62 - 1011",84,89,65,19,5,0.773809523809524
22-11-17,"3 - 1008",174,174,169,5,0,0.971264367816092
22-11-17,"16 - 1022",53,53,46,7,0,0.867924528301887
22-11-17,"24 - 1150",103,140,101,2,37,0.980582524271845
22-11-17,"24 - 1153",240,240,240,0,0,1
22-11-18,"62 - 1011",84,89,73,11,5,0.869047619047619
22-11-18,"3 - 1008",194,194,183,11,0,0.943298969072165
22-11-18,"16 - 1022",53,53,46,7,0,0.867924528301887
22-11-18,"24 - 1150",103,140,103,0,37,1
22-11-18,"24 - 1153",240,240,240,0,0,1
22-11-19,"62 - 1011",84,89,71,13,5,0.845238095238095
22-11-19,"3 - 1008",194,194,191,3,0,0.984536082474227
22-11-19,"16 - 1022",53,53,46,7,0,0.867924528301887
22-11-19,"24 - 1150",102,140,102,0,38,1
22-11-19,"24 - 1153",240,240,240,0,0,1
22-11-20,"62 - 1011",84,89,72,12,5,0.857142857142857
22-11-20,"3 - 1008",214,214,210,4,0,0.981308411214953
22-11-20,"16 - 1022",53,53,47,6,0,0.886792452830189
22-11-20,"24 - 1150",104,140,104,0,36,1
22-11-20,"24 - 1153",240,240,239,1,0,0.995833333333333
22-11-21,"62 - 1011",84,89,72,12,5,0.857142857142857
22-11-21,"3 - 1008",214,214,212,2,0,0.990654205607477
22-11-21,"16 - 1022",53,53,49,4,0,0.924528301886792
22-11-21,"24 - 1150",105,150,103,2,45,0.980952380952381
22-11-21,"24 - 1153",240,240,239,1,0,0.995833333333333
22-11-22,"62 - 1011",83,89,70,13,6,0.843373493975904
22-11-22,"3 - 1008",224,226,222,2,2,0.991071428571429
22-11-22,"16 - 1022",53,53,50,3,0,0.943396226415094
22-11-22,"24 - 1150",111,150,109,2,39,0.981981981981982
22-11-22,"24 - 1153",240,240,240,0,0,1
22-11-23,"62 - 1011",82,89,74,8,7,0.902439024390244
22-11-23,"3 - 1008",224,226,219,5,2,0.977678571428571
22-11-23,"16 - 1022",53,53,52,1,0,0.981132075471698
22-11-23,"24 - 1150",122,150,116,6,28,0.950819672131147
22-11-23,"24 - 1153",237,240,237,0,3,1
22-11-24,"62 - 1011",81,89,70,11,8,0.864197530864197
22-11-24,"3 - 1008",223,226,221,2,3,0.991031390134529
22-11-24,"16 - 1022",53,53,51,2,0,0.962264150943396
22-11-24,"24 - 1150",131,150,127,4,19,0.969465648854962
22-11-24,"24 - 1153",237,240,237,0,3,1
22-11-25,"62 - 1011",80,89,70,10,9,0.875
22-11-25,"3 - 1008",224,226,221,3,2,0.986607142857143
22-11-25,"16 - 1022",53,53,52,1,0,0.981132075471698
22-11-25,"24 - 1150",130,170,129,1,40,0.992307692307692
22-11-25,"24 - 1153",237,240,237,0,3,1
22-11-26,"62 - 1011",79,84,69,10,5,0.873417721518987
22-11-26,"3 - 1008",224,226,220,4,2,0.982142857142857
22-11-26,"16 - 1022",53,53,51,2,0,0.962264150943396
22-11-26,"24 - 1150",128,170,128,0,42,1
22-11-26,"24 - 1153",237,240,236,1,3,0.9957805907173
22-11-27,"62 - 1011",79,84,69,10,5,0.873417721518987
22-11-27,"3 - 1008",225,226,221,4,1,0.982222222222222
22-11-27,"16 - 1022",53,53,50,3,0,0.943396226415094
22-11-27,"24 - 1150",124,170,124,0,46,1
22-11-27,"24 - 1153",236,240,236,0,4,1
22-11-28,"62 - 1011",79,84,69,10,5,0.873417721518987
22-11-28,"3 - 1008",230,236,225,5,6,0.978260869565217
22-11-28,"16 - 1022",53,53,51,2,0,0.962264150943396
22-11-28,"24 - 1150",124,180,124,0,56,1
22-11-28,"24 - 1153",234,240,234,0,6,1
22-11-29,"62 - 1011",79,84,69,10,5,0.873417721518987
22-11-29,"3 - 1008",231,236,228,3,5,0.987012987012987
22-11-29,"16 - 1022",53,53,51,2,0,0.962264150943396
22-11-29,"24 - 1150",165,217,160,5,52,0.96969696969697
22-11-29,"24 - 1153",235,254,235,0,19,1
22-11-30,"62 - 1011",79,84,67,12,5,0.848101265822785
22-11-30,"3 - 1008",231,236,229,2,5,0.991341991341991
22-11-30,"16 - 1022",53,53,49,4,0,0.924528301886792
22-11-30,"24 - 1150",174,217,174,0,43,1
22-11-30,"24 - 1153",241,254,240,1,13,0.995850622406639
22-12-01,"62 - 1011",79,84,68,11,5,0.860759493670886
22-12-01,"3 - 1008",231,236,228,3,5,0.987012987012987
22-12-01,"16 - 1022",53,53,48,5,0,0.905660377358491
22-12-01,"24 - 1150",165,266,165,0,101,1
22-12-01,"24 - 1153",244,254,243,1,10,0.995901639344262
22-12-02,"62 - 1011",79,84,69,10,5,0.873417721518987
22-12-02,"3 - 1008",230,236,224,6,6,0.973913043478261
22-12-02,"16 - 1022",53,53,52,1,0,0.981132075471698
22-12-02,"24 - 1150",181,266,181,0,85,1
22-12-02,"24 - 1153",247,254,246,1,7,0.995951417004049
22-12-03,"62 - 1011",79,84,69,10,5,0.873417721518987
22-12-03,"3 - 1008",230,236,226,4,6,0.982608695652174
22-12-03,"16 - 1022",53,53,50,3,0,0.943396226415094
22-12-03,"24 - 1150",179,266,179,0,87,1
22-12-03,"24 - 1153",247,254,244,3,7,0.987854251012146
22-12-04,"62 - 1011",79,84,69,10,5,0.873417721518987
22-12-04,"3 - 1008",230,236,228,2,6,0.991304347826087
22-12-04,"16 - 1022",53,53,50,3,0,0.943396226415094
22-12-04,"24 - 1150",179,266,178,1,87,0.994413407821229
22-12-04,"24 - 1153",246,254,244,2,8,0.991869918699187
22-12-05,"62 - 1011",79,84,72,7,5,0.911392405063291
22-12-05,"3 - 1008",230,236,227,3,6,0.98695652173913
22-12-05,"16 - 1022",53,53,49,4,0,0.924528301886792
22-12-05,"24 - 1150",201,266,195,6,65,0.970149253731343
22-12-05,"24 - 1153",247,254,247,0,7,1
22-12-06,"62 - 1011",79,84,71,8,5,0.89873417721519
22-12-06,"3 - 1008",230,236,228,2,6,0.991304347826087
22-12-06,"16 - 1022",53,53,49,4,0,0.924528301886792
22-12-06,"24 - 1150",233,266,215,18,33,0.92274678111588
22-12-06,"24 - 1153",247,254,247,0,7,1
22-12-07,"62 - 1011",79,84,71,8,5,0.89873417721519
22-12-07,"3 - 1008",230,236,227,3,6,0.98695652173913
22-12-07,"16 - 1022",53,53,50,3,0,0.943396226415094
22-12-07,"24 - 1150",241,266,238,3,25,0.987551867219917
22-12-07,"24 - 1153",247,254,242,5,7,0.979757085020243
22-12-08,"62 - 1011",79,84,71,8,5,0.89873417721519
22-12-08,"3 - 1008",230,236,228,2,6,0.991304347826087
22-12-08,"16 - 1022",53,53,52,1,0,0.981132075471698
22-12-08,"24 - 1150",245,266,238,7,21,0.971428571428571
22-12-08,"24 - 1153",252,254,247,5,2,0.98015873015873
22-12-09,"62 - 1011",79,84,70,9,5,0.886075949367089
22-12-09,"3 - 1008",229,236,228,1,7,0.995633187772926
22-12-09,"16 - 1022",53,53,51,2,0,0.962264150943396
22-12-09,"24 - 1150",241,266,235,6,25,0.975103734439834
22-12-09,"24 - 1153",252,254,243,9,2,0.964285714285714
22-12-10,"62 - 1011",79,84,70,9,5,0.886075949367089
22-12-10,"3 - 1008",229,236,227,2,7,0.991266375545852
22-12-10,"16 - 1022",53,53,51,2,0,0.962264150943396
22-12-10,"24 - 1150",241,266,240,1,25,0.995850622406639
22-12-10,"24 - 1153",249,254,248,1,5,0.995983935742972
22-12-11,"62 - 1011",79,84,70,9,5,0.886075949367089
22-12-11,"3 - 1008",229,236,226,3,7,0.986899563318777
22-12-11,"16 - 1022",53,53,51,2,0,0.962264150943396
22-12-11,"24 - 1150",244,266,242,2,22,0.991803278688525
22-12-11,"24 - 1153",249,254,248,1,5,0.995983935742972
22-12-12,"62 - 1011",79,84,70,9,5,0.886075949367089
22-12-12,"3 - 1008",228,236,227,1,8,0.995614035087719
22-12-12,"16 - 1022",53,53,52,1,0,0.981132075471698
22-12-12,"24 - 1150",245,266,240,5,21,0.979591836734694
22-12-12,"24 - 1153",249,254,247,2,5,0.991967871485944
22-12-13,"62 - 1011",79,84,70,9,5,0.886075949367089
22-12-13,"3 - 1008",229,236,229,0,7,1
22-12-13,"16 - 1022",53,53,52,1,0,0.981132075471698
22-12-13,"24 - 1150",244,266,239,5,22,0.979508196721312
22-12-13,"24 - 1153",248,254,248,0,6,1
22-12-14,"62 - 1011",79,84,70,9,5,0.886075949367089
22-12-14,"3 - 1008",229,236,229,0,7,1
22-12-14,"16 - 1022",53,53,51,2,0,0.962264150943396
22-12-14,"24 - 1150",243,266,240,3,23,0.987654320987654
22-12-14,"24 - 1153",248,254,247,1,6,0.995967741935484
22-12-15,"62 - 1011",79,84,70,9,5,0.886075949367089
22-12-15,"3 - 1008",230,236,230,0,6,1
22-12-15,"16 - 1022",53,53,51,2,0,0.962264150943396
22-12-15,"24 - 1150",243,266,241,2,23,0.991769547325103
22-12-15,"24 - 1153",248,254,248,0,6,1
22-12-16,"62 - 1011",79,84,70,9,5,0.886075949367089
22-12-16,"3 - 1008",230,236,230,0,6,1
22-12-16,"16 - 1022",53,53,50,3,0,0.943396226415094
22-12-16,"24 - 1150",244,266,243,1,22,0.995901639344262
22-12-16,"24 - 1153",252,279,251,1,27,0.996031746031746
22-12-17,"62 - 1011",79,84,70,9,5,0.886075949367089
22-12-17,"3 - 1008",230,236,230,0,6,1
22-12-17,"16 - 1022",53,53,50,3,0,0.943396226415094
22-12-17,"24 - 1150",240,266,239,1,26,0.995833333333333
22-12-17,"24 - 1153",252,279,252,0,27,1
22-12-18,"62 - 1011",79,84,70,9,5,0.886075949367089
22-12-18,"3 - 1008",230,236,230,0,6,1
22-12-18,"16 - 1022",53,53,50,3,0,0.943396226415094
22-12-18,"24 - 1150",241,266,241,0,25,1
22-12-18,"24 - 1153",252,279,251,1,27,0.996031746031746
22-12-19,"62 - 1011",79,84,69,10,5,0.873417721518987
22-12-19,"3 - 1008",230,236,230,0,6,1
22-12-19,"16 - 1022",53,53,51,2,0,0.962264150943396
22-12-19,"24 - 1150",243,266,239,4,23,0.983539094650206
22-12-19,"24 - 1153",261,304,260,1,43,0.996168582375479
22-12-20,"62 - 1011",76,82,68,8,6,0.894736842105263
22-12-20,"3 - 1008",229,236,227,2,7,0.991266375545852
22-12-20,"16 - 1022",53,53,52,1,0,0.981132075471698
22-12-20,"24 - 1150",241,266,239,2,25,0.991701244813278
22-12-20,"24 - 1153",267,304,267,0,37,1
22-12-21,"62 - 1011",76,82,68,8,6,0.894736842105263
22-12-21,"3 - 1008",228,236,228,0,8,1
22-12-21,"16 - 1022",53,53,49,4,0,0.924528301886792
22-12-21,"24 - 1150",242,266,241,1,24,0.995867768595041
22-12-21,"24 - 1153",267,304,266,1,37,0.99625468164794
22-12-22,"62 - 1011",76,82,68,8,6,0.894736842105263
22-12-22,"3 - 1008",229,236,228,1,7,0.995633187772926
22-12-22,"16 - 1022",53,53,48,5,0,0.905660377358491
22-12-22,"24 - 1150",239,266,235,4,27,0.98326359832636
22-12-22,"24 - 1153",267,314,266,1,47,0.99625468164794
22-12-23,"62 - 1011",76,82,67,9,6,0.881578947368421
22-12-23,"3 - 1008",230,236,228,2,6,0.991304347826087
22-12-23,"16 - 1022",53,53,44,9,0,0.830188679245283
22-12-23,"24 - 1150",247,266,245,2,19,0.991902834008097
22-12-23,"24 - 1153",278,399,270,8,121,0.971223021582734
22-12-24,"62 - 1011",76,82,69,7,6,0.907894736842105
22-12-24,"3 - 1008",230,236,228,2,6,0.991304347826087
22-12-24,"16 - 1022",53,53,47,6,0,0.886792452830189
22-12-24,"24 - 1150",248,266,244,4,18,0.983870967741935
22-12-24,"24 - 1153",278,399,277,1,121,0.996402877697842
22-12-25,"62 - 1011",76,82,69,7,6,0.907894736842105
22-12-25,"3 - 1008",230,236,228,2,6,0.991304347826087
22-12-25,"16 - 1022",53,53,47,6,0,0.886792452830189
22-12-25,"24 - 1150",248,266,246,2,18,0.991935483870968
22-12-25,"24 - 1153",278,399,278,0,121,1
22-12-26,"62 - 1011",76,82,68,8,6,0.894736842105263
22-12-26,"3 - 1008",230,236,226,4,6,0.982608695652174
22-12-26,"16 - 1022",53,53,47,6,0,0.886792452830189
22-12-26,"24 - 1150",248,266,247,1,18,0.995967741935484
22-12-26,"24 - 1153",278,399,276,2,121,0.992805755395683
22-12-27,"62 - 1011",76,82,68,8,6,0.894736842105263
22-12-27,"3 - 1008",230,236,225,5,6,0.978260869565217
22-12-27,"16 - 1022",53,53,47,6,0,0.886792452830189
22-12-27,"24 - 1150",249,266,248,1,17,0.995983935742972
22-12-27,"24 - 1153",278,399,278,0,121,1
22-12-28,"62 - 1011",76,82,68,8,6,0.894736842105263
22-12-28,"3 - 1008",229,236,226,3,7,0.986899563318777
22-12-28,"16 - 1022",53,53,47,6,0,0.886792452830189
22-12-28,"24 - 1150",248,266,247,1,18,0.995967741935484
22-12-28,"24 - 1153",284,399,282,2,115,0.992957746478873
22-12-29,"62 - 1011",76,82,69,7,6,0.907894736842105
22-12-29,"3 - 1008",226,236,219,7,10,0.969026548672566
22-12-29,"16 - 1022",53,53,47,6,0,0.886792452830189
22-12-29,"24 - 1150",248,266,246,2,18,0.991935483870968
22-12-29,"24 - 1153",284,399,281,3,115,0.98943661971831
22-12-30,"62 - 1011",78,82,75,3,4,0.961538461538462
22-12-30,"3 - 1008",221,236,219,2,15,0.990950226244344
22-12-30,"16 - 1022",53,53,49,4,0,0.924528301886792
22-12-30,"24 - 1150",250,266,248,2,16,0.992
22-12-30,"24 - 1153",284,399,284,0,115,1
22-12-31,"62 - 1011",79,82,76,3,3,0.962025316455696
22-12-31,"3 - 1008",225,236,224,1,11,0.995555555555556
22-12-31,"16 - 1022",53,53,49,4,0,0.924528301886792
22-12-31,"24 - 1150",249,266,248,1,17,0.995983935742972
22-12-31,"24 - 1153",284,399,284,0,115,1
2023-01-01,"62 - 1011",79,82,76,3,3,0.962025316455696
2023-01-01,"3 - 1008",225,236,224,1,11,0.995555555555556
2023-01-01,"16 - 1022",53,53,47,6,0,0.886792452830189
2023-01-01,"24 - 1150",249,266,247,2,17,0.991967871485944
2023-01-01,"24 - 1153",284,399,284,0,115,1
2023-01-02,"62 - 1011",79,82,78,1,3,0.987341772151899
2023-01-02,"3 - 1008",225,236,221,4,11,0.982222222222222
2023-01-02,"16 - 1022",53,53,46,7,0,0.867924528301887
2023-01-02,"24 - 1150",248,266,247,1,18,0.995967741935484
2023-01-02,"24 - 1153",283,399,283,0,116,1
2023-01-03,"62 - 1011",79,82,78,1,3,0.987341772151899
2023-01-03,"3 - 1008",222,236,222,0,14,1
2023-01-03,"16 - 1022",53,53,48,5,0,0.905660377358491
2023-01-03,"24 - 1150",249,266,247,2,17,0.991967871485944
2023-01-03,"24 - 1153",286,399,284,2,113,0.993006993006993
2023-01-04,"62 - 1011",79,82,75,4,3,0.949367088607595
2023-01-04,"3 - 1008",220,236,219,1,16,0.995454545454545
2023-01-04,"16 - 1022",53,53,50,3,0,0.943396226415094
2023-01-04,"24 - 1150",249,266,249,0,17,1
2023-01-04,"24 - 1153",291,399,291,0,108,1
2023-01-05,"62 - 1011",79,82,75,4,3,0.949367088607595
2023-01-05,"3 - 1008",220,236,220,0,16,1
2023-01-05,"16 - 1022",53,53,49,4,0,0.924528301886792
2023-01-05,"24 - 1150",249,266,249,0,17,1
2023-01-05,"24 - 1153",293,399,292,1,106,0.996587030716723
2023-01-06,"62 - 1011",79,82,75,4,3,0.949367088607595
2023-01-06,"3 - 1008",222,236,221,1,14,0.995495495495496
2023-01-06,"16 - 1022",53,53,49,4,0,0.924528301886792
2023-01-06,"24 - 1150",252,266,251,1,14,0.996031746031746
2023-01-06,"24 - 1153",293,399,293,0,106,1
2023-01-07,"62 - 1011",79,82,76,3,3,0.962025316455696
2023-01-07,"3 - 1008",222,236,218,4,14,0.981981981981982
2023-01-07,"16 - 1022",53,53,46,7,0,0.867924528301887
2023-01-07,"24 - 1150",251,266,250,1,15,0.99601593625498
2023-01-07,"24 - 1153",293,399,293,0,106,1
2023-01-08,"62 - 1011",79,82,75,4,3,0.949367088607595
2023-01-08,"3 - 1008",225,236,224,1,11,0.995555555555556
2023-01-08,"16 - 1022",53,53,46,7,0,0.867924528301887
2023-01-08,"24 - 1150",251,266,251,0,15,1
2023-01-08,"24 - 1153",294,399,294,0,105,1
2023-01-09,"62 - 1011",79,82,76,3,3,0.962025316455696
2023-01-09,"3 - 1008",222,236,220,2,14,0.990990990990991
2023-01-09,"16 - 1022",53,53,46,7,0,0.867924528301887
2023-01-09,"24 - 1150",251,266,250,1,15,0.99601593625498
2023-01-09,"24 - 1153",299,399,299,0,100,1
2023-01-10,"62 - 1011",79,82,75,4,3,0.949367088607595
2023-01-10,"3 - 1008",225,236,222,3,11,0.986666666666667
2023-01-10,"16 - 1022",53,53,46,7,0,0.867924528301887
2023-01-10,"24 - 1150",253,266,250,3,13,0.988142292490119
2023-01-10,"24 - 1153",299,399,299,0,100,1
2023-01-11,"62 - 1011",79,88,76,3,9,0.962025316455696
2023-01-11,"3 - 1008",227,236,223,4,9,0.982378854625551
2023-01-11,"16 - 1022",53,53,46,7,0,0.867924528301887
2023-01-11,"24 - 1150",259,266,256,3,7,0.988416988416988
2023-01-11,"24 - 1153",305,399,305,0,94,1
2023-01-12,"62 - 1011",79,88,76,3,9,0.962025316455696
2023-01-12,"3 - 1008",227,236,226,1,9,0.995594713656388
2023-01-12,"16 - 1022",53,53,44,9,0,0.830188679245283
2023-01-12,"24 - 1150",259,266,253,6,7,0.976833976833977
2023-01-12,"24 - 1153",311,399,311,0,88,1
2023-01-13,"62 - 1011",81,88,76,5,7,0.938271604938272
2023-01-13,"3 - 1008",227,236,227,0,9,1
2023-01-13,"16 - 1022",53,53,46,7,0,0.867924528301887
2023-01-13,"24 - 1150",259,266,258,1,7,0.996138996138996
2023-01-13,"24 - 1153",312,399,311,1,87,0.996794871794872
2023-01-14,"62 - 1011",81,88,78,3,7,0.962962962962963
2023-01-14,"3 - 1008",228,236,226,2,8,0.991228070175439
2023-01-14,"16 - 1022",52,53,47,5,1,0.903846153846154
2023-01-14,"24 - 1150",259,266,259,0,7,1
2023-01-14,"24 - 1153",312,399,310,2,87,0.993589743589744
2023-01-15,"62 - 1011",81,88,78,3,7,0.962962962962963
2023-01-15,"3 - 1008",228,236,228,0,8,1
2023-01-15,"16 - 1022",52,53,47,5,1,0.903846153846154
2023-01-15,"24 - 1150",259,266,255,4,7,0.984555984555985
2023-01-15,"24 - 1153",312,399,312,0,87,1
2023-01-16,"62 - 1011",81,88,76,5,7,0.938271604938272
2023-01-16,"3 - 1008",227,236,226,1,9,0.995594713656388
2023-01-16,"16 - 1022",52,53,50,2,1,0.961538461538462
2023-01-16,"24 - 1150",258,266,253,5,8,0.98062015503876
2023-01-16,"24 - 1153",321,402,321,0,81,1
2023-01-17,"62 - 1011",81,88,75,6,7,0.925925925925926
2023-01-17,"3 - 1008",227,236,225,2,9,0.991189427312775
2023-01-17,"16 - 1022",52,53,52,0,1,1
2023-01-17,"24 - 1150",259,266,255,4,7,0.984555984555985
2023-01-17,"24 - 1153",322,402,322,0,80,1
2023-01-18,"62 - 1011",81,88,76,5,7,0.938271604938272
2023-01-18,"3 - 1008",226,236,225,1,10,0.995575221238938
2023-01-18,"16 - 1022",52,53,52,0,1,1
2023-01-18,"24 - 1150",258,266,255,3,8,0.988372093023256
2023-01-18,"24 - 1153",338,422,336,2,84,0.994082840236686
2023-01-19,"62 - 1011",81,88,77,4,7,0.950617283950617
2023-01-19,"3 - 1008",230,236,228,2,6,0.991304347826087
2023-01-19,"16 - 1022",52,53,51,1,1,0.980769230769231
2023-01-19,"24 - 1150",259,266,257,2,7,0.992277992277992
2023-01-19,"24 - 1153",333,354,332,1,21,0.996996996996997
2023-01-20,"62 - 1011",81,88,77,4,7,0.950617283950617
2023-01-20,"3 - 1008",230,236,228,2,6,0.991304347826087
2023-01-20,"16 - 1022",52,53,50,2,1,0.961538461538462
2023-01-20,"24 - 1150",258,266,254,4,8,0.984496124031008
2023-01-20,"24 - 1153",334,362,333,1,28,0.997005988023952
2023-01-21,"62 - 1011",81,88,78,3,7,0.962962962962963
2023-01-21,"3 - 1008",230,236,228,2,6,0.991304347826087
2023-01-21,"16 - 1022",52,53,49,3,1,0.942307692307692
2023-01-21,"24 - 1150",258,266,254,4,8,0.984496124031008
2023-01-21,"24 - 1153",336,362,335,1,26,0.99702380952381
2023-01-22,"62 - 1011",81,88,79,2,7,0.975308641975309
2023-01-22,"3 - 1008",230,236,227,3,6,0.98695652173913
2023-01-22,"16 - 1022",52,53,49,3,1,0.942307692307692
2023-01-22,"24 - 1150",258,266,254,4,8,0.984496124031008
2023-01-22,"24 - 1153",337,362,337,0,25,1
2023-01-23,"62 - 1011",81,88,78,3,7,0.962962962962963
2023-01-23,"3 - 1008",228,236,226,2,8,0.991228070175439
2023-01-23,"16 - 1022",53,53,52,1,0,0.981132075471698
2023-01-23,"24 - 1150",259,266,257,2,7,0.992277992277992
2023-01-23,"24 - 1153",341,362,339,2,21,0.994134897360704
2023-01-24,"62 - 1011",81,98,78,3,17,0.962962962962963
2023-01-24,"3 - 1008",228,236,226,2,8,0.991228070175439
2023-01-24,"16 - 1022",53,53,51,2,0,0.962264150943396
2023-01-24,"24 - 1150",259,266,259,0,7,1
2023-01-24,"24 - 1153",343,362,343,0,19,1
2023-01-25,"62 - 1011",80,98,77,3,18,0.9625
2023-01-25,"3 - 1008",227,236,225,2,9,0.991189427312775
2023-01-25,"16 - 1022",53,53,51,2,0,0.962264150943396
2023-01-25,"24 - 1150",258,266,256,2,8,0.992248062015504
2023-01-25,"24 - 1153",346,365,343,3,19,0.991329479768786
2023-01-26,"62 - 1011",81,98,77,4,17,0.950617283950617
2023-01-26,"3 - 1008",227,236,226,1,9,0.995594713656388
2023-01-26,"16 - 1022",53,53,51,2,0,0.962264150943396
2023-01-26,"24 - 1150",259,266,253,6,7,0.976833976833977
2023-01-26,"24 - 1153",344,355,344,0,11,1
2023-01-27,"62 - 1011",81,98,76,5,17,0.938271604938272
2023-01-27,"3 - 1008",228,236,227,1,8,0.995614035087719
2023-01-27,"16 - 1022",53,53,51,2,0,0.962264150943396
2023-01-27,"24 - 1150",257,266,254,3,9,0.988326848249027
2023-01-27,"24 - 1153",345,355,340,5,10,0.985507246376812
2023-01-28,"62 - 1011",81,98,76,5,17,0.938271604938272
2023-01-28,"3 - 1008",228,236,226,2,8,0.991228070175439
2023-01-28,"16 - 1022",53,53,53,0,0,1
2023-01-28,"24 - 1150",257,266,254,3,9,0.988326848249027
2023-01-28,"24 - 1153",349,355,347,2,6,0.994269340974212
2023-01-29,"62 - 1011",81,98,76,5,17,0.938271604938272
2023-01-29,"3 - 1008",228,236,228,0,8,1
2023-01-29,"16 - 1022",53,53,53,0,0,1
2023-01-29,"24 - 1150",257,266,256,1,9,0.996108949416342
2023-01-29,"24 - 1153",349,355,348,1,6,0.997134670487106
2023-01-30,"62 - 1011",81,98,77,4,17,0.950617283950617
2023-01-30,"3 - 1008",228,236,227,1,8,0.995614035087719
2023-01-30,"16 - 1022",53,53,53,0,0,1
2023-01-30,"24 - 1150",257,266,256,1,9,0.996108949416342
2023-01-30,"24 - 1153",348,355,348,0,7,1
2023-01-31,"62 - 1011",81,98,77,4,17,0.950617283950617
2023-01-31,"3 - 1008",230,236,227,3,6,0.98695652173913
2023-01-31,"16 - 1022",53,53,52,1,0,0.981132075471698
2023-01-31,"24 - 1150",256,266,256,0,10,1
2023-01-31,"24 - 1153",348,355,348,0,7,1
2023-02-01,"62 - 1011",86,98,81,5,12,0.941860465116279
2023-02-01,"3 - 1008",234,236,229,5,2,0.978632478632479
2023-02-01,"16 - 1022",53,53,51,2,0,0.962264150943396
2023-02-01,"24 - 1150",256,266,255,1,10,0.99609375
2023-02-01,"24 - 1153",350,355,349,1,5,0.997142857142857
2023-02-02,"62 - 1011",83,98,81,2,15,0.975903614457831
2023-02-02,"3 - 1008",233,236,230,3,3,0.987124463519313
2023-02-02,"16 - 1022",53,53,52,1,0,0.981132075471698
2023-02-02,"24 - 1150",259,266,254,5,7,0.980694980694981
2023-02-02,"24 - 1153",352,355,352,0,3,1
2023-02-03,"62 - 1011",83,98,81,2,15,0.975903614457831
2023-02-03,"3 - 1008",233,236,228,5,3,0.978540772532189
2023-02-03,"16 - 1022",53,53,53,0,0,1
2023-02-03,"24 - 1150",259,266,257,2,7,0.992277992277992
2023-02-03,"24 - 1153",352,355,351,1,3,0.997159090909091
2023-02-04,"62 - 1011",97,98,81,16,1,0.835051546391753
2023-02-04,"3 - 1008",233,236,226,7,3,0.969957081545064
2023-02-04,"16 - 1022",53,53,53,0,0,1
2023-02-04,"24 - 1150",259,266,253,6,7,0.976833976833977
2023-02-04,"24 - 1153",351,355,349,2,4,0.994301994301994
2023-02-05,"62 - 1011",97,98,82,15,1,0.845360824742268
2023-02-05,"3 - 1008",233,236,227,6,3,0.974248927038627
2023-02-05,"16 - 1022",53,53,53,0,0,1
2023-02-05,"24 - 1150",259,266,258,1,7,0.996138996138996
2023-02-05,"24 - 1153",351,355,351,0,4,1
2023-02-06,"62 - 1011",97,98,80,17,1,0.824742268041237
2023-02-06,"3 - 1008",232,236,229,3,4,0.987068965517241
2023-02-06,"16 - 1022",53,53,52,1,0,0.981132075471698
2023-02-06,"24 - 1150",259,266,258,1,7,0.996138996138996
2023-02-06,"24 - 1153",351,355,351,0,4,1
2023-02-07,"62 - 1011",97,98,78,19,1,0.804123711340206
2023-02-07,"3 - 1008",233,236,229,4,3,0.982832618025751
2023-02-07,"16 - 1022",53,53,52,1,0,0.981132075471698
2023-02-07,"24 - 1150",259,266,258,1,7,0.996138996138996
2023-02-07,"24 - 1153",352,355,352,0,3,1
2023-02-08,"62 - 1011",97,98,77,20,1,0.793814432989691
2023-02-08,"3 - 1008",233,236,230,3,3,0.987124463519313
2023-02-08,"16 - 1022",53,53,52,1,0,0.981132075471698
2023-02-08,"24 - 1150",258,266,255,3,8,0.988372093023256
2023-02-08,"24 - 1153",337,355,336,1,18,0.997032640949555
2023-02-09,"62 - 1011",97,98,78,19,1,0.804123711340206
2023-02-09,"3 - 1008",233,236,231,2,3,0.991416309012876
2023-02-09,"16 - 1022",53,53,51,2,0,0.962264150943396
2023-02-09,"24 - 1150",258,266,255,3,8,0.988372093023256
2023-02-09,"24 - 1153",335,355,333,2,20,0.994029850746269
2023-02-10,"62 - 1011",97,98,80,17,1,0.824742268041237
2023-02-10,"3 - 1008",233,236,229,4,3,0.982832618025751
2023-02-10,"16 - 1022",53,53,51,2,0,0.962264150943396
2023-02-10,"24 - 1150",256,266,254,2,10,0.9921875
2023-02-10,"24 - 1153",343,355,341,2,12,0.994169096209913
2023-02-11,"62 - 1011",97,98,81,16,1,0.835051546391753
2023-02-11,"3 - 1008",233,236,231,2,3,0.991416309012876
2023-02-11,"16 - 1022",53,53,51,2,0,0.962264150943396
2023-02-11,"24 - 1150",256,266,255,1,10,0.99609375
2023-02-11,"24 - 1153",349,355,348,1,6,0.997134670487106
2023-02-12,"62 - 1011",97,98,80,17,1,0.824742268041237
2023-02-12,"3 - 1008",234,236,232,2,2,0.991452991452991
2023-02-12,"16 - 1022",53,53,50,3,0,0.943396226415094
2023-02-12,"24 - 1150",256,266,255,1,10,0.99609375
2023-02-12,"24 - 1153",349,355,348,1,6,0.997134670487106
2023-02-13,"62 - 1011",97,98,80,17,1,0.824742268041237
2023-02-13,"3 - 1008",234,236,232,2,2,0.991452991452991
2023-02-13,"16 - 1022",53,53,52,1,0,0.981132075471698
2023-02-13,"24 - 1150",256,266,251,5,10,0.98046875
2023-02-13,"24 - 1153",349,355,349,0,6,1
2023-02-14,"62 - 1011",97,98,80,17,1,0.824742268041237
2023-02-14,"3 - 1008",234,236,232,2,2,0.991452991452991
2023-02-14,"16 - 1022",52,53,50,2,1,0.961538461538462
2023-02-14,"24 - 1150",256,266,247,9,10,0.96484375
2023-02-14,"24 - 1153",349,355,349,0,6,1
2023-02-15,"62 - 1011",97,98,80,17,1,0.824742268041237
2023-02-15,"3 - 1008",234,236,232,2,2,0.991452991452991
2023-02-15,"16 - 1022",53,53,49,4,0,0.924528301886792
2023-02-15,"24 - 1150",256,266,247,9,10,0.96484375
2023-02-15,"24 - 1153",349,355,349,0,6,1
2023-02-16,"62 - 1011",97,98,81,16,1,0.835051546391753
2023-02-16,"3 - 1008",233,236,232,1,3,0.995708154506438
2023-02-16,"16 - 1022",53,53,51,2,0,0.962264150943396
2023-02-16,"24 - 1150",256,266,249,7,10,0.97265625
2023-02-16,"24 - 1153",349,355,349,0,6,1
2023-02-17,"62 - 1011",97,98,79,18,1,0.814432989690722
2023-02-17,"3 - 1008",234,236,231,3,2,0.987179487179487
2023-02-17,"16 - 1022",53,53,52,1,0,0.981132075471698
2023-02-17,"24 - 1150",258,266,251,7,8,0.972868217054264
2023-02-17,"24 - 1153",349,355,349,0,6,1
2023-02-18,"62 - 1011",97,98,81,16,1,0.835051546391753
2023-02-18,"3 - 1008",234,236,229,5,2,0.978632478632479
2023-02-18,"16 - 1022",53,53,51,2,0,0.962264150943396
2023-02-18,"24 - 1150",258,266,258,0,8,1
2023-02-18,"24 - 1153",349,355,349,0,6,1
2023-02-19,"62 - 1011",97,98,79,18,1,0.814432989690722
2023-02-19,"3 - 1008",234,236,232,2,2,0.991452991452991
2023-02-19,"16 - 1022",53,53,51,2,0,0.962264150943396
2023-02-19,"24 - 1150",256,266,254,2,10,0.9921875
2023-02-19,"24 - 1153",349,355,348,1,6,0.997134670487106
2023-02-20,"62 - 1011",97,98,84,13,1,0.865979381443299
2023-02-20,"3 - 1008",234,236,231,3,2,0.987179487179487
2023-02-20,"16 - 1022",53,53,51,2,0,0.962264150943396
2023-02-20,"24 - 1150",258,266,248,10,8,0.961240310077519
2023-02-20,"24 - 1153",349,355,349,0,6,1
2023-02-21,"62 - 1011",97,98,86,11,1,0.88659793814433
2023-02-21,"3 - 1008",234,236,232,2,2,0.991452991452991
2023-02-21,"16 - 1022",53,53,52,1,0,0.981132075471698
2023-02-21,"24 - 1150",258,266,254,4,8,0.984496124031008
2023-02-21,"24 - 1153",349,355,349,0,6,1
2023-02-22,"62 - 1011",97,98,85,12,1,0.876288659793814
2023-02-22,"3 - 1008",233,236,231,2,3,0.991416309012876
2023-02-22,"16 - 1022",53,53,53,0,0,1
2023-02-22,"24 - 1150",258,266,256,2,8,0.992248062015504
2023-02-22,"24 - 1153",348,355,347,1,7,0.997126436781609
2023-02-23,"62 - 1011",97,98,85,12,1,0.876288659793814
2023-02-23,"3 - 1008",232,236,229,3,4,0.987068965517241
2023-02-23,"16 - 1022",53,53,53,0,0,1
2023-02-23,"24 - 1150",258,266,253,5,8,0.98062015503876
2023-02-23,"24 - 1153",348,355,348,0,7,1
2023-02-24,"62 - 1011",97,98,86,11,1,0.88659793814433
2023-02-24,"3 - 1008",232,236,231,1,4,0.995689655172414
2023-02-24,"16 - 1022",53,53,52,1,0,0.981132075471698
2023-02-24,"24 - 1150",258,266,256,2,8,0.992248062015504
2023-02-24,"24 - 1153",348,355,348,0,7,1
2023-02-25,"62 - 1011",97,98,86,11,1,0.88659793814433
2023-02-25,"3 - 1008",232,236,231,1,4,0.995689655172414
2023-02-25,"16 - 1022",53,53,52,1,0,0.981132075471698
2023-02-25,"24 - 1150",258,266,258,0,8,1
2023-02-25,"24 - 1153",348,355,348,0,7,1
2023-02-26,"62 - 1011",97,98,86,11,1,0.88659793814433
2023-02-26,"3 - 1008",232,236,230,2,4,0.991379310344828
2023-02-26,"16 - 1022",53,53,51,2,0,0.962264150943396
2023-02-26,"24 - 1150",258,266,258,0,8,1
2023-02-26,"24 - 1153",348,355,347,1,7,0.997126436781609
2023-02-27,"62 - 1011",97,98,86,11,1,0.88659793814433
2023-02-27,"3 - 1008",231,236,228,3,5,0.987012987012987
2023-02-27,"16 - 1022",53,53,49,4,0,0.924528301886792
2023-02-27,"24 - 1150",258,266,258,0,8,1
2023-02-27,"24 - 1153",348,355,348,0,7,1
2023-02-28,"62 - 1011",97,98,84,13,1,0.865979381443299
2023-02-28,"3 - 1008",231,236,225,6,5,0.974025974025974
2023-02-28,"16 - 1022",53,53,49,4,0,0.924528301886792
2023-02-28,"24 - 1150",256,266,252,4,10,0.984375
2023-02-28,"24 - 1153",348,355,348,0,7,1
2023-03-01,"62 - 1011",97,98,85,12,1,0.876288659793814
2023-03-01,"3 - 1008",228,236,225,3,8,0.986842105263158
2023-03-01,"16 - 1022",53,53,50,3,0,0.943396226415094
2023-03-01,"24 - 1150",254,266,252,2,12,0.992125984251969
2023-03-01,"24 - 1153",347,355,344,3,8,0.99135446685879
2023-03-02,"62 - 1011",97,98,85,12,1,0.876288659793814
2023-03-02,"3 - 1008",230,236,226,4,6,0.982608695652174
2023-03-02,"16 - 1022",53,53,50,3,0,0.943396226415094
2023-03-02,"24 - 1150",254,266,246,8,12,0.968503937007874
2023-03-02,"24 - 1153",346,355,346,0,9,1
2023-03-03,"62 - 1011",97,98,85,12,1,0.876288659793814
2023-03-03,"3 - 1008",230,236,226,4,6,0.982608695652174
2023-03-03,"16 - 1022",53,53,50,3,0,0.943396226415094
2023-03-03,"24 - 1150",254,259,248,6,5,0.976377952755906
2023-03-03,"24 - 1153",347,355,347,0,8,1
2023-03-04,"62 - 1011",97,98,86,11,1,0.88659793814433
2023-03-04,"3 - 1008",230,236,227,3,6,0.98695652173913
2023-03-04,"16 - 1022",53,53,49,4,0,0.924528301886792
2023-03-04,"24 - 1150",254,259,251,3,5,0.988188976377953
2023-03-04,"24 - 1153",347,355,345,2,8,0.994236311239193
2023-03-05,"62 - 1011",97,98,85,12,1,0.876288659793814
2023-03-05,"3 - 1008",230,236,228,2,6,0.991304347826087
2023-03-05,"16 - 1022",53,53,50,3,0,0.943396226415094
2023-03-05,"24 - 1150",254,259,251,3,5,0.988188976377953
2023-03-05,"24 - 1153",346,355,346,0,9,1
2023-03-06,"62 - 1011",97,98,88,9,1,0.907216494845361
2023-03-06,"3 - 1008",230,236,226,4,6,0.982608695652174
2023-03-06,"16 - 1022",53,53,50,3,0,0.943396226415094
2023-03-06,"24 - 1150",253,259,252,1,6,0.99604743083004
2023-03-06,"24 - 1153",345,355,345,0,10,1
2023-03-07,"62 - 1011",97,98,88,9,1,0.907216494845361
2023-03-07,"3 - 1008",231,236,228,3,5,0.987012987012987
2023-03-07,"16 - 1022",53,53,51,2,0,0.962264150943396
2023-03-07,"24 - 1150",253,259,251,2,6,0.992094861660079
2023-03-07,"24 - 1153",345,355,344,1,10,0.997101449275362
2023-03-08,"62 - 1011",97,98,88,9,1,0.907216494845361
2023-03-08,"3 - 1008",231,236,224,7,5,0.96969696969697
2023-03-08,"16 - 1022",53,53,49,4,0,0.924528301886792
2023-03-08,"24 - 1150",254,259,248,6,5,0.976377952755906
2023-03-08,"24 - 1153",345,355,344,1,10,0.997101449275362
2023-03-09,"62 - 1011",97,98,87,10,1,0.896907216494845
2023-03-09,"3 - 1008",231,236,228,3,5,0.987012987012987
2023-03-09,"16 - 1022",53,53,48,5,0,0.905660377358491
2023-03-09,"24 - 1150",254,259,253,1,5,0.996062992125984
2023-03-09,"24 - 1153",351,355,350,1,4,0.997150997150997
2023-03-10,"62 - 1011",98,98,89,9,0,0.908163265306122
2023-03-10,"3 - 1008",231,236,229,2,5,0.991341991341991
2023-03-10,"16 - 1022",53,53,49,4,0,0.924528301886792
2023-03-10,"24 - 1150",254,259,252,2,5,0.992125984251969
2023-03-10,"24 - 1153",351,355,351,0,4,1
2023-03-11,"62 - 1011",98,98,89,9,0,0.908163265306122
2023-03-11,"3 - 1008",231,236,229,2,5,0.991341991341991
2023-03-11,"16 - 1022",53,53,50,3,0,0.943396226415094
2023-03-11,"24 - 1150",252,259,251,1,7,0.996031746031746
2023-03-11,"24 - 1153",351,355,351,0,4,1
2023-03-12,"62 - 1011",98,98,89,9,0,0.908163265306122
2023-03-12,"3 - 1008",231,236,229,2,5,0.991341991341991
2023-03-12,"16 - 1022",53,53,50,3,0,0.943396226415094
2023-03-12,"24 - 1150",250,259,250,0,9,1
2023-03-12,"24 - 1153",350,355,350,0,5,1
2023-03-13,"62 - 1011",98,98,87,11,0,0.887755102040816
2023-03-13,"3 - 1008",231,236,228,3,5,0.987012987012987
2023-03-13,"16 - 1022",53,53,51,2,0,0.962264150943396
2023-03-13,"24 - 1150",253,259,250,3,6,0.988142292490119
2023-03-13,"24 - 1153",350,355,349,1,5,0.997142857142857
2023-03-14,"62 - 1011",98,98,84,14,0,0.857142857142857
2023-03-14,"3 - 1008",231,236,228,3,5,0.987012987012987
2023-03-14,"16 - 1022",53,53,50,3,0,0.943396226415094
2023-03-14,"24 - 1150",255,259,253,2,4,0.992156862745098
2023-03-14,"24 - 1153",350,355,348,2,5,0.994285714285714
2023-03-15,"62 - 1011",98,98,86,12,0,0.877551020408163
2023-03-15,"3 - 1008",231,236,229,2,5,0.991341991341991
2023-03-15,"16 - 1022",53,53,51,2,0,0.962264150943396
2023-03-15,"24 - 1150",254,259,254,0,5,1
2023-03-15,"24 - 1153",350,355,350,0,5,1
2023-03-16,"62 - 1011",98,98,86,12,0,0.877551020408163
2023-03-16,"3 - 1008",232,236,231,1,4,0.995689655172414
2023-03-16,"16 - 1022",52,53,49,3,1,0.942307692307692
2023-03-16,"24 - 1150",253,259,253,0,6,1
2023-03-16,"24 - 1153",350,355,347,3,5,0.991428571428571
2023-03-17,"62 - 1011",98,98,81,17,0,0.826530612244898
2023-03-17,"3 - 1008",232,236,232,0,4,1
2023-03-17,"16 - 1022",53,53,51,2,0,0.962264150943396
2023-03-17,"24 - 1150",247,259,247,0,12,1
2023-03-17,"24 - 1153",351,355,351,0,4,1
2023-03-18,"62 - 1011",98,98,82,16,0,0.836734693877551
2023-03-18,"3 - 1008",232,236,231,1,4,0.995689655172414
2023-03-18,"16 - 1022",53,53,51,2,0,0.962264150943396
2023-03-18,"24 - 1150",247,259,245,2,12,0.991902834008097
2023-03-18,"24 - 1153",351,355,351,0,4,1
2023-03-19,"62 - 1011",98,98,82,16,0,0.836734693877551
2023-03-19,"3 - 1008",232,236,229,3,4,0.987068965517241
2023-03-19,"16 - 1022",53,53,51,2,0,0.962264150943396
2023-03-19,"24 - 1150",247,259,247,0,12,1
2023-03-19,"24 - 1153",351,355,351,0,4,1
2023-03-20,"62 - 1011",98,98,81,17,0,0.826530612244898
2023-03-20,"3 - 1008",231,236,230,1,5,0.995670995670996
2023-03-20,"16 - 1022",53,53,50,3,0,0.943396226415094
2023-03-20,"24 - 1150",249,259,245,4,10,0.983935742971888
2023-03-20,"24 - 1153",351,355,351,0,4,1
2023-03-21,"62 - 1011",98,98,82,16,0,0.836734693877551
2023-03-21,"3 - 1008",231,236,230,1,5,0.995670995670996
2023-03-21,"16 - 1022",53,53,51,2,0,0.962264150943396
2023-03-21,"24 - 1150",247,259,247,0,12,1
2023-03-21,"24 - 1153",350,355,350,0,5,1
2023-03-22,"62 - 1011",98,98,84,14,0,0.857142857142857
2023-03-22,"3 - 1008",231,236,229,2,5,0.991341991341991
2023-03-22,"16 - 1022",53,53,51,2,0,0.962264150943396
2023-03-22,"24 - 1150",241,259,241,0,18,1
2023-03-22,"24 - 1153",350,355,348,2,5,0.994285714285714
2023-03-23,"62 - 1011",98,98,86,12,0,0.877551020408163
2023-03-23,"3 - 1008",231,236,230,1,5,0.995670995670996
2023-03-23,"16 - 1022",53,53,51,2,0,0.962264150943396
2023-03-23,"24 - 1150",237,259,235,2,22,0.991561181434599
2023-03-23,"24 - 1153",350,355,349,1,5,0.997142857142857
2023-03-24,"62 - 1011",98,98,86,12,0,0.877551020408163
2023-03-24,"3 - 1008",230,236,229,1,6,0.995652173913044
2023-03-24,"16 - 1022",53,53,51,2,0,0.962264150943396
2023-03-24,"24 - 1150",233,259,232,1,26,0.995708154506438
2023-03-24,"24 - 1153",350,355,350,0,5,1
2023-03-25,"62 - 1011",98,98,86,12,0,0.877551020408163
2023-03-25,"3 - 1008",230,236,229,1,6,0.995652173913044
2023-03-25,"16 - 1022",53,53,51,2,0,0.962264150943396
2023-03-25,"24 - 1150",230,259,230,0,29,1
2023-03-25,"24 - 1153",350,355,350,0,5,1
2023-03-26,"62 - 1011",98,98,86,12,0,0.877551020408163
2023-03-26,"3 - 1008",230,236,229,1,6,0.995652173913044
2023-03-26,"16 - 1022",53,53,51,2,0,0.962264150943396
2023-03-26,"24 - 1150",230,259,230,0,29,1
2023-03-26,"24 - 1153",350,355,350,0,5,1
2023-03-27,"62 - 1011",98,98,86,12,0,0.877551020408163
2023-03-27,"3 - 1008",230,236,229,1,6,0.995652173913044
2023-03-27,"16 - 1022",53,53,51,2,0,0.962264150943396
2023-03-27,"24 - 1150",228,259,228,0,31,1
2023-03-27,"24 - 1153",350,355,348,2,5,0.994285714285714
2023-03-28,"62 - 1011",98,98,87,11,0,0.887755102040816
2023-03-28,"3 - 1008",230,236,229,1,6,0.995652173913044
2023-03-28,"16 - 1022",53,53,51,2,0,0.962264150943396
2023-03-28,"24 - 1150",253,259,248,5,6,0.980237154150198
2023-03-28,"24 - 1153",349,355,349,0,6,1
2023-03-29,"62 - 1011",98,98,86,12,0,0.877551020408163
2023-03-29,"3 - 1008",230,236,228,2,6,0.991304347826087
2023-03-29,"16 - 1022",53,53,51,2,0,0.962264150943396
2023-03-29,"24 - 1150",253,259,251,2,6,0.992094861660079
2023-03-29,"24 - 1153",349,355,347,2,6,0.994269340974212
2023-03-30,"62 - 1011",98,98,85,13,0,0.86734693877551
2023-03-30,"3 - 1008",231,236,227,4,5,0.982683982683983
2023-03-30,"16 - 1022",52,53,50,2,1,0.961538461538462
2023-03-30,"24 - 1150",253,259,252,1,6,0.99604743083004
2023-03-30,"24 - 1153",349,355,349,0,6,1
2023-03-31,"62 - 1011",98,98,85,13,0,0.86734693877551
2023-03-31,"3 - 1008",231,236,226,5,5,0.978354978354978
2023-03-31,"16 - 1022",52,53,48,4,1,0.923076923076923
2023-03-31,"24 - 1150",254,259,251,3,5,0.988188976377953
2023-03-31,"24 - 1153",349,355,349,0,6,1
2023-04-01,"62 - 1011",98,98,85,13,0,0.86734693877551
2023-04-01,"3 - 1008",231,236,225,6,5,0.974025974025974
2023-04-01,"16 - 1022",52,53,48,4,1,0.923076923076923
2023-04-01,"24 - 1150",253,259,247,6,6,0.976284584980237
2023-04-01,"24 - 1153",349,355,349,0,6,1
2023-04-02,"62 - 1011",98,98,85,13,0,0.86734693877551
2023-04-02,"3 - 1008",231,236,225,6,5,0.974025974025974
2023-04-02,"16 - 1022",52,53,48,4,1,0.923076923076923
2023-04-02,"24 - 1150",253,259,253,0,6,1
2023-04-02,"24 - 1153",349,355,349,0,6,1
2023-04-03,"62 - 1011",98,98,86,12,0,0.877551020408163
2023-04-03,"3 - 1008",231,236,225,6,5,0.974025974025974
2023-04-03,"16 - 1022",52,53,49,3,1,0.942307692307692
2023-04-03,"24 - 1150",252,259,250,2,7,0.992063492063492
2023-04-03,"24 - 1153",349,355,348,1,6,0.997134670487106
2023-04-04,"62 - 1011",98,98,86,12,0,0.877551020408163
2023-04-04,"3 - 1008",231,236,227,4,5,0.982683982683983
2023-04-04,"16 - 1022",52,53,49,3,1,0.942307692307692
2023-04-04,"24 - 1150",252,259,249,3,7,0.988095238095238
2023-04-04,"24 - 1153",349,355,347,2,6,0.994269340974212
2023-04-05,"62 - 1011",98,98,90,8,0,0.918367346938776
2023-04-05,"3 - 1008",230,236,227,3,6,0.98695652173913
2023-04-05,"16 - 1022",52,53,49,3,1,0.942307692307692
2023-04-05,"24 - 1150",251,259,251,0,8,1
2023-04-05,"24 - 1153",349,355,349,0,6,1
2023-04-06,"62 - 1011",97,98,92,5,1,0.948453608247423
2023-04-06,"3 - 1008",230,236,227,3,6,0.98695652173913
2023-04-06,"16 - 1022",52,53,50,2,1,0.961538461538462
2023-04-06,"24 - 1150",246,259,246,0,13,1
2023-04-06,"24 - 1153",350,355,348,2,5,0.994285714285714
2023-04-07,"62 - 1011",97,98,92,5,1,0.948453608247423
2023-04-07,"3 - 1008",230,236,227,3,6,0.98695652173913
2023-04-07,"16 - 1022",52,53,48,4,1,0.923076923076923
2023-04-07,"24 - 1150",248,259,246,2,11,0.991935483870968
2023-04-07,"24 - 1153",350,355,350,0,5,1
2023-04-08,"62 - 1011",96,98,93,3,2,0.96875
2023-04-08,"3 - 1008",230,236,227,3,6,0.98695652173913
2023-04-08,"16 - 1022",51,53,48,3,2,0.941176470588235
2023-04-08,"24 - 1150",248,259,245,3,11,0.987903225806452
2023-04-08,"24 - 1153",350,355,350,0,5,1
2023-04-09,"62 - 1011",96,98,93,3,2,0.96875
2023-04-09,"3 - 1008",230,236,227,3,6,0.98695652173913
2023-04-09,"16 - 1022",52,53,49,3,1,0.942307692307692
2023-04-09,"24 - 1150",248,259,246,2,11,0.991935483870968
2023-04-09,"24 - 1153",350,355,349,1,5,0.997142857142857
2023-04-10,"62 - 1011",96,98,92,4,2,0.958333333333333
2023-04-10,"3 - 1008",230,236,227,3,6,0.98695652173913
2023-04-10,"16 - 1022",52,53,48,4,1,0.923076923076923
2023-04-10,"24 - 1150",248,259,247,1,11,0.995967741935484
2023-04-10,"24 - 1153",350,355,350,0,5,1
2023-04-11,"62 - 1011",96,98,94,2,2,0.979166666666667
2023-04-11,"3 - 1008",230,236,227,3,6,0.98695652173913
2023-04-11,"16 - 1022",52,53,49,3,1,0.942307692307692
2023-04-11,"24 - 1150",250,259,250,0,9,1
2023-04-11,"24 - 1153",350,355,350,0,5,1
2023-04-12,"62 - 1011",96,98,95,1,2,0.989583333333333
2023-04-12,"3 - 1008",230,236,226,4,6,0.982608695652174
2023-04-12,"16 - 1022",52,53,50,2,1,0.961538461538462
2023-04-12,"24 - 1150",249,259,247,2,10,0.991967871485944
2023-04-12,"24 - 1153",350,355,350,0,5,1
2023-04-13,"62 - 1011",96,98,95,1,2,0.989583333333333
2023-04-13,"3 - 1008",230,236,225,5,6,0.978260869565217
2023-04-13,"16 - 1022",52,53,48,4,1,0.923076923076923
2023-04-13,"24 - 1150",245,259,241,4,14,0.983673469387755
2023-04-13,"24 - 1153",350,355,350,0,5,1
2023-04-14,"62 - 1011",96,98,95,1,2,0.989583333333333
2023-04-14,"3 - 1008",230,236,225,5,6,0.978260869565217
2023-04-14,"16 - 1022",53,53,53,0,0,1
2023-04-14,"24 - 1150",245,259,241,4,14,0.983673469387755
2023-04-14,"24 - 1153",350,355,350,0,5,1
2023-04-15,"62 - 1011",96,98,95,1,2,0.989583333333333
2023-04-15,"3 - 1008",230,236,226,4,6,0.982608695652174
2023-04-15,"16 - 1022",53,53,53,0,0,1
2023-04-15,"24 - 1150",243,259,243,0,16,1
2023-04-15,"24 - 1153",350,355,348,2,5,0.994285714285714
2023-04-16,"62 - 1011",96,98,95,1,2,0.989583333333333
2023-04-16,"3 - 1008",230,236,226,4,6,0.982608695652174
2023-04-16,"16 - 1022",53,53,53,0,0,1
2023-04-16,"24 - 1150",246,259,246,0,13,1
2023-04-16,"24 - 1153",350,355,350,0,5,1
2023-04-17,"62 - 1011",96,98,95,1,2,0.989583333333333
2023-04-17,"3 - 1008",230,236,223,7,6,0.969565217391304
2023-04-17,"16 - 1022",53,53,51,2,0,0.962264150943396
2023-04-17,"24 - 1150",253,259,251,2,6,0.992094861660079
2023-04-17,"24 - 1153",350,355,350,0,5,1
2023-04-18,"62 - 1011",96,98,95,1,2,0.989583333333333
2023-04-18,"3 - 1008",229,236,225,4,7,0.982532751091703
2023-04-18,"16 - 1022",53,53,52,1,0,0.981132075471698
2023-04-18,"24 - 1150",253,259,250,3,6,0.988142292490119
2023-04-18,"24 - 1153",351,355,350,1,4,0.997150997150997
2023-04-19,"62 - 1011",96,98,96,0,2,1
2023-04-19,"3 - 1008",228,236,223,5,8,0.978070175438597
2023-04-19,"16 - 1022",53,53,52,1,0,0.981132075471698
2023-04-19,"24 - 1150",253,259,250,3,6,0.988142292490119
2023-04-19,"24 - 1153",351,355,349,2,4,0.994301994301994
2023-04-20,"62 - 1011",96,98,95,1,2,0.989583333333333
2023-04-20,"3 - 1008",228,236,223,5,8,0.978070175438597
2023-04-20,"16 - 1022",53,53,52,1,0,0.981132075471698
2023-04-20,"24 - 1150",253,259,253,0,6,1
2023-04-20,"24 - 1153",350,355,350,0,5,1
2023-04-21,"62 - 1011",96,98,95,1,2,0.989583333333333
2023-04-21,"3 - 1008",228,236,223,5,8,0.978070175438597
2023-04-21,"16 - 1022",53,53,53,0,0,1
2023-04-21,"24 - 1150",253,259,251,2,6,0.992094861660079
2023-04-21,"24 - 1153",351,355,351,0,4,1
2023-04-22,"62 - 1011",96,98,91,5,2,0.947916666666667
2023-04-22,"3 - 1008",228,236,223,5,8,0.978070175438597
2023-04-22,"16 - 1022",53,53,52,1,0,0.981132075471698
2023-04-22,"24 - 1150",251,259,251,0,8,1
2023-04-22,"24 - 1153",351,355,350,1,4,0.997150997150997
2023-04-23,"62 - 1011",96,98,91,5,2,0.947916666666667
2023-04-23,"3 - 1008",228,236,223,5,8,0.978070175438597
2023-04-23,"16 - 1022",53,53,52,1,0,0.981132075471698
2023-04-23,"24 - 1150",251,259,251,0,8,1
2023-04-23,"24 - 1153",351,355,349,2,4,0.994301994301994
2023-04-24,"62 - 1011",96,98,93,3,2,0.96875
2023-04-24,"3 - 1008",228,236,221,7,8,0.969298245614035
2023-04-24,"16 - 1022",53,53,52,1,0,0.981132075471698
2023-04-24,"24 - 1150",253,259,248,5,6,0.980237154150198
2023-04-24,"24 - 1153",351,355,350,1,4,0.997150997150997
2023-04-25,"62 - 1011",96,98,91,5,2,0.947916666666667
2023-04-25,"3 - 1008",229,236,225,4,7,0.982532751091703
2023-04-25,"16 - 1022",53,53,53,0,0,1
2023-04-25,"24 - 1150",253,259,252,1,6,0.99604743083004
2023-04-25,"24 - 1153",351,355,351,0,4,1
2023-04-26,"62 - 1011",96,98,91,5,2,0.947916666666667
2023-04-26,"3 - 1008",229,236,224,5,7,0.978165938864629
2023-04-26,"16 - 1022",53,53,53,0,0,1
2023-04-26,"24 - 1150",252,259,249,3,7,0.988095238095238
2023-04-26,"24 - 1153",351,355,351,0,4,1
2023-04-27,"62 - 1011",96,98,91,5,2,0.947916666666667
2023-04-27,"3 - 1008",230,236,225,5,6,0.978260869565217
2023-04-27,"16 - 1022",53,53,53,0,0,1
2023-04-27,"24 - 1150",255,259,246,9,4,0.964705882352941
2023-04-27,"24 - 1153",351,355,351,0,4,1
2023-04-28,"62 - 1011",96,98,93,3,2,0.96875
2023-04-28,"3 - 1008",230,236,227,3,6,0.98695652173913
2023-04-28,"16 - 1022",53,53,53,0,0,1
2023-04-28,"24 - 1150",254,259,250,4,5,0.984251968503937
2023-04-28,"24 - 1153",351,355,349,2,4,0.994301994301994
2023-04-29,"62 - 1011",96,98,94,2,2,0.979166666666667
2023-04-29,"3 - 1008",230,236,227,3,6,0.98695652173913
2023-04-29,"16 - 1022",53,53,53,0,0,1
2023-04-29,"24 - 1150",252,259,248,4,7,0.984126984126984
2023-04-29,"24 - 1153",351,355,351,0,4,1
2023-04-30,"62 - 1011",96,98,93,3,2,0.96875
2023-04-30,"3 - 1008",230,236,226,4,6,0.982608695652174
2023-04-30,"16 - 1022",53,53,53,0,0,1
2023-04-30,"24 - 1150",252,259,252,0,7,1
2023-04-30,"24 - 1153",351,355,350,1,4,0.997150997150997
2023-05-01,"62 - 1011",96,98,94,2,2,0.979166666666667
2023-05-01,"3 - 1008",230,236,224,6,6,0.973913043478261
2023-05-01,"16 - 1022",53,53,50,3,0,0.943396226415094
2023-05-01,"24 - 1150",255,259,253,2,4,0.992156862745098
2023-05-01,"24 - 1153",351,355,351,0,4,1
2023-05-02,"62 - 1011",96,98,94,2,2,0.979166666666667
2023-05-02,"3 - 1008",231,236,225,6,5,0.974025974025974
2023-05-02,"16 - 1022",53,53,51,2,0,0.962264150943396
2023-05-02,"24 - 1150",257,259,255,2,2,0.992217898832685
2023-05-02,"24 - 1153",349,355,348,1,6,0.997134670487106
2023-05-03,"62 - 1011",96,98,94,2,2,0.979166666666667
2023-05-03,"3 - 1008",231,236,225,6,5,0.974025974025974
2023-05-03,"16 - 1022",53,53,48,5,0,0.905660377358491
2023-05-03,"24 - 1150",256,259,256,0,3,1
2023-05-03,"24 - 1153",348,355,345,3,7,0.991379310344828
2023-05-04,"62 - 1011",96,98,93,3,2,0.96875
2023-05-04,"3 - 1008",231,236,226,5,5,0.978354978354978
2023-05-04,"16 - 1022",53,53,48,5,0,0.905660377358491
2023-05-04,"24 - 1150",256,259,254,2,3,0.9921875
2023-05-04,"24 - 1153",347,355,346,1,8,0.997118155619596
2023-05-05,"62 - 1011",96,98,94,2,2,0.979166666666667
2023-05-05,"3 - 1008",231,236,226,5,5,0.978354978354978
2023-05-05,"16 - 1022",53,53,49,4,0,0.924528301886792
2023-05-05,"24 - 1150",254,259,251,3,5,0.988188976377953
2023-05-05,"24 - 1153",346,355,346,0,9,1
2023-05-06,"62 - 1011",96,98,94,2,2,0.979166666666667
2023-05-06,"3 - 1008",231,236,226,5,5,0.978354978354978
2023-05-06,"16 - 1022",53,53,50,3,0,0.943396226415094
2023-05-06,"24 - 1150",254,259,253,1,5,0.996062992125984
2023-05-06,"24 - 1153",341,355,341,0,14,1
2023-05-07,"62 - 1011",96,98,92,4,2,0.958333333333333
2023-05-07,"3 - 1008",231,236,225,6,5,0.974025974025974
2023-05-07,"16 - 1022",53,53,48,5,0,0.905660377358491
2023-05-07,"24 - 1150",255,259,254,1,4,0.996078431372549
2023-05-07,"24 - 1153",347,355,347,0,8,1
2023-05-08,"62 - 1011",96,98,94,2,2,0.979166666666667
2023-05-08,"3 - 1008",231,236,221,10,5,0.956709956709957
2023-05-08,"16 - 1022",53,53,50,3,0,0.943396226415094
2023-05-08,"24 - 1150",256,259,256,0,3,1
2023-05-08,"24 - 1153",351,355,351,0,4,1
2023-05-09,"62 - 1011",96,98,94,2,2,0.979166666666667
2023-05-09,"3 - 1008",231,236,223,8,5,0.965367965367965
2023-05-09,"16 - 1022",53,53,51,2,0,0.962264150943396
2023-05-09,"24 - 1150",254,259,254,0,5,1
2023-05-09,"24 - 1153",352,355,352,0,3,1
2023-05-10,"62 - 1011",96,98,94,2,2,0.979166666666667
2023-05-10,"3 - 1008",231,236,224,7,5,0.96969696969697
2023-05-10,"16 - 1022",53,53,51,2,0,0.962264150943396
2023-05-10,"24 - 1150",253,259,253,0,6,1
2023-05-10,"24 - 1153",350,355,349,1,5,0.997142857142857
2023-05-11,"62 - 1011",96,98,92,4,2,0.958333333333333
2023-05-11,"3 - 1008",231,236,224,7,5,0.96969696969697
2023-05-11,"16 - 1022",53,53,51,2,0,0.962264150943396
2023-05-11,"24 - 1150",247,259,247,0,12,1
2023-05-11,"24 - 1153",348,355,348,0,7,1
2023-05-12,"62 - 1011",96,98,92,4,2,0.958333333333333
2023-05-12,"3 - 1008",231,236,223,8,5,0.965367965367965
2023-05-12,"16 - 1022",53,53,52,1,0,0.981132075471698
2023-05-12,"24 - 1150",240,259,240,0,19,1
2023-05-12,"24 - 1153",343,355,343,0,12,1
2023-05-13,"62 - 1011",96,98,93,3,2,0.96875
2023-05-13,"3 - 1008",231,236,223,8,5,0.965367965367965
2023-05-13,"16 - 1022",53,53,52,1,0,0.981132075471698
2023-05-13,"24 - 1150",239,259,239,0,20,1
2023-05-13,"24 - 1153",344,355,344,0,11,1
2023-05-14,"62 - 1011",96,98,94,2,2,0.979166666666667
2023-05-14,"3 - 1008",231,236,223,8,5,0.965367965367965
2023-05-14,"16 - 1022",53,53,52,1,0,0.981132075471698
2023-05-14,"24 - 1150",235,259,235,0,24,1
2023-05-14,"24 - 1153",347,355,347,0,8,1
2023-05-15,"62 - 1011",96,98,94,2,2,0.979166666666667
2023-05-15,"3 - 1008",231,236,224,7,5,0.96969696969697
2023-05-15,"16 - 1022",53,53,52,1,0,0.981132075471698
2023-05-15,"24 - 1150",232,259,232,0,27,1
2023-05-15,"24 - 1153",348,355,348,0,7,1
2023-05-16,"62 - 1011",96,98,93,3,2,0.96875
2023-05-16,"3 - 1008",231,236,224,7,5,0.96969696969697
2023-05-16,"16 - 1022",53,53,52,1,0,0.981132075471698
2023-05-16,"24 - 1150",230,259,230,0,29,1
2023-05-16,"24 - 1153",353,355,353,0,2,1
2023-05-17,"62 - 1011",96,98,93,3,2,0.96875
2023-05-17,"3 - 1008",231,236,225,6,5,0.974025974025974
2023-05-17,"16 - 1022",53,53,52,1,0,0.981132075471698
2023-05-17,"24 - 1150",231,259,230,1,28,0.995670995670996
2023-05-17,"24 - 1153",351,355,351,0,4,1
2023-05-18,"62 - 1011",96,98,96,0,2,1
2023-05-18,"3 - 1008",231,236,226,5,5,0.978354978354978
2023-05-18,"16 - 1022",53,53,52,1,0,0.981132075471698
2023-05-18,"24 - 1150",235,259,235,0,24,1
2023-05-18,"24 - 1153",352,355,352,0,3,1
2023-05-19,"62 - 1011",96,98,96,0,2,1
2023-05-19,"3 - 1008",231,236,227,4,5,0.982683982683983
2023-05-19,"16 - 1022",53,53,52,1,0,0.981132075471698
2023-05-19,"24 - 1150",241,259,239,2,18,0.991701244813278
2023-05-19,"24 - 1153",350,355,350,0,5,1
2023-05-20,"62 - 1011",96,98,96,0,2,1
2023-05-20,"3 - 1008",231,236,227,4,5,0.982683982683983
2023-05-20,"16 - 1022",53,53,52,1,0,0.981132075471698
2023-05-20,"24 - 1150",239,259,239,0,20,1
2023-05-20,"24 - 1153",352,355,352,0,3,1
2023-05-21,"62 - 1011",96,98,96,0,2,1
2023-05-21,"3 - 1008",231,236,227,4,5,0.982683982683983
2023-05-21,"16 - 1022",53,53,51,2,0,0.962264150943396
2023-05-21,"24 - 1150",237,259,237,0,22,1
2023-05-21,"24 - 1153",352,355,352,0,3,1
2023-05-22,"62 - 1011",96,98,96,0,2,1
2023-05-22,"3 - 1008",231,236,227,4,5,0.982683982683983
2023-05-22,"16 - 1022",53,53,51,2,0,0.962264150943396
2023-05-22,"24 - 1150",236,259,236,0,23,1
2023-05-22,"24 - 1153",351,355,350,1,4,0.997150997150997
2023-05-23,"62 - 1011",96,98,96,0,2,1
2023-05-23,"3 - 1008",231,236,225,6,5,0.974025974025974
2023-05-23,"16 - 1022",52,53,52,0,1,1
2023-05-23,"24 - 1150",236,259,233,3,23,0.98728813559322
2023-05-23,"24 - 1153",353,355,352,1,2,0.997167138810198
2023-05-24,"62 - 1011",96,98,96,0,2,1
2023-05-24,"3 - 1008",231,236,227,4,5,0.982683982683983
2023-05-24,"16 - 1022",52,53,52,0,1,1
2023-05-24,"24 - 1150",229,259,229,0,30,1
2023-05-24,"24 - 1153",347,355,347,0,8,1
2023-05-25,"62 - 1011",96,98,96,0,2,1
2023-05-25,"3 - 1008",231,236,227,4,5,0.982683982683983
2023-05-25,"16 - 1022",53,53,53,0,0,1
2023-05-25,"24 - 1150",236,259,235,1,23,0.995762711864407
2023-05-25,"24 - 1153",339,355,339,0,16,1
2023-05-26,"62 - 1011",96,98,95,1,2,0.989583333333333
2023-05-26,"3 - 1008",230,236,225,5,6,0.978260869565217
2023-05-26,"16 - 1022",53,53,52,1,0,0.981132075471698
2023-05-26,"24 - 1150",236,259,236,0,23,1
2023-05-26,"24 - 1153",337,355,336,1,18,0.997032640949555
2023-05-27,"62 - 1011",96,98,96,0,2,1
2023-05-27,"3 - 1008",230,236,227,3,6,0.98695652173913
2023-05-27,"16 - 1022",53,53,52,1,0,0.981132075471698
2023-05-27,"24 - 1150",236,259,236,0,23,1
2023-05-27,"24 - 1153",337,355,337,0,18,1
2023-05-28,"62 - 1011",96,98,96,0,2,1
2023-05-28,"3 - 1008",230,236,227,3,6,0.98695652173913
2023-05-28,"16 - 1022",53,53,52,1,0,0.981132075471698
2023-05-28,"24 - 1150",236,259,236,0,23,1
2023-05-28,"24 - 1153",337,355,337,0,18,1
2023-05-29,"62 - 1011",96,98,95,1,2,0.989583333333333
2023-05-29,"3 - 1008",230,236,227,3,6,0.98695652173913
2023-05-29,"16 - 1022",53,53,53,0,0,1
2023-05-29,"24 - 1150",234,259,234,0,25,1
2023-05-29,"24 - 1153",332,355,332,0,23,1
2023-05-30,"62 - 1011",96,98,96,0,2,1
2023-05-30,"3 - 1008",230,236,224,6,6,0.973913043478261
2023-05-30,"16 - 1022",53,53,52,1,0,0.981132075471698
2023-05-30,"24 - 1150",242,259,240,2,17,0.991735537190083
2023-05-30,"24 - 1153",329,355,329,0,26,1
2023-05-31,"62 - 1011",96,98,95,1,2,0.989583333333333
2023-05-31,"3 - 1008",230,236,225,5,6,0.978260869565217
2023-05-31,"16 - 1022",53,53,52,1,0,0.981132075471698
2023-05-31,"24 - 1150",244,259,244,0,15,1
2023-05-31,"24 - 1153",327,355,327,0,28,1
2023-06-01,"62 - 1011",96,98,94,2,2,0.979166666666667
2023-06-01,"3 - 1008",230,236,225,5,6,0.978260869565217
2023-06-01,"16 - 1022",53,53,50,3,0,0.943396226415094
2023-06-01,"24 - 1150",243,259,241,2,16,0.991769547325103
2023-06-01,"24 - 1153",347,355,347,0,8,1
2023-06-02,"62 - 1011",96,98,96,0,2,1
2023-06-02,"3 - 1008",230,236,224,6,6,0.973913043478261
2023-06-02,"16 - 1022",53,53,49,4,0,0.924528301886792
2023-06-02,"24 - 1150",247,259,242,5,12,0.979757085020243
2023-06-02,"24 - 1153",351,355,351,0,4,1
2023-06-03,"62 - 1011",96,98,96,0,2,1
2023-06-03,"3 - 1008",230,236,225,5,6,0.978260869565217
2023-06-03,"16 - 1022",53,53,49,4,0,0.924528301886792
2023-06-03,"24 - 1150",244,259,244,0,15,1
2023-06-03,"24 - 1153",348,355,348,0,7,1
2023-06-04,"62 - 1011",96,98,96,0,2,1
2023-06-04,"3 - 1008",230,236,225,5,6,0.978260869565217
2023-06-04,"16 - 1022",53,53,48,5,0,0.905660377358491
2023-06-04,"24 - 1150",244,259,244,0,15,1
2023-06-04,"24 - 1153",348,355,348,0,7,1
2023-06-05,"62 - 1011",96,98,94,2,2,0.979166666666667
2023-06-05,"3 - 1008",230,236,225,5,6,0.978260869565217
2023-06-05,"16 - 1022",53,53,50,3,0,0.943396226415094
2023-06-05,"24 - 1150",244,259,238,6,15,0.975409836065574
2023-06-05,"24 - 1153",353,355,351,2,2,0.994334277620397
2023-06-06,"62 - 1011",96,98,95,1,2,0.989583333333333
2023-06-06,"3 - 1008",230,236,226,4,6,0.982608695652174
2023-06-06,"16 - 1022",52,53,50,2,1,0.961538461538462
2023-06-06,"24 - 1150",252,259,235,17,7,0.932539682539683
2023-06-06,"24 - 1153",353,355,352,1,2,0.997167138810198
2023-06-07,"62 - 1011",96,98,94,2,2,0.979166666666667
2023-06-07,"3 - 1008",230,236,226,4,6,0.982608695652174
2023-06-07,"16 - 1022",52,53,49,3,1,0.942307692307692
2023-06-07,"24 - 1150",254,259,244,10,5,0.960629921259842
2023-06-07,"24 - 1153",353,355,353,0,2,1
2023-06-08,"62 - 1011",96,98,94,2,2,0.979166666666667
2023-06-08,"3 - 1008",230,236,226,4,6,0.982608695652174
2023-06-08,"16 - 1022",52,53,50,2,1,0.961538461538462
2023-06-08,"24 - 1150",255,259,247,8,4,0.968627450980392
2023-06-08,"24 - 1153",353,355,353,0,2,1
2023-06-09,"62 - 1011",96,98,94,2,2,0.979166666666667
2023-06-09,"3 - 1008",230,236,226,4,6,0.982608695652174
2023-06-09,"16 - 1022",52,53,52,0,1,1
2023-06-09,"24 - 1150",254,259,251,3,5,0.988188976377953
2023-06-09,"24 - 1153",353,355,353,0,2,1
2023-06-10,"62 - 1011",96,98,93,3,2,0.96875
2023-06-10,"3 - 1008",230,236,226,4,6,0.982608695652174
2023-06-10,"16 - 1022",52,53,52,0,1,1
2023-06-10,"24 - 1150",254,259,254,0,5,1
2023-06-10,"24 - 1153",353,355,353,0,2,1
2023-06-11,"62 - 1011",96,98,93,3,2,0.96875
2023-06-11,"3 - 1008",230,236,226,4,6,0.982608695652174
2023-06-11,"16 - 1022",52,53,51,1,1,0.980769230769231
2023-06-11,"24 - 1150",254,259,254,0,5,1
2023-06-11,"24 - 1153",353,355,353,0,2,1
2023-06-12,"62 - 1011",96,98,91,5,2,0.947916666666667
2023-06-12,"3 - 1008",230,236,226,4,6,0.982608695652174
2023-06-12,"16 - 1022",52,53,50,2,1,0.961538461538462
2023-06-12,"24 - 1150",254,259,250,4,5,0.984251968503937
2023-06-12,"24 - 1153",353,355,353,0,2,1
2023-06-13,"62 - 1011",96,98,91,5,2,0.947916666666667
2023-06-13,"3 - 1008",230,236,227,3,6,0.98695652173913
2023-06-13,"16 - 1022",53,53,51,2,0,0.962264150943396
2023-06-13,"24 - 1150",254,259,252,2,5,0.992125984251969
2023-06-13,"24 - 1153",353,355,353,0,2,1
2023-06-14,"62 - 1011",96,98,91,5,2,0.947916666666667
2023-06-14,"3 - 1008",231,236,228,3,5,0.987012987012987
2023-06-14,"16 - 1022",53,53,52,1,0,0.981132075471698
2023-06-14,"24 - 1150",254,259,253,1,5,0.996062992125984
2023-06-14,"24 - 1153",351,355,351,0,4,1
2023-06-15,"62 - 1011",96,98,91,5,2,0.947916666666667
2023-06-15,"3 - 1008",231,236,227,4,5,0.982683982683983
2023-06-15,"16 - 1022",53,53,52,1,0,0.981132075471698
2023-06-15,"24 - 1150",253,259,253,0,6,1
2023-06-15,"24 - 1153",352,355,352,0,3,1
2023-06-16,"62 - 1011",96,98,91,5,2,0.947916666666667
2023-06-16,"3 - 1008",231,236,228,3,5,0.987012987012987
2023-06-16,"16 - 1022",53,53,52,1,0,0.981132075471698
2023-06-16,"24 - 1150",252,259,252,0,7,1
2023-06-16,"24 - 1153",352,355,352,0,3,1
2023-06-17,"62 - 1011",96,98,91,5,2,0.947916666666667
2023-06-17,"3 - 1008",231,236,229,2,5,0.991341991341991
2023-06-17,"16 - 1022",53,53,50,3,0,0.943396226415094
2023-06-17,"24 - 1150",251,259,251,0,8,1
2023-06-17,"24 - 1153",352,355,352,0,3,1
2023-06-18,"62 - 1011",96,98,91,5,2,0.947916666666667
2023-06-18,"3 - 1008",231,236,229,2,5,0.991341991341991
2023-06-18,"16 - 1022",53,53,50,3,0,0.943396226415094
2023-06-18,"24 - 1150",253,259,253,0,6,1
2023-06-18,"24 - 1153",352,355,352,0,3,1
2023-06-19,"62 - 1011",96,98,90,6,2,0.9375
2023-06-19,"3 - 1008",231,236,229,2,5,0.991341991341991
2023-06-19,"16 - 1022",53,53,50,3,0,0.943396226415094
2023-06-19,"24 - 1150",255,259,255,0,4,1
2023-06-19,"24 - 1153",352,355,352,0,3,1
2023-06-20,"62 - 1011",96,98,91,5,2,0.947916666666667
2023-06-20,"3 - 1008",231,236,229,2,5,0.991341991341991
2023-06-20,"16 - 1022",53,53,50,3,0,0.943396226415094
2023-06-20,"24 - 1150",252,259,250,2,7,0.992063492063492
2023-06-20,"24 - 1153",352,355,352,0,3,1
2023-06-21,"62 - 1011",96,98,90,6,2,0.9375
2023-06-21,"3 - 1008",231,236,230,1,5,0.995670995670996
2023-06-21,"16 - 1022",53,53,51,2,0,0.962264150943396
2023-06-21,"24 - 1150",255,259,253,2,4,0.992156862745098
2023-06-21,"24 - 1153",353,355,353,0,2,1
2023-06-22,"62 - 1011",88,98,88,0,10,1
2023-06-22,"3 - 1008",230,236,228,2,6,0.991304347826087
2023-06-22,"16 - 1022",53,53,52,1,0,0.981132075471698
2023-06-22,"24 - 1150",252,259,251,1,7,0.996031746031746
2023-06-22,"24 - 1153",353,355,353,0,2,1
2023-06-23,"62 - 1011",88,98,88,0,10,1
2023-06-23,"3 - 1008",230,236,227,3,6,0.98695652173913
2023-06-23,"16 - 1022",53,53,53,0,0,1
2023-06-23,"24 - 1150",252,259,252,0,7,1
2023-06-23,"24 - 1153",353,355,353,0,2,1
2023-06-24,"62 - 1011",88,98,88,0,10,1
2023-06-24,"3 - 1008",230,236,227,3,6,0.98695652173913
2023-06-24,"16 - 1022",53,53,53,0,0,1
2023-06-24,"24 - 1150",252,259,252,0,7,1
2023-06-24,"24 - 1153",353,355,353,0,2,1
2023-06-25,"62 - 1011",88,98,88,0,10,1
2023-06-25,"3 - 1008",230,236,227,3,6,0.98695652173913
2023-06-25,"16 - 1022",53,53,53,0,0,1
2023-06-25,"24 - 1150",253,259,251,2,6,0.992094861660079
2023-06-25,"24 - 1153",353,355,353,0,2,1
2023-06-26,"62 - 1011",88,98,88,0,10,1
2023-06-26,"3 - 1008",230,236,228,2,6,0.991304347826087
2023-06-26,"16 - 1022",53,53,52,1,0,0.981132075471698
2023-06-26,"24 - 1150",256,259,249,7,3,0.97265625
2023-06-26,"24 - 1153",353,355,353,0,2,1
2023-06-27,"62 - 1011",88,98,88,0,10,1
2023-06-27,"3 - 1008",230,236,227,3,6,0.98695652173913
2023-06-27,"16 - 1022",53,53,52,1,0,0.981132075471698
2023-06-27,"24 - 1150",255,259,253,2,4,0.992156862745098
2023-06-27,"24 - 1153",352,355,352,0,3,1
2023-06-28,"62 - 1011",88,98,88,0,10,1
2023-06-28,"3 - 1008",230,236,227,3,6,0.98695652173913
2023-06-28,"16 - 1022",53,53,52,1,0,0.981132075471698
2023-06-28,"24 - 1150",255,259,253,2,4,0.992156862745098
2023-06-28,"24 - 1153",353,355,353,0,2,1
2023-06-29,"62 - 1011",88,98,88,0,10,1
2023-06-29,"3 - 1008",230,236,227,3,6,0.98695652173913
2023-06-29,"16 - 1022",53,53,52,1,0,0.981132075471698
2023-06-29,"24 - 1150",256,259,256,0,3,1
2023-06-29,"24 - 1153",353,355,352,1,2,0.997167138810198
2023-06-30,"62 - 1011",88,98,87,1,10,0.988636363636364
2023-06-30,"3 - 1008",230,236,226,4,6,0.982608695652174
2023-06-30,"16 - 1022",52,53,50,2,1,0.961538461538462
2023-06-30,"24 - 1150",256,259,254,2,3,0.9921875
2023-06-30,"24 - 1153",353,355,353,0,2,1
2023-07-01,"62 - 1011",88,98,87,1,10,0.988636363636364
2023-07-01,"3 - 1008",231,236,227,4,5,0.982683982683983
2023-07-01,"16 - 1022",52,53,50,2,1,0.961538461538462
2023-07-01,"24 - 1150",255,259,255,0,4,1
2023-07-01,"24 - 1153",353,355,353,0,2,1
2023-07-02,"62 - 1011",88,98,87,1,10,0.988636363636364
2023-07-02,"3 - 1008",231,236,227,4,5,0.982683982683983
2023-07-02,"16 - 1022",53,53,51,2,0,0.962264150943396
2023-07-02,"24 - 1150",255,259,255,0,4,1
2023-07-02,"24 - 1153",353,355,352,1,2,0.997167138810198
2023-07-03,"62 - 1011",88,98,86,2,10,0.977272727272727
2023-07-03,"3 - 1008",231,236,226,5,5,0.978354978354978
2023-07-03,"16 - 1022",53,53,51,2,0,0.962264150943396
2023-07-03,"24 - 1150",255,259,253,2,4,0.992156862745098
2023-07-03,"24 - 1153",353,355,353,0,2,1
2023-07-04,"62 - 1011",88,98,86,2,10,0.977272727272727
2023-07-04,"3 - 1008",231,236,226,5,5,0.978354978354978
2023-07-04,"16 - 1022",53,53,51,2,0,0.962264150943396
2023-07-04,"24 - 1150",255,259,253,2,4,0.992156862745098
2023-07-04,"24 - 1153",353,355,353,0,2,1
2023-07-05,"62 - 1011",88,98,85,3,10,0.965909090909091
2023-07-05,"3 - 1008",231,236,226,5,5,0.978354978354978
2023-07-05,"16 - 1022",53,53,51,2,0,0.962264150943396
2023-07-05,"24 - 1150",255,259,252,3,4,0.988235294117647
2023-07-05,"24 - 1153",353,355,353,0,2,1
2023-07-06,"62 - 1011",88,98,85,3,10,0.965909090909091
2023-07-06,"3 - 1008",232,236,228,4,4,0.982758620689655
2023-07-06,"16 - 1022",53,53,51,2,0,0.962264150943396
2023-07-06,"24 - 1150",255,259,253,2,4,0.992156862745098
2023-07-06,"24 - 1153",353,355,353,0,2,1
2023-07-07,"62 - 1011",88,98,85,3,10,0.965909090909091
2023-07-07,"3 - 1008",231,236,227,4,5,0.982683982683983
2023-07-07,"16 - 1022",53,53,51,2,0,0.962264150943396
2023-07-07,"24 - 1150",256,259,252,4,3,0.984375
2023-07-07,"24 - 1153",351,355,351,0,4,1
2023-07-08,"62 - 1011",88,98,86,2,10,0.977272727272727
2023-07-08,"3 - 1008",231,236,227,4,5,0.982683982683983
2023-07-08,"16 - 1022",53,53,51,2,0,0.962264150943396
2023-07-08,"24 - 1150",255,259,255,0,4,1
2023-07-08,"24 - 1153",352,355,352,0,3,1
2023-07-09,"62 - 1011",88,98,86,2,10,0.977272727272727
2023-07-09,"3 - 1008",231,236,227,4,5,0.982683982683983
2023-07-09,"16 - 1022",53,53,50,3,0,0.943396226415094
2023-07-09,"24 - 1150",254,259,254,0,5,1
2023-07-09,"24 - 1153",352,355,352,0,3,1
2023-07-10,"62 - 1011",88,98,86,2,10,0.977272727272727
2023-07-10,"3 - 1008",231,236,228,3,5,0.987012987012987
2023-07-10,"16 - 1022",53,53,50,3,0,0.943396226415094
2023-07-10,"24 - 1150",256,259,256,0,3,1
2023-07-10,"24 - 1153",353,355,353,0,2,1
2023-07-11,"62 - 1011",88,98,85,3,10,0.965909090909091
2023-07-11,"3 - 1008",231,236,227,4,5,0.982683982683983
2023-07-11,"16 - 1022",53,53,51,2,0,0.962264150943396
2023-07-11,"24 - 1150",258,259,256,2,1,0.992248062015504
2023-07-11,"24 - 1153",353,355,353,0,2,1
2023-07-12,"62 - 1011",88,98,86,2,10,0.977272727272727
2023-07-12,"3 - 1008",231,236,227,4,5,0.982683982683983
2023-07-12,"16 - 1022",53,53,51,2,0,0.962264150943396
2023-07-12,"24 - 1150",253,259,253,0,6,1
2023-07-12,"24 - 1153",353,355,353,0,2,1
2023-07-13,"62 - 1011",88,98,88,0,10,1
2023-07-13,"3 - 1008",231,236,227,4,5,0.982683982683983
2023-07-13,"16 - 1022",53,53,51,2,0,0.962264150943396
2023-07-13,"24 - 1150",253,259,253,0,6,1
2023-07-13,"24 - 1153",353,355,353,0,2,1
2023-07-14,"62 - 1011",88,98,88,0,10,1
2023-07-14,"3 - 1008",231,236,229,2,5,0.991341991341991
2023-07-14,"16 - 1022",53,53,51,2,0,0.962264150943396
2023-07-14,"24 - 1150",256,259,252,4,3,0.984375
2023-07-14,"24 - 1153",353,355,353,0,2,1
2023-07-15,"62 - 1011",88,98,88,0,10,1
2023-07-15,"3 - 1008",232,236,229,3,4,0.987068965517241
2023-07-15,"16 - 1022",53,53,51,2,0,0.962264150943396
2023-07-15,"24 - 1150",256,259,252,4,3,0.984375
2023-07-15,"24 - 1153",353,355,353,0,2,1
2023-07-16,"62 - 1011",88,98,87,1,10,0.988636363636364
2023-07-16,"3 - 1008",232,236,228,4,4,0.982758620689655
2023-07-16,"16 - 1022",53,53,51,2,0,0.962264150943396
2023-07-16,"24 - 1150",258,259,256,2,1,0.992248062015504
2023-07-16,"24 - 1153",353,355,352,1,2,0.997167138810198
2023-07-17,"62 - 1011",88,98,88,0,10,1
2023-07-17,"3 - 1008",232,236,228,4,4,0.982758620689655
2023-07-17,"16 - 1022",53,53,52,1,0,0.981132075471698
2023-07-17,"24 - 1150",256,259,256,0,3,1
2023-07-17,"24 - 1153",353,355,353,0,2,1
2023-07-18,"62 - 1011",88,98,88,0,10,1
2023-07-18,"3 - 1008",232,236,228,4,4,0.982758620689655
2023-07-18,"16 - 1022",53,53,52,1,0,0.981132075471698
2023-07-18,"24 - 1150",258,259,256,2,1,0.992248062015504
2023-07-18,"24 - 1153",353,355,353,0,2,1
2023-07-19,"62 - 1011",88,98,87,1,10,0.988636363636364
2023-07-19,"3 - 1008",232,236,225,7,4,0.969827586206897
2023-07-19,"16 - 1022",53,60,52,1,7,0.981132075471698
2023-07-19,"24 - 1150",257,259,257,0,2,1
2023-07-19,"24 - 1153",353,355,353,0,2,1
2023-07-20,"62 - 1011",88,98,87,1,10,0.988636363636364
2023-07-20,"3 - 1008",232,236,227,5,4,0.978448275862069
2023-07-20,"16 - 1022",53,60,52,1,7,0.981132075471698
2023-07-20,"24 - 1150",257,259,257,0,2,1
2023-07-20,"24 - 1153",353,355,353,0,2,1
2023-07-21,"62 - 1011",88,98,87,1,10,0.988636363636364
2023-07-21,"3 - 1008",231,236,227,4,5,0.982683982683983
2023-07-21,"16 - 1022",53,60,52,1,7,0.981132075471698
2023-07-21,"24 - 1150",257,259,256,1,2,0.996108949416342
2023-07-21,"24 - 1153",353,355,353,0,2,1
2023-07-22,"62 - 1011",88,98,88,0,10,1
2023-07-22,"3 - 1008",231,236,228,3,5,0.987012987012987
2023-07-22,"16 - 1022",53,60,52,1,7,0.981132075471698
2023-07-22,"24 - 1150",257,259,256,1,2,0.996108949416342
2023-07-22,"24 - 1153",353,355,353,0,2,1
2023-07-23,"62 - 1011",88,98,88,0,10,1
2023-07-23,"3 - 1008",231,236,229,2,5,0.991341991341991
2023-07-23,"16 - 1022",53,60,52,1,7,0.981132075471698
2023-07-23,"24 - 1150",256,259,256,0,3,1
2023-07-23,"24 - 1153",353,355,353,0,2,1
2023-07-24,"62 - 1011",88,98,88,0,10,1
2023-07-24,"3 - 1008",231,236,229,2,5,0.991341991341991
2023-07-24,"16 - 1022",56,60,56,0,4,1
2023-07-24,"24 - 1150",257,259,255,2,2,0.992217898832685
2023-07-24,"24 - 1153",353,355,353,0,2,1
2023-07-25,"62 - 1011",88,98,88,0,10,1
2023-07-25,"3 - 1008",231,236,229,2,5,0.991341991341991
2023-07-25,"16 - 1022",56,60,56,0,4,1
2023-07-25,"24 - 1150",254,259,250,4,5,0.984251968503937
2023-07-25,"24 - 1153",353,355,353,0,2,1
2023-07-26,"62 - 1011",96,98,88,8,2,0.916666666666667
2023-07-26,"3 - 1008",231,236,229,2,5,0.991341991341991
2023-07-26,"16 - 1022",57,60,56,1,3,0.982456140350877
2023-07-26,"24 - 1150",252,259,252,0,7,1
2023-07-26,"24 - 1153",353,355,353,0,2,1
2023-07-27,"62 - 1011",96,98,88,8,2,0.916666666666667
2023-07-27,"3 - 1008",231,236,230,1,5,0.995670995670996
2023-07-27,"16 - 1022",57,60,56,1,3,0.982456140350877
2023-07-27,"24 - 1150",250,259,250,0,9,1
2023-07-27,"24 - 1153",353,355,353,0,2,1
2023-07-28,"62 - 1011",96,98,88,8,2,0.916666666666667
2023-07-28,"3 - 1008",231,236,229,2,5,0.991341991341991
2023-07-28,"16 - 1022",57,60,56,1,3,0.982456140350877
2023-07-28,"24 - 1150",248,259,248,0,11,1
2023-07-28,"24 - 1153",353,355,353,0,2,1
2023-07-29,"62 - 1011",96,98,88,8,2,0.916666666666667
2023-07-29,"3 - 1008",231,236,228,3,5,0.987012987012987
2023-07-29,"16 - 1022",58,60,57,1,2,0.982758620689655
2023-07-29,"24 - 1150",247,259,247,0,12,1
2023-07-29,"24 - 1153",353,355,353,0,2,1
2023-07-30,"62 - 1011",96,98,88,8,2,0.916666666666667
2023-07-30,"3 - 1008",231,236,229,2,5,0.991341991341991
2023-07-30,"16 - 1022",57,60,55,2,3,0.964912280701754
2023-07-30,"24 - 1150",244,259,243,1,15,0.995901639344262
2023-07-30,"24 - 1153",353,355,353,0,2,1
2023-07-31,"62 - 1011",96,98,89,7,2,0.927083333333333
2023-07-31,"3 - 1008",231,236,229,2,5,0.991341991341991
2023-07-31,"16 - 1022",57,60,54,3,3,0.947368421052632
2023-07-31,"24 - 1150",242,259,242,0,17,1
2023-07-31,"24 - 1153",353,355,353,0,2,1
2023-08-01,"62 - 1011",96,98,89,7,2,0.927083333333333
2023-08-01,"3 - 1008",231,236,227,4,5,0.982683982683983
2023-08-01,"16 - 1022",57,60,53,4,3,0.929824561403509
2023-08-01,"24 - 1150",241,259,240,1,18,0.995850622406639
2023-08-01,"24 - 1153",353,355,353,0,2,1
2023-08-02,"62 - 1011",96,98,90,6,2,0.9375
2023-08-02,"3 - 1008",231,236,225,6,5,0.974025974025974
2023-08-02,"16 - 1022",57,60,54,3,3,0.947368421052632
2023-08-02,"24 - 1150",243,259,243,0,16,1
2023-08-02,"24 - 1153",353,355,353,0,2,1
2023-08-03,"62 - 1011",96,98,92,4,2,0.958333333333333
2023-08-03,"3 - 1008",231,236,226,5,5,0.978354978354978
2023-08-03,"16 - 1022",60,60,58,2,0,0.966666666666667
2023-08-03,"24 - 1150",241,259,241,0,18,1
2023-08-03,"24 - 1153",353,355,353,0,2,1
2023-08-04,"62 - 1011",96,98,93,3,2,0.96875
2023-08-04,"3 - 1008",231,246,226,5,15,0.978354978354978
2023-08-04,"16 - 1022",60,60,59,1,0,0.983333333333333
2023-08-04,"24 - 1150",240,259,240,0,19,1
2023-08-04,"24 - 1153",353,355,353,0,2,1
2023-08-05,"62 - 1011",96,98,93,3,2,0.96875
2023-08-05,"3 - 1008",233,246,227,6,13,0.974248927038627
2023-08-05,"16 - 1022",60,60,59,1,0,0.983333333333333
2023-08-05,"24 - 1150",240,259,240,0,19,1
2023-08-05,"24 - 1153",353,355,353,0,2,1
2023-08-06,"62 - 1011",96,98,93,3,2,0.96875
2023-08-06,"3 - 1008",235,255,230,5,20,0.978723404255319
2023-08-06,"16 - 1022",60,60,59,1,0,0.983333333333333
2023-08-06,"24 - 1150",240,259,240,0,19,1
2023-08-06,"24 - 1153",353,355,353,0,2,1
2023-08-07,"62 - 1011",96,98,92,4,2,0.958333333333333
2023-08-07,"3 - 1008",235,255,230,5,20,0.978723404255319
2023-08-07,"16 - 1022",60,60,59,1,0,0.983333333333333
2023-08-07,"24 - 1150",237,259,237,0,22,1
2023-08-07,"24 - 1153",353,355,353,0,2,1
2023-08-08,"62 - 1011",96,98,93,3,2,0.96875
2023-08-08,"3 - 1008",236,255,231,5,19,0.978813559322034
2023-08-08,"16 - 1022",60,60,59,1,0,0.983333333333333
2023-08-08,"24 - 1150",233,259,233,0,26,1
2023-08-08,"24 - 1153",353,355,353,0,2,1
2023-08-09,"62 - 1011",96,98,95,1,2,0.989583333333333
2023-08-09,"3 - 1008",239,255,235,4,16,0.98326359832636
2023-08-09,"16 - 1022",60,60,60,0,0,1
2023-08-09,"24 - 1150",235,259,235,0,24,1
2023-08-09,"24 - 1153",353,355,353,0,2,1
2023-08-10,"62 - 1011",96,98,95,1,2,0.989583333333333
2023-08-10,"3 - 1008",239,255,235,4,16,0.98326359832636
2023-08-10,"16 - 1022",60,60,60,0,0,1
2023-08-10,"24 - 1150",231,259,231,0,28,1
2023-08-10,"24 - 1153",353,355,353,0,2,1
2023-08-11,"62 - 1011",96,98,94,2,2,0.979166666666667
2023-08-11,"3 - 1008",240,255,237,3,15,0.9875
2023-08-11,"16 - 1022",60,60,59,1,0,0.983333333333333
2023-08-11,"24 - 1150",235,259,235,0,24,1
2023-08-11,"24 - 1153",353,355,353,0,2,1
2023-08-12,"62 - 1011",96,98,95,1,2,0.989583333333333
2023-08-12,"3 - 1008",240,255,237,3,15,0.9875
2023-08-12,"16 - 1022",60,60,59,1,0,0.983333333333333
2023-08-12,"24 - 1150",235,259,235,0,24,1
2023-08-12,"24 - 1153",353,355,353,0,2,1
2023-08-13,"62 - 1011",96,98,95,1,2,0.989583333333333
2023-08-13,"3 - 1008",240,255,237,3,15,0.9875
2023-08-13,"16 - 1022",60,60,57,3,0,0.95
2023-08-13,"24 - 1150",233,259,233,0,26,1
2023-08-13,"24 - 1153",353,355,353,0,2,1
2023-08-14,"62 - 1011",96,98,94,2,2,0.979166666666667
2023-08-14,"3 - 1008",240,255,237,3,15,0.9875
2023-08-14,"16 - 1022",60,60,60,0,0,1
2023-08-14,"24 - 1150",232,259,232,0,27,1
2023-08-14,"24 - 1153",353,355,353,0,2,1
2023-08-15,"62 - 1011",96,98,94,2,2,0.979166666666667
2023-08-15,"3 - 1008",240,255,237,3,15,0.9875
2023-08-15,"16 - 1022",59,60,59,0,1,1
2023-08-15,"24 - 1150",231,259,231,0,28,1
2023-08-15,"24 - 1153",353,355,353,0,2,1
2023-08-16,"62 - 1011",96,98,94,2,2,0.979166666666667
2023-08-16,"3 - 1008",240,255,237,3,15,0.9875
2023-08-16,"16 - 1022",60,60,59,1,0,0.983333333333333
2023-08-16,"24 - 1150",229,259,229,0,30,1
2023-08-16,"24 - 1153",353,355,353,0,2,1
2023-08-17,"62 - 1011",96,98,94,2,2,0.979166666666667
2023-08-17,"3 - 1008",240,255,238,2,15,0.991666666666667
2023-08-17,"16 - 1022",60,60,57,3,0,0.95
2023-08-17,"24 - 1150",226,259,226,0,33,1
2023-08-17,"24 - 1153",353,355,353,0,2,1
2023-08-18,"62 - 1011",96,98,95,1,2,0.989583333333333
2023-08-18,"3 - 1008",240,255,238,2,15,0.991666666666667
2023-08-18,"16 - 1022",60,60,58,2,0,0.966666666666667
2023-08-18,"24 - 1150",225,259,225,0,34,1
2023-08-18,"24 - 1153",353,355,353,0,2,1
2023-08-19,"62 - 1011",96,98,95,1,2,0.989583333333333
2023-08-19,"3 - 1008",240,255,238,2,15,0.991666666666667
2023-08-19,"16 - 1022",60,60,58,2,0,0.966666666666667
2023-08-19,"24 - 1150",225,259,225,0,34,1
2023-08-19,"24 - 1153",353,355,353,0,2,1
2023-08-20,"62 - 1011",96,98,95,1,2,0.989583333333333
2023-08-20,"3 - 1008",241,255,239,2,14,0.991701244813278
2023-08-20,"16 - 1022",60,60,58,2,0,0.966666666666667
2023-08-20,"24 - 1150",224,259,224,0,35,1
2023-08-20,"24 - 1153",353,355,353,0,2,1
2023-08-21,"62 - 1011",96,98,94,2,2,0.979166666666667
2023-08-21,"3 - 1008",243,255,241,2,12,0.991769547325103
2023-08-21,"16 - 1022",60,60,59,1,0,0.983333333333333
2023-08-21,"24 - 1150",219,259,219,0,40,1
2023-08-21,"24 - 1153",353,355,353,0,2,1
2023-08-22,"62 - 1011",96,98,94,2,2,0.979166666666667
2023-08-22,"3 - 1008",244,255,242,2,11,0.991803278688525
2023-08-22,"16 - 1022",60,60,59,1,0,0.983333333333333
2023-08-22,"24 - 1150",220,259,220,0,39,1
2023-08-22,"24 - 1153",353,355,353,0,2,1
2023-08-23,"62 - 1011",96,98,93,3,2,0.96875
2023-08-23,"3 - 1008",244,255,241,3,11,0.987704918032787
2023-08-23,"16 - 1022",60,60,59,1,0,0.983333333333333
2023-08-23,"24 - 1150",222,259,222,0,37,1
2023-08-23,"24 - 1153",353,355,352,1,2,0.997167138810198
2023-08-24,"62 - 1011",96,98,92,4,2,0.958333333333333
2023-08-24,"3 - 1008",244,255,242,2,11,0.991803278688525
2023-08-24,"16 - 1022",60,60,59,1,0,0.983333333333333
2023-08-24,"24 - 1150",223,259,222,1,36,0.995515695067265
2023-08-24,"24 - 1153",353,355,353,0,2,1
2023-08-25,"62 - 1011",96,98,93,3,2,0.96875
2023-08-25,"3 - 1008",244,255,241,3,11,0.987704918032787
2023-08-25,"16 - 1022",60,60,60,0,0,1
2023-08-25,"24 - 1150",224,259,224,0,35,1
2023-08-25,"24 - 1153",352,355,352,0,3,1
2023-08-26,"62 - 1011",96,98,94,2,2,0.979166666666667
2023-08-26,"3 - 1008",244,255,240,4,11,0.983606557377049
2023-08-26,"16 - 1022",60,60,58,2,0,0.966666666666667
2023-08-26,"24 - 1150",224,259,224,0,35,1
2023-08-26,"24 - 1153",352,355,352,0,3,1
2023-08-27,"62 - 1011",96,98,94,2,2,0.979166666666667
2023-08-27,"3 - 1008",244,255,240,4,11,0.983606557377049
2023-08-27,"16 - 1022",60,60,58,2,0,0.966666666666667
2023-08-27,"24 - 1150",224,259,224,0,35,1
2023-08-27,"24 - 1153",352,355,352,0,3,1
2023-08-28,"62 - 1011",96,98,95,1,2,0.989583333333333
2023-08-28,"3 - 1008",244,255,241,3,11,0.987704918032787
2023-08-28,"16 - 1022",60,60,56,4,0,0.933333333333333
2023-08-28,"24 - 1150",225,259,225,0,34,1
2023-08-28,"24 - 1153",352,355,352,0,3,1
2023-08-29,"62 - 1011",96,98,95,1,2,0.989583333333333
2023-08-29,"3 - 1008",244,255,241,3,11,0.987704918032787
2023-08-29,"16 - 1022",60,60,58,2,0,0.966666666666667
2023-08-29,"24 - 1150",223,259,223,0,36,1
2023-08-29,"24 - 1153",352,355,352,0,3,1
2023-08-30,"62 - 1011",96,98,94,2,2,0.979166666666667
2023-08-30,"3 - 1008",242,255,239,3,13,0.987603305785124
2023-08-30,"16 - 1022",60,60,58,2,0,0.966666666666667
2023-08-30,"24 - 1150",224,259,224,0,35,1
2023-08-30,"24 - 1153",386,410,377,9,24,0.976683937823834
2023-08-31,"62 - 1011",96,98,94,2,2,0.979166666666667
2023-08-31,"3 - 1008",243,255,239,4,12,0.983539094650206
2023-08-31,"16 - 1022",60,60,58,2,0,0.966666666666667
2023-08-31,"24 - 1150",216,259,216,0,43,1
2023-08-31,"24 - 1153",395,410,395,0,15,1
2023-09-01,"62 - 1011",96,98,94,2,2,0.979166666666667
2023-09-01,"3 - 1008",243,255,238,5,12,0.979423868312757
2023-09-01,"16 - 1022",60,60,56,4,0,0.933333333333333
2023-09-01,"24 - 1150",215,259,214,1,44,0.995348837209302
2023-09-01,"24 - 1153",389,410,389,0,21,1
2023-09-02,"62 - 1011",96,98,94,2,2,0.979166666666667
2023-09-02,"3 - 1008",243,255,238,5,12,0.979423868312757
2023-09-02,"16 - 1022",60,60,56,4,0,0.933333333333333
2023-09-02,"24 - 1150",214,259,214,0,45,1
2023-09-02,"24 - 1153",390,410,390,0,20,1
2023-09-03,"62 - 1011",96,98,93,3,2,0.96875
2023-09-03,"3 - 1008",243,255,238,5,12,0.979423868312757
2023-09-03,"16 - 1022",60,60,54,6,0,0.9
2023-09-03,"24 - 1150",213,259,213,0,46,1
2023-09-03,"24 - 1153",390,410,390,0,20,1
2023-09-04,"62 - 1011",96,98,93,3,2,0.96875
2023-09-04,"3 - 1008",243,255,238,5,12,0.979423868312757
2023-09-04,"16 - 1022",60,60,54,6,0,0.9
2023-09-04,"24 - 1150",211,259,211,0,48,1
2023-09-04,"24 - 1153",390,410,390,0,20,1
2023-09-05,"62 - 1011",96,98,93,3,2,0.96875
2023-09-05,"3 - 1008",243,255,238,5,12,0.979423868312757
2023-09-05,"16 - 1022",60,60,55,5,0,0.916666666666667
2023-09-05,"24 - 1150",211,259,211,0,48,1
2023-09-05,"24 - 1153",390,410,390,0,20,1
2023-09-06,"62 - 1011",96,98,93,3,2,0.96875
2023-09-06,"3 - 1008",243,255,239,4,12,0.983539094650206
2023-09-06,"16 - 1022",60,60,55,5,0,0.916666666666667
2023-09-06,"24 - 1150",212,259,212,0,47,1
2023-09-06,"24 - 1153",393,410,393,0,17,1
2023-09-07,"62 - 1011",96,98,92,4,2,0.958333333333333
2023-09-07,"3 - 1008",243,255,236,7,12,0.97119341563786
2023-09-07,"16 - 1022",60,60,55,5,0,0.916666666666667
2023-09-07,"24 - 1150",210,259,210,0,49,1
2023-09-07,"24 - 1153",393,410,393,0,17,1
2023-09-08,"62 - 1011",96,98,91,5,2,0.947916666666667
2023-09-08,"3 - 1008",243,255,238,5,12,0.979423868312757
2023-09-08,"16 - 1022",60,60,57,3,0,0.95
2023-09-08,"24 - 1150",218,287,218,0,69,1
2023-09-08,"24 - 1153",393,410,393,0,17,1
2023-09-09,"62 - 1011",96,98,93,3,2,0.96875
2023-09-09,"3 - 1008",243,255,238,5,12,0.979423868312757
2023-09-09,"16 - 1022",60,60,57,3,0,0.95
2023-09-09,"24 - 1150",216,287,216,0,71,1
2023-09-09,"24 - 1153",393,410,393,0,17,1
2023-09-10,"62 - 1011",96,98,93,3,2,0.96875
2023-09-10,"3 - 1008",243,255,238,5,12,0.979423868312757
2023-09-10,"16 - 1022",60,60,57,3,0,0.95
2023-09-10,"24 - 1150",216,287,216,0,71,1
2023-09-10,"24 - 1153",392,410,392,0,18,1
2023-09-11,"62 - 1011",96,98,92,4,2,0.958333333333333
2023-09-11,"3 - 1008",243,255,238,5,12,0.979423868312757
2023-09-11,"16 - 1022",60,60,59,1,0,0.983333333333333
2023-09-11,"24 - 1150",216,287,216,0,71,1
2023-09-11,"24 - 1153",390,410,390,0,20,1
2023-09-12,"62 - 1011",96,98,91,5,2,0.947916666666667
2023-09-12,"3 - 1008",243,255,237,6,12,0.975308641975309
2023-09-12,"16 - 1022",59,60,58,1,1,0.983050847457627
2023-09-12,"24 - 1150",224,287,219,5,63,0.977678571428571
2023-09-12,"24 - 1153",392,410,392,0,18,1
2023-09-13,"62 - 1011",96,98,90,6,2,0.9375
2023-09-13,"3 - 1008",243,255,238,5,12,0.979423868312757
2023-09-13,"16 - 1022",60,60,58,2,0,0.966666666666667
2023-09-13,"24 - 1150",245,287,244,1,42,0.995918367346939
2023-09-13,"24 - 1153",390,410,390,0,20,1
2023-09-14,"62 - 1011",96,98,90,6,2,0.9375
2023-09-14,"3 - 1008",243,255,240,3,12,0.987654320987654
2023-09-14,"16 - 1022",60,60,60,0,0,1
2023-09-14,"24 - 1150",259,287,251,8,28,0.969111969111969
2023-09-14,"24 - 1153",386,410,386,0,24,1
2023-09-15,"62 - 1011",96,98,90,6,2,0.9375
2023-09-15,"3 - 1008",243,255,236,7,12,0.97119341563786
2023-09-15,"16 - 1022",60,60,59,1,0,0.983333333333333
2023-09-15,"24 - 1150",260,287,260,0,27,1
2023-09-15,"24 - 1153",396,416,396,0,20,1
2023-09-16,"62 - 1011",96,98,90,6,2,0.9375
2023-09-16,"3 - 1008",243,255,235,8,12,0.967078189300412
2023-09-16,"16 - 1022",60,60,57,3,0,0.95
2023-09-16,"24 - 1150",261,287,261,0,26,1
2023-09-16,"24 - 1153",396,416,396,0,20,1
2023-09-17,"62 - 1011",96,98,91,5,2,0.947916666666667
2023-09-17,"3 - 1008",243,255,235,8,12,0.967078189300412
2023-09-17,"16 - 1022",60,60,57,3,0,0.95
2023-09-17,"24 - 1150",261,287,261,0,26,1
2023-09-17,"24 - 1153",396,416,396,0,20,1
2023-09-18,"62 - 1011",96,98,93,3,2,0.96875
2023-09-18,"3 - 1008",245,255,237,8,10,0.96734693877551
2023-09-18,"16 - 1022",60,60,59,1,0,0.983333333333333
2023-09-18,"24 - 1150",261,287,259,2,26,0.992337164750958
2023-09-18,"24 - 1153",406,416,406,0,10,1
2023-09-19,"62 - 1011",96,98,94,2,2,0.979166666666667
2023-09-19,"3 - 1008",248,255,238,10,7,0.959677419354839
2023-09-19,"16 - 1022",60,60,57,3,0,0.95
2023-09-19,"24 - 1150",262,287,262,0,25,1
2023-09-19,"24 - 1153",404,416,403,1,12,0.997524752475248
2023-09-20,"62 - 1011",96,98,96,0,2,1
2023-09-20,"3 - 1008",250,255,240,10,5,0.96
2023-09-20,"16 - 1022",59,60,57,2,1,0.966101694915254
2023-09-20,"24 - 1150",261,287,261,0,26,1
2023-09-20,"24 - 1153",403,416,403,0,13,1
2023-09-21,"62 - 1011",96,98,95,1,2,0.989583333333333
2023-09-21,"3 - 1008",250,255,240,10,5,0.96
2023-09-21,"16 - 1022",60,60,58,2,0,0.966666666666667
2023-09-21,"24 - 1150",273,287,271,2,14,0.992673992673993
2023-09-21,"24 - 1153",405,416,405,0,11,1
2023-09-22,"62 - 1011",96,98,95,1,2,0.989583333333333
2023-09-22,"3 - 1008",250,255,240,10,5,0.96
2023-09-22,"16 - 1022",60,60,58,2,0,0.966666666666667
2023-09-22,"24 - 1150",275,287,275,0,12,1
2023-09-22,"24 - 1153",409,420,409,0,11,1
2023-09-23,"62 - 1011",96,98,96,0,2,1
2023-09-23,"3 - 1008",250,255,240,10,5,0.96
2023-09-23,"16 - 1022",60,60,58,2,0,0.966666666666667
2023-09-23,"24 - 1150",275,287,275,0,12,1
2023-09-23,"24 - 1153",410,420,410,0,10,1
2023-09-24,"62 - 1011",96,98,96,0,2,1
2023-09-24,"3 - 1008",250,255,239,11,5,0.956
2023-09-24,"16 - 1022",60,60,58,2,0,0.966666666666667
2023-09-24,"24 - 1150",273,287,273,0,14,1
2023-09-24,"24 - 1153",410,420,410,0,10,1
2023-09-25,"62 - 1011",96,98,96,0,2,1
2023-09-25,"3 - 1008",250,255,239,11,5,0.956
2023-09-25,"16 - 1022",60,60,58,2,0,0.966666666666667
2023-09-25,"24 - 1150",280,287,280,0,7,1
2023-09-25,"24 - 1153",410,420,409,1,10,0.997560975609756
2023-09-26,"62 - 1011",96,98,96,0,2,1
2023-09-26,"3 - 1008",250,255,239,11,5,0.956
2023-09-26,"16 - 1022",60,60,59,1,0,0.983333333333333
2023-09-26,"24 - 1150",279,287,279,0,8,1
2023-09-26,"24 - 1153",412,420,412,0,8,1
2023-09-27,"62 - 1011",96,98,95,1,2,0.989583333333333
2023-09-27,"3 - 1008",250,255,237,13,5,0.948
2023-09-27,"16 - 1022",60,60,59,1,0,0.983333333333333
2023-09-27,"24 - 1150",282,287,282,0,5,1
2023-09-27,"24 - 1153",412,420,412,0,8,1
2023-09-28,"62 - 1011",108,112,108,0,4,1
2023-09-28,"3 - 1008",250,255,237,13,5,0.948
2023-09-28,"16 - 1022",60,60,59,1,0,0.983333333333333
2023-09-28,"24 - 1150",283,287,283,0,4,1
2023-09-28,"24 - 1153",413,420,413,0,7,1
2023-09-29,"62 - 1011",112,112,110,2,0,0.982142857142857
2023-09-29,"3 - 1008",250,255,238,12,5,0.952
2023-09-29,"16 - 1022",60,60,58,2,0,0.966666666666667
2023-09-29,"24 - 1150",281,287,281,0,6,1
2023-09-29,"24 - 1153",413,420,413,0,7,1
2023-09-30,"62 - 1011",112,112,112,0,0,1
2023-09-30,"3 - 1008",250,255,238,12,5,0.952
2023-09-30,"16 - 1022",60,60,58,2,0,0.966666666666667
2023-09-30,"24 - 1150",279,287,279,0,8,1
2023-09-30,"24 - 1153",413,420,413,0,7,1
2023-10-01,"62 - 1011",112,112,112,0,0,1
2023-10-01,"3 - 1008",250,255,238,12,5,0.952
2023-10-01,"16 - 1022",60,60,57,3,0,0.95
2023-10-01,"24 - 1150",276,287,276,0,11,1
2023-10-01,"24 - 1153",414,420,414,0,6,1
2023-10-02,"62 - 1011",112,112,110,2,0,0.982142857142857
2023-10-02,"3 - 1008",250,255,237,13,5,0.948
2023-10-02,"16 - 1022",60,60,54,6,0,0.9
2023-10-02,"24 - 1150",282,287,274,8,5,0.971631205673759
2023-10-02,"24 - 1153",415,420,415,0,5,1
2023-10-03,"62 - 1011",112,112,112,0,0,1
2023-10-03,"3 - 1008",250,255,238,12,5,0.952
2023-10-03,"16 - 1022",60,60,56,4,0,0.933333333333333
2023-10-03,"24 - 1150",280,287,280,0,7,1
2023-10-03,"24 - 1153",415,420,415,0,5,1
2023-10-04,"62 - 1011",112,112,112,0,0,1
2023-10-04,"3 - 1008",250,255,238,12,5,0.952
2023-10-04,"16 - 1022",60,60,57,3,0,0.95
2023-10-04,"24 - 1150",282,287,280,2,5,0.99290780141844
2023-10-04,"24 - 1153",416,420,416,0,4,1
2023-10-05,"62 - 1011",112,112,111,1,0,0.991071428571429
2023-10-05,"3 - 1008",250,255,237,13,5,0.948
2023-10-05,"16 - 1022",60,60,57,3,0,0.95
2023-10-05,"24 - 1150",280,287,278,2,7,0.992857142857143
2023-10-05,"24 - 1153",416,420,416,0,4,1
2023-10-06,"62 - 1011",116,116,116,0,0,1
2023-10-06,"3 - 1008",250,255,237,13,5,0.948
2023-10-06,"16 - 1022",60,60,56,4,0,0.933333333333333
2023-10-06,"24 - 1150",282,287,280,2,5,0.99290780141844
2023-10-06,"24 - 1153",417,420,416,1,3,0.997601918465228
2023-10-07,"62 - 1011",116,116,116,0,0,1
2023-10-07,"3 - 1008",250,255,236,14,5,0.944
2023-10-07,"16 - 1022",60,60,56,4,0,0.933333333333333
2023-10-07,"24 - 1150",282,287,280,2,5,0.99290780141844
2023-10-07,"24 - 1153",417,420,417,0,3,1
2023-10-08,"62 - 1011",116,116,116,0,0,1
2023-10-08,"3 - 1008",250,255,237,13,5,0.948
2023-10-08,"16 - 1022",60,60,56,4,0,0.933333333333333
2023-10-08,"24 - 1150",282,287,282,0,5,1
2023-10-08,"24 - 1153",417,420,417,0,3,1
2023-10-09,"62 - 1011",116,116,116,0,0,1
2023-10-09,"3 - 1008",250,255,237,13,5,0.948
2023-10-09,"16 - 1022",60,60,56,4,0,0.933333333333333
2023-10-09,"24 - 1150",283,287,283,0,4,1
2023-10-09,"24 - 1153",417,420,416,1,3,0.997601918465228
2023-10-10,"62 - 1011",116,116,116,0,0,1
2023-10-10,"3 - 1008",250,255,236,14,5,0.944
2023-10-10,"16 - 1022",60,60,59,1,0,0.983333333333333
2023-10-10,"24 - 1150",284,287,284,0,3,1
2023-10-10,"24 - 1153",417,420,417,0,3,1
2023-10-11,"62 - 1011",116,116,114,2,0,0.982758620689655
2023-10-11,"3 - 1008",250,255,234,16,5,0.936
2023-10-11,"16 - 1022",60,60,60,0,0,1
2023-10-11,"24 - 1150",285,287,285,0,2,1
2023-10-11,"24 - 1153",417,420,416,1,3,0.997601918465228
2023-10-12,"62 - 1011",116,116,116,0,0,1
2023-10-12,"3 - 1008",251,255,235,16,4,0.936254980079681
2023-10-12,"16 - 1022",60,60,60,0,0,1
2023-10-12,"24 - 1150",286,287,285,1,1,0.996503496503496
2023-10-12,"24 - 1153",417,420,417,0,3,1
2023-10-13,"62 - 1011",116,116,116,0,0,1
2023-10-13,"3 - 1008",251,255,236,15,4,0.940239043824701
2023-10-13,"16 - 1022",60,60,60,0,0,1
2023-10-13,"24 - 1150",285,287,285,0,2,1
2023-10-13,"24 - 1153",417,420,417,0,3,1
2023-10-14,"62 - 1011",116,116,116,0,0,1
2023-10-14,"3 - 1008",252,255,237,15,3,0.94047619047619
2023-10-14,"16 - 1022",60,60,60,0,0,1
2023-10-14,"24 - 1150",284,287,284,0,3,1
2023-10-14,"24 - 1153",417,420,417,0,3,1
2023-10-15,"62 - 1011",116,116,116,0,0,1
2023-10-15,"3 - 1008",252,255,237,15,3,0.94047619047619
2023-10-15,"16 - 1022",60,60,60,0,0,1
2023-10-15,"24 - 1150",284,287,284,0,3,1
2023-10-15,"24 - 1153",417,420,417,0,3,1
2023-10-16,"62 - 1011",116,116,116,0,0,1
2023-10-16,"3 - 1008",254,255,239,15,1,0.940944881889764
2023-10-16,"16 - 1022",60,60,60,0,0,1
2023-10-16,"24 - 1150",284,287,284,0,3,1
2023-10-16,"24 - 1153",418,420,418,0,2,1
2023-10-17,"62 - 1011",116,116,115,1,0,0.991379310344828
2023-10-17,"3 - 1008",254,255,240,14,1,0.94488188976378
2023-10-17,"16 - 1022",60,60,60,0,0,1
2023-10-17,"24 - 1150",285,287,285,0,2,1
2023-10-17,"24 - 1153",418,420,418,0,2,1
2023-10-18,"62 - 1011",116,116,113,3,0,0.974137931034483
2023-10-18,"3 - 1008",253,255,239,14,2,0.944664031620553
2023-10-18,"16 - 1022",60,60,60,0,0,1
2023-10-18,"24 - 1150",285,287,285,0,2,1
2023-10-18,"24 - 1153",416,420,416,0,4,1
2023-10-19,"62 - 1011",116,116,116,0,0,1
2023-10-19,"3 - 1008",253,255,239,14,2,0.944664031620553
2023-10-19,"16 - 1022",60,60,60,0,0,1
2023-10-19,"24 - 1150",284,287,284,0,3,1
2023-10-19,"24 - 1153",416,420,416,0,4,1
2023-10-20,"62 - 1011",116,116,116,0,0,1
2023-10-20,"3 - 1008",254,255,241,13,1,0.948818897637795
2023-10-20,"16 - 1022",60,60,59,1,0,0.983333333333333
2023-10-20,"24 - 1150",284,287,284,0,3,1
2023-10-20,"24 - 1153",416,420,416,0,4,1
2023-10-21,"62 - 1011",116,116,116,0,0,1
2023-10-21,"3 - 1008",254,255,241,13,1,0.948818897637795
2023-10-21,"16 - 1022",60,60,59,1,0,0.983333333333333
2023-10-21,"24 - 1150",281,287,281,0,6,1
2023-10-21,"24 - 1153",416,420,416,0,4,1
2023-10-22,"62 - 1011",116,116,115,1,0,0.991379310344828
2023-10-22,"3 - 1008",253,255,240,13,2,0.948616600790514
2023-10-22,"16 - 1022",60,60,59,1,0,0.983333333333333
2023-10-22,"24 - 1150",282,287,282,0,5,1
2023-10-22,"24 - 1153",416,420,416,0,4,1
2023-10-23,"62 - 1011",116,116,116,0,0,1
2023-10-23,"3 - 1008",253,255,240,13,2,0.948616600790514
2023-10-23,"16 - 1022",60,60,60,0,0,1
2023-10-23,"24 - 1150",282,287,282,0,5,1
2023-10-23,"24 - 1153",416,420,415,1,4,0.997596153846154
2023-10-24,"62 - 1011",116,116,116,0,0,1
2023-10-24,"3 - 1008",252,255,238,14,3,0.944444444444444
2023-10-24,"16 - 1022",60,60,60,0,0,1
2023-10-24,"24 - 1150",282,287,282,0,5,1
2023-10-24,"24 - 1153",416,420,416,0,4,1
2023-10-25,"62 - 1011",116,116,116,0,0,1
2023-10-25,"3 - 1008",251,255,239,12,4,0.952191235059761
2023-10-25,"16 - 1022",60,60,60,0,0,1
2023-10-25,"24 - 1150",282,287,282,0,5,1
2023-10-25,"24 - 1153",418,420,418,0,2,1
2023-10-26,"62 - 1011",116,116,116,0,0,1
2023-10-26,"3 - 1008",251,255,239,12,4,0.952191235059761
2023-10-26,"16 - 1022",60,60,60,0,0,1
2023-10-26,"24 - 1150",281,287,281,0,6,1
2023-10-26,"24 - 1153",418,420,418,0,2,1
2023-10-27,"62 - 1011",116,116,116,0,0,1
2023-10-27,"3 - 1008",251,255,240,11,4,0.956175298804781
2023-10-27,"16 - 1022",60,60,59,1,0,0.983333333333333
2023-10-27,"24 - 1150",281,287,279,2,6,0.99288256227758
2023-10-27,"24 - 1153",418,420,418,0,2,1
2023-10-28,"62 - 1011",116,116,115,1,0,0.991379310344828
2023-10-28,"3 - 1008",249,255,238,11,6,0.955823293172691
2023-10-28,"16 - 1022",60,60,59,1,0,0.983333333333333
2023-10-28,"24 - 1150",282,287,282,0,5,1
2023-10-28,"24 - 1153",418,420,418,0,2,1
2023-10-29,"62 - 1011",116,116,116,0,0,1
2023-10-29,"3 - 1008",249,255,238,11,6,0.955823293172691
2023-10-29,"16 - 1022",60,60,59,1,0,0.983333333333333
2023-10-29,"24 - 1150",282,287,282,0,5,1
2023-10-29,"24 - 1153",418,420,418,0,2,1
2023-10-30,"62 - 1011",116,116,115,1,0,0.991379310344828
2023-10-30,"3 - 1008",249,255,238,11,6,0.955823293172691
2023-10-30,"16 - 1022",60,60,59,1,0,0.983333333333333
2023-10-30,"24 - 1150",282,287,282,0,5,1
2023-10-30,"24 - 1153",418,420,418,0,2,1
2023-10-31,"62 - 1011",116,116,114,2,0,0.982758620689655
2023-10-31,"3 - 1008",249,255,238,11,6,0.955823293172691
2023-10-31,"16 - 1022",60,60,59,1,0,0.983333333333333
2023-10-31,"24 - 1150",282,287,282,0,5,1
2023-10-31,"24 - 1153",418,420,418,0,2,1
2023-11-01,"62 - 1011",116,116,114,2,0,0.982758620689655
2023-11-01,"3 - 1008",248,255,238,10,7,0.959677419354839
2023-11-01,"16 - 1022",60,60,58,2,0,0.966666666666667
2023-11-01,"24 - 1150",281,287,281,0,6,1
2023-11-01,"24 - 1153",418,420,418,0,2,1
2023-11-02,"62 - 1011",116,116,114,2,0,0.982758620689655
2023-11-02,"3 - 1008",249,255,241,8,6,0.967871485943775
2023-11-02,"16 - 1022",60,60,59,1,0,0.983333333333333
2023-11-02,"24 - 1150",279,287,279,0,8,1
2023-11-02,"24 - 1153",418,420,418,0,2,1
2023-11-03,"62 - 1011",116,116,114,2,0,0.982758620689655
2023-11-03,"3 - 1008",249,255,242,7,6,0.971887550200803
2023-11-03,"16 - 1022",60,60,58,2,0,0.966666666666667
2023-11-03,"24 - 1150",279,287,277,2,8,0.992831541218638
2023-11-03,"24 - 1153",418,420,418,0,2,1
2023-11-04,"62 - 1011",116,116,115,1,0,0.991379310344828
2023-11-04,"3 - 1008",249,255,242,7,6,0.971887550200803
2023-11-04,"16 - 1022",60,60,58,2,0,0.966666666666667
2023-11-04,"24 - 1150",278,287,278,0,9,1
2023-11-04,"24 - 1153",418,420,418,0,2,1
2023-11-05,"62 - 1011",116,116,115,1,0,0.991379310344828
2023-11-05,"3 - 1008",249,255,242,7,6,0.971887550200803
2023-11-05,"16 - 1022",60,60,58,2,0,0.966666666666667
2023-11-05,"24 - 1150",278,287,278,0,9,1
2023-11-05,"24 - 1153",418,420,417,1,2,0.997607655502392
2023-11-06,"62 - 1011",116,116,115,1,0,0.991379310344828
2023-11-06,"3 - 1008",250,255,241,9,5,0.964
2023-11-06,"16 - 1022",60,60,57,3,0,0.95
2023-11-06,"24 - 1150",276,287,274,2,11,0.992753623188406
2023-11-06,"24 - 1153",418,420,418,0,2,1
2023-11-07,"62 - 1011",116,116,116,0,0,1
2023-11-07,"3 - 1008",250,255,240,10,5,0.96
2023-11-07,"16 - 1022",60,60,58,2,0,0.966666666666667
2023-11-07,"24 - 1150",276,287,276,0,11,1
2023-11-07,"24 - 1153",418,420,418,0,2,1
2023-11-08,"62 - 1011",116,116,115,1,0,0.991379310344828
2023-11-08,"3 - 1008",250,354,242,8,104,0.968
2023-11-08,"16 - 1022",60,60,59,1,0,0.983333333333333
2023-11-08,"24 - 1150",279,287,279,0,8,1
2023-11-08,"24 - 1153",418,420,418,0,2,1
2023-11-09,"62 - 1011",116,116,116,0,0,1
2023-11-09,"3 - 1008",250,354,241,9,104,0.964
2023-11-09,"16 - 1022",60,60,58,2,0,0.966666666666667
2023-11-09,"24 - 1150",281,287,281,0,6,1
2023-11-09,"24 - 1153",418,420,418,0,2,1
2023-11-10,"62 - 1011",116,116,116,0,0,1
2023-11-10,"3 - 1008",250,354,242,8,104,0.968
2023-11-10,"16 - 1022",60,60,56,4,0,0.933333333333333
2023-11-10,"24 - 1150",282,287,282,0,5,1
2023-11-10,"24 - 1153",418,420,418,0,2,1
2023-11-11,"62 - 1011",116,116,116,0,0,1
2023-11-11,"3 - 1008",250,354,242,8,104,0.968
2023-11-11,"16 - 1022",60,60,56,4,0,0.933333333333333
2023-11-11,"24 - 1150",283,287,283,0,4,1
2023-11-11,"24 - 1153",418,420,418,0,2,1
2023-11-12,"62 - 1011",116,116,116,0,0,1
2023-11-12,"3 - 1008",250,354,241,9,104,0.964
2023-11-12,"16 - 1022",60,60,56,4,0,0.933333333333333
2023-11-12,"24 - 1150",283,287,283,0,4,1
2023-11-12,"24 - 1153",418,420,418,0,2,1
2023-11-13,"62 - 1011",116,116,116,0,0,1
2023-11-13,"3 - 1008",250,354,242,8,104,0.968
2023-11-13,"16 - 1022",60,60,56,4,0,0.933333333333333
2023-11-13,"24 - 1150",283,287,283,0,4,1
2023-11-13,"24 - 1153",418,420,418,0,2,1
2023-11-14,"62 - 1011",116,116,113,3,0,0.974137931034483
2023-11-14,"3 - 1008",250,354,243,7,104,0.972
2023-11-14,"16 - 1022",60,60,56,4,0,0.933333333333333
2023-11-14,"24 - 1150",284,287,284,0,3,1
2023-11-14,"24 - 1153",418,420,418,0,2,1
2023-11-15,"62 - 1011",116,116,113,3,0,0.974137931034483
2023-11-15,"3 - 1008",270,354,259,11,84,0.959259259259259
2023-11-15,"16 - 1022",60,60,56,4,0,0.933333333333333
2023-11-15,"24 - 1150",285,287,285,0,2,1
2023-11-15,"24 - 1153",418,420,418,0,2,1
2023-11-16,"62 - 1011",116,116,113,3,0,0.974137931034483
2023-11-16,"3 - 1008",275,354,270,5,79,0.981818181818182
2023-11-16,"16 - 1022",60,60,57,3,0,0.95
2023-11-16,"24 - 1150",285,287,285,0,2,1
2023-11-16,"24 - 1153",418,420,418,0,2,1
2023-11-17,"62 - 1011",116,116,114,2,0,0.982758620689655
2023-11-17,"3 - 1008",292,354,289,3,62,0.98972602739726
2023-11-17,"16 - 1022",60,60,57,3,0,0.95
2023-11-17,"24 - 1150",285,287,285,0,2,1
2023-11-17,"24 - 1153",418,420,418,0,2,1
2023-11-18,"62 - 1011",116,116,113,3,0,0.974137931034483
2023-11-18,"3 - 1008",311,354,308,3,43,0.990353697749196
2023-11-18,"16 - 1022",60,60,57,3,0,0.95
2023-11-18,"24 - 1150",285,287,285,0,2,1
2023-11-18,"24 - 1153",418,420,418,0,2,1
2023-11-19,"62 - 1011",116,116,113,3,0,0.974137931034483
2023-11-19,"3 - 1008",319,354,316,3,35,0.990595611285266
2023-11-19,"16 - 1022",60,60,58,2,0,0.966666666666667
2023-11-19,"24 - 1150",285,287,285,0,2,1
2023-11-19,"24 - 1153",418,420,418,0,2,1
2023-11-20,"62 - 1011",116,116,113,3,0,0.974137931034483
2023-11-20,"3 - 1008",326,354,319,7,28,0.978527607361963
2023-11-20,"16 - 1022",60,60,59,1,0,0.983333333333333
2023-11-20,"24 - 1150",285,287,285,0,2,1
2023-11-20,"24 - 1153",418,420,418,0,2,1
2023-11-21,"62 - 1011",116,116,113,3,0,0.974137931034483
2023-11-21,"3 - 1008",338,354,331,7,16,0.979289940828402
2023-11-21,"16 - 1022",60,60,59,1,0,0.983333333333333
2023-11-21,"24 - 1150",285,287,285,0,2,1
2023-11-21,"24 - 1153",418,420,418,0,2,1
2023-11-22,"62 - 1011",116,116,114,2,0,0.982758620689655
2023-11-22,"3 - 1008",346,354,338,8,8,0.976878612716763
2023-11-22,"16 - 1022",60,60,58,2,0,0.966666666666667
2023-11-22,"24 - 1150",285,287,285,0,2,1
2023-11-22,"24 - 1153",418,420,418,0,2,1
2023-11-23,"62 - 1011",116,116,115,1,0,0.991379310344828
2023-11-23,"3 - 1008",346,354,341,5,8,0.985549132947977
2023-11-23,"16 - 1022",60,60,58,2,0,0.966666666666667
2023-11-23,"24 - 1150",284,287,284,0,3,1
2023-11-23,"24 - 1153",417,420,417,0,3,1
2023-11-24,"62 - 1011",116,116,115,1,0,0.991379310344828
2023-11-24,"3 - 1008",346,354,341,5,8,0.985549132947977
2023-11-24,"16 - 1022",60,60,60,0,0,1
2023-11-24,"24 - 1150",283,287,283,0,4,1
2023-11-24,"24 - 1153",417,420,417,0,3,1
2023-11-25,"62 - 1011",116,116,115,1,0,0.991379310344828
2023-11-25,"3 - 1008",346,354,342,4,8,0.988439306358382
2023-11-25,"16 - 1022",60,60,60,0,0,1
2023-11-25,"24 - 1150",284,287,284,0,3,1
2023-11-25,"24 - 1153",417,420,416,1,3,0.997601918465228
2023-11-26,"62 - 1011",116,116,115,1,0,0.991379310344828
2023-11-26,"3 - 1008",346,354,342,4,8,0.988439306358382
2023-11-26,"16 - 1022",60,60,60,0,0,1
2023-11-26,"24 - 1150",284,287,284,0,3,1
2023-11-26,"24 - 1153",417,420,417,0,3,1
2023-11-27,"62 - 1011",116,116,116,0,0,1
2023-11-27,"3 - 1008",347,354,342,5,7,0.985590778097983
2023-11-27,"16 - 1022",60,60,60,0,0,1
2023-11-27,"24 - 1150",281,287,281,0,6,1
2023-11-27,"24 - 1153",417,420,417,0,3,1
2023-11-28,"62 - 1011",116,116,114,2,0,0.982758620689655
2023-11-28,"3 - 1008",347,354,343,4,7,0.988472622478386
2023-11-28,"16 - 1022",60,60,60,0,0,1
2023-11-28,"24 - 1150",281,287,281,0,6,1
2023-11-28,"24 - 1153",416,420,416,0,4,1
2023-11-29,"62 - 1011",116,116,113,3,0,0.974137931034483
2023-11-29,"3 - 1008",346,354,343,3,8,0.991329479768786
2023-11-29,"16 - 1022",60,60,60,0,0,1
2023-11-29,"24 - 1150",281,287,281,0,6,1
2023-11-29,"24 - 1153",418,420,418,0,2,1
2023-11-30,"62 - 1011",116,116,116,0,0,1
2023-11-30,"3 - 1008",346,354,343,3,8,0.991329479768786
2023-11-30,"16 - 1022",60,60,58,2,0,0.966666666666667
2023-11-30,"24 - 1150",284,287,284,0,3,1
2023-11-30,"24 - 1153",418,420,418,0,2,1
2023-12-01,"62 - 1011",116,116,115,1,0,0.991379310344828
2023-12-01,"3 - 1008",346,354,343,3,8,0.991329479768786
2023-12-01,"16 - 1022",60,60,59,1,0,0.983333333333333
2023-12-01,"24 - 1150",283,287,283,0,4,1
2023-12-01,"24 - 1153",418,420,418,0,2,1
2023-12-02,"62 - 1011",116,116,112,4,0,0.96551724137931
2023-12-02,"3 - 1008",346,354,343,3,8,0.991329479768786
2023-12-02,"16 - 1022",60,60,57,3,0,0.95
2023-12-02,"24 - 1150",283,287,283,0,4,1
2023-12-02,"24 - 1153",418,420,418,0,2,1
2023-12-03,"62 - 1011",116,116,112,4,0,0.96551724137931
2023-12-03,"3 - 1008",346,354,343,3,8,0.991329479768786
2023-12-03,"16 - 1022",60,60,57,3,0,0.95
2023-12-03,"24 - 1150",281,287,281,0,6,1
2023-12-03,"24 - 1153",418,420,418,0,2,1
2023-12-04,"62 - 1011",116,116,114,2,0,0.982758620689655
2023-12-04,"3 - 1008",346,354,342,4,8,0.988439306358382
2023-12-04,"16 - 1022",60,60,56,4,0,0.933333333333333
2023-12-04,"24 - 1150",283,287,283,0,4,1
2023-12-04,"24 - 1153",418,420,418,0,2,1
2023-12-05,"62 - 1011",116,116,114,2,0,0.982758620689655
2023-12-05,"3 - 1008",350,354,344,6,4,0.982857142857143
2023-12-05,"16 - 1022",59,60,56,3,1,0.949152542372881
2023-12-05,"24 - 1150",285,287,285,0,2,1
2023-12-05,"24 - 1153",418,420,418,0,2,1
2023-12-06,"62 - 1011",116,116,113,3,0,0.974137931034483
2023-12-06,"3 - 1008",349,354,343,6,5,0.982808022922636
2023-12-06,"16 - 1022",59,60,56,3,1,0.949152542372881
2023-12-06,"24 - 1150",285,287,285,0,2,1
2023-12-06,"24 - 1153",418,420,418,0,2,1
2023-12-07,"62 - 1011",116,116,114,2,0,0.982758620689655
2023-12-07,"3 - 1008",348,354,342,6,6,0.982758620689655
2023-12-07,"16 - 1022",59,60,56,3,1,0.949152542372881
2023-12-07,"24 - 1150",284,287,284,0,3,1
2023-12-07,"24 - 1153",418,420,416,2,2,0.995215311004785
2023-12-08,"62 - 1011",116,116,114,2,0,0.982758620689655
2023-12-08,"3 - 1008",348,354,341,7,6,0.979885057471264
2023-12-08,"16 - 1022",59,60,56,3,1,0.949152542372881
2023-12-08,"24 - 1150",283,287,283,0,4,1
2023-12-08,"24 - 1153",418,420,418,0,2,1
2023-12-09,"62 - 1011",116,116,113,3,0,0.974137931034483
2023-12-09,"3 - 1008",348,354,341,7,6,0.979885057471264
2023-12-09,"16 - 1022",59,60,56,3,1,0.949152542372881
2023-12-09,"24 - 1150",284,287,284,0,3,1
2023-12-09,"24 - 1153",418,420,417,1,2,0.997607655502392
2023-12-10,"62 - 1011",116,116,113,3,0,0.974137931034483
2023-12-10,"3 - 1008",348,354,339,9,6,0.974137931034483
2023-12-10,"16 - 1022",59,60,56,3,1,0.949152542372881
2023-12-10,"24 - 1150",284,287,282,2,3,0.992957746478873
2023-12-10,"24 - 1153",418,420,417,1,2,0.997607655502392
2023-12-11,"62 - 1011",116,116,113,3,0,0.974137931034483
2023-12-11,"3 - 1008",348,354,342,6,6,0.982758620689655
2023-12-11,"16 - 1022",59,60,56,3,1,0.949152542372881
2023-12-11,"24 - 1150",285,287,285,0,2,1
2023-12-11,"24 - 1153",418,420,418,0,2,1
2023-12-12,"62 - 1011",116,116,112,4,0,0.96551724137931
2023-12-12,"3 - 1008",348,354,341,7,6,0.979885057471264
2023-12-12,"16 - 1022",59,60,57,2,1,0.966101694915254
2023-12-12,"24 - 1150",284,287,282,2,3,0.992957746478873
2023-12-12,"24 - 1153",418,420,418,0,2,1
2023-12-13,"62 - 1011",116,116,113,3,0,0.974137931034483
2023-12-13,"3 - 1008",345,354,339,6,9,0.982608695652174
2023-12-13,"16 - 1022",59,60,57,2,1,0.966101694915254
2023-12-13,"24 - 1150",285,287,285,0,2,1
2023-12-13,"24 - 1153",418,420,417,1,2,0.997607655502392
2023-12-14,"62 - 1011",116,116,112,4,0,0.96551724137931
2023-12-14,"3 - 1008",345,354,334,11,9,0.968115942028986
2023-12-14,"16 - 1022",59,60,57,2,1,0.966101694915254
2023-12-14,"24 - 1150",285,287,285,0,2,1
2023-12-14,"24 - 1153",418,420,418,0,2,1
2023-12-15,"62 - 1011",116,116,111,5,0,0.956896551724138
2023-12-15,"3 - 1008",345,354,338,7,9,0.979710144927536
2023-12-15,"16 - 1022",59,60,56,3,1,0.949152542372881
2023-12-15,"24 - 1150",285,287,285,0,2,1
2023-12-15,"24 - 1153",418,420,418,0,2,1
2023-12-16,"62 - 1011",116,116,111,5,0,0.956896551724138
2023-12-16,"3 - 1008",345,354,341,4,9,0.988405797101449
2023-12-16,"16 - 1022",59,60,55,4,1,0.932203389830508
2023-12-16,"24 - 1150",285,287,285,0,2,1
2023-12-16,"24 - 1153",418,420,418,0,2,1
2023-12-17,"62 - 1011",116,116,111,5,0,0.956896551724138
2023-12-17,"3 - 1008",344,354,341,3,10,0.991279069767442
2023-12-17,"16 - 1022",59,60,57,2,1,0.966101694915254
2023-12-17,"24 - 1150",284,287,284,0,3,1
2023-12-17,"24 - 1153",418,420,418,0,2,1
2023-12-18,"62 - 1011",116,116,112,4,0,0.96551724137931
2023-12-18,"3 - 1008",344,354,341,3,10,0.991279069767442
2023-12-18,"16 - 1022",59,60,58,1,1,0.983050847457627
2023-12-18,"24 - 1150",283,287,283,0,4,1
2023-12-18,"24 - 1153",418,420,418,0,2,1
2023-12-19,"62 - 1011",116,116,112,4,0,0.96551724137931
2023-12-19,"3 - 1008",343,354,342,1,11,0.997084548104956
2023-12-19,"16 - 1022",59,60,58,1,1,0.983050847457627
2023-12-19,"24 - 1150",282,287,282,0,5,1
2023-12-19,"24 - 1153",420,420,419,1,0,0.997619047619048
2023-12-20,"62 - 1011",116,116,112,4,0,0.96551724137931
2023-12-20,"3 - 1008",341,354,338,3,13,0.991202346041056
2023-12-20,"16 - 1022",59,60,59,0,1,1
2023-12-20,"24 - 1150",283,287,283,0,4,1
2023-12-20,"24 - 1153",420,420,420,0,0,1
2023-12-21,"62 - 1011",116,116,112,4,0,0.96551724137931
2023-12-21,"3 - 1008",339,354,338,1,15,0.997050147492625
2023-12-21,"16 - 1022",59,60,57,2,1,0.966101694915254
2023-12-21,"24 - 1150",281,287,281,0,6,1
2023-12-21,"24 - 1153",420,420,420,0,0,1
2023-12-22,"62 - 1011",116,116,111,5,0,0.956896551724138
2023-12-22,"3 - 1008",339,354,337,2,15,0.994100294985251
2023-12-22,"16 - 1022",60,60,58,2,0,0.966666666666667
2023-12-22,"24 - 1150",280,287,280,0,7,1
2023-12-22,"24 - 1153",420,420,419,1,0,0.997619047619048
2023-12-23,"62 - 1011",116,116,111,5,0,0.956896551724138
2023-12-23,"3 - 1008",338,354,337,1,16,0.997041420118343
2023-12-23,"16 - 1022",60,60,58,2,0,0.966666666666667
2023-12-23,"24 - 1150",278,287,278,0,9,1
2023-12-23,"24 - 1153",420,420,420,0,0,1
2023-12-24,"62 - 1011",116,116,110,6,0,0.948275862068966
2023-12-24,"3 - 1008",338,354,336,2,16,0.994082840236686
2023-12-24,"16 - 1022",60,60,57,3,0,0.95
2023-12-24,"24 - 1150",280,287,279,1,7,0.996428571428571
2023-12-24,"24 - 1153",420,420,420,0,0,1
2023-12-25,"62 - 1011",116,116,110,6,0,0.948275862068966
2023-12-25,"3 - 1008",338,354,336,2,16,0.994082840236686
2023-12-25,"16 - 1022",60,60,57,3,0,0.95
2023-12-25,"24 - 1150",280,287,280,0,7,1
2023-12-25,"24 - 1153",420,420,420,0,0,1
2023-12-26,"62 - 1011",116,116,110,6,0,0.948275862068966
2023-12-26,"3 - 1008",338,354,336,2,16,0.994082840236686
2023-12-26,"16 - 1022",60,60,57,3,0,0.95
2023-12-26,"24 - 1150",279,287,278,1,8,0.996415770609319
2023-12-26,"24 - 1153",420,420,420,0,0,1
2023-12-27,"62 - 1011",116,116,110,6,0,0.948275862068966
2023-12-27,"3 - 1008",340,354,338,2,14,0.994117647058824
2023-12-27,"16 - 1022",60,60,57,3,0,0.95
2023-12-27,"24 - 1150",280,287,279,1,7,0.996428571428571
2023-12-27,"24 - 1153",420,420,420,0,0,1
2023-12-28,"62 - 1011",116,116,108,8,0,0.931034482758621
2023-12-28,"3 - 1008",340,354,338,2,14,0.994117647058824
2023-12-28,"16 - 1022",60,60,57,3,0,0.95
2023-12-28,"24 - 1150",281,287,280,1,6,0.99644128113879
2023-12-28,"24 - 1153",420,420,420,0,0,1
2023-12-29,"62 - 1011",116,116,108,8,0,0.931034482758621
2023-12-29,"3 - 1008",340,354,338,2,14,0.994117647058824
2023-12-29,"16 - 1022",60,60,59,1,0,0.983333333333333
2023-12-29,"24 - 1150",282,287,281,1,5,0.99645390070922
2023-12-29,"24 - 1153",420,420,420,0,0,1
2023-12-30,"62 - 1011",116,116,108,8,0,0.931034482758621
2023-12-30,"3 - 1008",342,354,337,5,12,0.985380116959064
2023-12-30,"16 - 1022",60,60,59,1,0,0.983333333333333
2023-12-30,"24 - 1150",281,287,280,1,6,0.99644128113879
2023-12-30,"24 - 1153",420,420,420,0,0,1
2023-12-31,"62 - 1011",116,116,107,9,0,0.922413793103448
2023-12-31,"3 - 1008",342,354,337,5,12,0.985380116959064
2023-12-31,"16 - 1022",60,60,58,2,0,0.966666666666667
2023-12-31,"24 - 1150",281,287,280,1,6,0.99644128113879
2023-12-31,"24 - 1153",420,420,420,0,0,1
2024-01-01,"62 - 1011",116,116,107,9,0,0.922413793103448
2024-01-01,"3 - 1008",342,354,339,3,12,0.991228070175439
2024-01-01,"16 - 1022",60,60,58,2,0,0.966666666666667
2024-01-01,"24 - 1150",280,287,279,1,7,0.996428571428571
2024-01-01,"24 - 1153",420,420,420,0,0,1
2024-01-02,"62 - 1011",116,116,106,10,0,0.913793103448276
2024-01-02,"3 - 1008",344,354,339,5,10,0.98546511627907
2024-01-02,"16 - 1022",60,60,58,2,0,0.966666666666667
2024-01-02,"24 - 1150",284,287,282,2,3,0.992957746478873
2024-01-02,"24 - 1153",420,420,420,0,0,1
2024-01-03,"62 - 1011",116,116,105,11,0,0.905172413793103
2024-01-03,"3 - 1008",344,354,337,7,10,0.979651162790698
2024-01-03,"16 - 1022",60,60,58,2,0,0.966666666666667
2024-01-03,"24 - 1150",284,287,282,2,3,0.992957746478873
2024-01-03,"24 - 1153",420,420,419,1,0,0.997619047619048
2024-01-04,"62 - 1011",116,116,106,10,0,0.913793103448276
2024-01-04,"3 - 1008",344,354,335,9,10,0.973837209302326
2024-01-04,"16 - 1022",60,60,59,1,0,0.983333333333333
2024-01-04,"24 - 1150",284,287,284,0,3,1
2024-01-04,"24 - 1153",420,420,420,0,0,1
2024-01-05,"62 - 1011",116,116,109,7,0,0.939655172413793
2024-01-05,"3 - 1008",343,354,337,6,11,0.982507288629738
2024-01-05,"16 - 1022",60,60,58,2,0,0.966666666666667
2024-01-05,"24 - 1150",284,287,283,1,3,0.996478873239437
2024-01-05,"24 - 1153",420,420,420,0,0,1
2024-01-06,"62 - 1011",116,116,109,7,0,0.939655172413793
2024-01-06,"3 - 1008",343,354,337,6,11,0.982507288629738
2024-01-06,"16 - 1022",60,60,58,2,0,0.966666666666667
2024-01-06,"24 - 1150",284,287,284,0,3,1
2024-01-06,"24 - 1153",420,420,419,1,0,0.997619047619048
2024-01-07,"62 - 1011",116,116,109,7,0,0.939655172413793
2024-01-07,"3 - 1008",344,354,341,3,10,0.991279069767442
2024-01-07,"16 - 1022",60,60,58,2,0,0.966666666666667
2024-01-07,"24 - 1150",284,287,284,0,3,1
2024-01-07,"24 - 1153",420,420,420,0,0,1
2024-01-08,"62 - 1011",116,116,109,7,0,0.939655172413793
2024-01-08,"3 - 1008",344,354,342,2,10,0.994186046511628
2024-01-08,"16 - 1022",60,60,59,1,0,0.983333333333333
2024-01-08,"24 - 1150",283,287,283,0,4,1
2024-01-08,"24 - 1153",420,420,420,0,0,1
2024-01-09,"62 - 1011",116,116,110,6,0,0.948275862068966
2024-01-09,"3 - 1008",345,354,340,5,9,0.985507246376812
2024-01-09,"16 - 1022",60,60,59,1,0,0.983333333333333
2024-01-09,"24 - 1150",283,287,283,0,4,1
2024-01-09,"24 - 1153",420,420,420,0,0,1
2024-01-10,"62 - 1011",116,116,110,6,0,0.948275862068966
2024-01-10,"3 - 1008",346,354,340,6,8,0.982658959537572
2024-01-10,"16 - 1022",60,60,59,1,0,0.983333333333333
2024-01-10,"24 - 1150",283,287,283,0,4,1
2024-01-10,"24 - 1153",420,420,418,2,0,0.995238095238095
2024-01-11,"62 - 1011",116,116,110,6,0,0.948275862068966
2024-01-11,"3 - 1008",346,354,341,5,8,0.985549132947977
2024-01-11,"16 - 1022",60,60,59,1,0,0.983333333333333
2024-01-11,"24 - 1150",284,287,283,1,3,0.996478873239437
2024-01-11,"24 - 1153",420,420,420,0,0,1
2024-01-12,"62 - 1011",116,116,110,6,0,0.948275862068966
2024-01-12,"3 - 1008",346,354,341,5,8,0.985549132947977
2024-01-12,"16 - 1022",60,60,58,2,0,0.966666666666667
2024-01-12,"24 - 1150",283,287,283,0,4,1
2024-01-12,"24 - 1153",420,420,417,3,0,0.992857142857143
2024-01-13,"62 - 1011",116,116,111,5,0,0.956896551724138
2024-01-13,"3 - 1008",346,354,342,4,8,0.988439306358382
2024-01-13,"16 - 1022",60,60,58,2,0,0.966666666666667
2024-01-13,"24 - 1150",283,287,283,0,4,1
2024-01-13,"24 - 1153",420,420,420,0,0,1
2024-01-14,"62 - 1011",116,116,111,5,0,0.956896551724138
2024-01-14,"3 - 1008",346,354,343,3,8,0.991329479768786
2024-01-14,"16 - 1022",60,60,58,2,0,0.966666666666667
2024-01-14,"24 - 1150",283,287,283,0,4,1
2024-01-14,"24 - 1153",420,420,420,0,0,1
2024-01-15,"62 - 1011",116,116,110,6,0,0.948275862068966
2024-01-15,"3 - 1008",348,354,345,3,6,0.991379310344828
2024-01-15,"16 - 1022",59,60,57,2,1,0.966101694915254
2024-01-15,"24 - 1150",283,287,283,0,4,1
2024-01-15,"24 - 1153",420,420,419,1,0,0.997619047619048
2024-01-16,"62 - 1011",116,116,111,5,0,0.956896551724138
2024-01-16,"3 - 1008",348,354,345,3,6,0.991379310344828
2024-01-16,"16 - 1022",59,60,57,2,1,0.966101694915254
2024-01-16,"24 - 1150",284,287,282,2,3,0.992957746478873
2024-01-16,"24 - 1153",420,420,420,0,0,1
2024-01-17,"62 - 1011",116,116,111,5,0,0.956896551724138
2024-01-17,"3 - 1008",348,354,343,5,6,0.985632183908046
2024-01-17,"16 - 1022",59,60,57,2,1,0.966101694915254
2024-01-17,"24 - 1150",285,287,283,2,2,0.992982456140351
2024-01-17,"24 - 1153",420,420,420,0,0,1
2024-01-18,"62 - 1011",116,116,111,5,0,0.956896551724138
2024-01-18,"3 - 1008",349,354,347,2,5,0.994269340974212
2024-01-18,"16 - 1022",59,60,59,0,1,1
2024-01-18,"24 - 1150",284,287,282,2,3,0.992957746478873
2024-01-18,"24 - 1153",420,420,420,0,0,1
2024-01-19,"62 - 1011",116,116,111,5,0,0.956896551724138
2024-01-19,"3 - 1008",349,354,347,2,5,0.994269340974212
2024-01-19,"16 - 1022",59,60,59,0,1,1
2024-01-19,"24 - 1150",284,287,284,0,3,1
2024-01-19,"24 - 1153",420,420,420,0,0,1
2024-01-20,"62 - 1011",116,116,111,5,0,0.956896551724138
2024-01-20,"3 - 1008",349,354,348,1,5,0.997134670487106
2024-01-20,"16 - 1022",59,60,59,0,1,1
2024-01-20,"24 - 1150",284,287,284,0,3,1
2024-01-20,"24 - 1153",419,420,418,1,1,0.997613365155131
2024-01-21,"62 - 1011",116,116,110,6,0,0.948275862068966
2024-01-21,"3 - 1008",349,354,349,0,5,1
2024-01-21,"16 - 1022",59,60,59,0,1,1
2024-01-21,"24 - 1150",284,287,284,0,3,1
2024-01-21,"24 - 1153",420,420,420,0,0,1
2024-01-22,"62 - 1011",116,116,111,5,0,0.956896551724138
2024-01-22,"3 - 1008",349,354,348,1,5,0.997134670487106
2024-01-22,"16 - 1022",59,60,56,3,1,0.949152542372881
2024-01-22,"24 - 1150",283,287,283,0,4,1
2024-01-22,"24 - 1153",420,420,420,0,0,1
2024-01-23,"62 - 1011",116,116,112,4,0,0.96551724137931
2024-01-23,"3 - 1008",350,354,350,0,4,1
2024-01-23,"16 - 1022",59,60,57,2,1,0.966101694915254
2024-01-23,"24 - 1150",284,287,283,1,3,0.996478873239437
2024-01-23,"24 - 1153",420,420,420,0,0,1
2024-01-24,"62 - 1011",116,116,111,5,0,0.956896551724138
2024-01-24,"3 - 1008",350,354,349,1,4,0.997142857142857
2024-01-24,"16 - 1022",59,60,59,0,1,1
2024-01-24,"24 - 1150",283,287,283,0,4,1
2024-01-24,"24 - 1153",420,420,420,0,0,1
2024-01-25,"62 - 1011",116,116,110,6,0,0.948275862068966
2024-01-25,"3 - 1008",351,354,351,0,3,1
2024-01-25,"16 - 1022",59,60,59,0,1,1
2024-01-25,"24 - 1150",284,287,284,0,3,1
2024-01-25,"24 - 1153",420,420,419,1,0,0.997619047619048
2024-01-26,"62 - 1011",116,116,111,5,0,0.956896551724138
2024-01-26,"3 - 1008",350,354,350,0,4,1
2024-01-26,"16 - 1022",59,60,59,0,1,1
2024-01-26,"24 - 1150",283,287,283,0,4,1
2024-01-26,"24 - 1153",420,420,420,0,0,1
2024-01-27,"62 - 1011",116,116,110,6,0,0.948275862068966
2024-01-27,"3 - 1008",352,354,352,0,2,1
2024-01-27,"16 - 1022",59,60,58,1,1,0.983050847457627
2024-01-27,"24 - 1150",281,287,281,0,6,1
2024-01-27,"24 - 1153",420,420,420,0,0,1
2024-01-28,"62 - 1011",116,116,110,6,0,0.948275862068966
2024-01-28,"3 - 1008",352,354,352,0,2,1
2024-01-28,"16 - 1022",59,60,58,1,1,0.983050847457627
2024-01-28,"24 - 1150",284,287,284,0,3,1
2024-01-28,"24 - 1153",420,420,420,0,0,1
2024-01-29,"62 - 1011",116,116,110,6,0,0.948275862068966
2024-01-29,"3 - 1008",351,354,349,2,3,0.994301994301994
2024-01-29,"16 - 1022",59,60,58,1,1,0.983050847457627
2024-01-29,"24 - 1150",284,287,284,0,3,1
2024-01-29,"24 - 1153",420,420,420,0,0,1
2024-01-30,"62 - 1011",116,116,108,8,0,0.931034482758621
2024-01-30,"3 - 1008",347,354,346,1,7,0.997118155619596
2024-01-30,"16 - 1022",60,60,59,1,0,0.983333333333333
2024-01-30,"24 - 1150",285,287,285,0,2,1
2024-01-30,"24 - 1153",419,420,419,0,1,1
2024-01-31,"62 - 1011",116,116,109,7,0,0.939655172413793
2024-01-31,"3 - 1008",347,354,346,1,7,0.997118155619596
2024-01-31,"16 - 1022",60,60,58,2,0,0.966666666666667
2024-01-31,"24 - 1150",281,287,281,0,6,1
2024-01-31,"24 - 1153",420,420,420,0,0,1
2024-02-01,"62 - 1011",116,116,109,7,0,0.939655172413793
2024-02-01,"3 - 1008",347,354,344,3,7,0.99135446685879
2024-02-01,"16 - 1022",60,60,58,2,0,0.966666666666667
2024-02-01,"24 - 1150",281,287,280,1,6,0.99644128113879
2024-02-01,"24 - 1153",417,420,416,1,3,0.997601918465228
2024-02-02,"62 - 1011",116,116,109,7,0,0.939655172413793
2024-02-02,"3 - 1008",343,354,339,4,11,0.988338192419825
2024-02-02,"16 - 1022",60,60,57,3,0,0.95
2024-02-02,"24 - 1150",278,287,276,2,9,0.992805755395683
2024-02-02,"24 - 1153",414,420,414,0,6,1
2024-02-03,"62 - 1011",116,116,109,7,0,0.939655172413793
2024-02-03,"3 - 1008",343,354,341,2,11,0.994169096209913
2024-02-03,"16 - 1022",60,60,57,3,0,0.95
2024-02-03,"24 - 1150",283,287,278,5,4,0.982332155477032
2024-02-03,"24 - 1153",413,420,413,0,7,1
2024-02-04,"62 - 1011",116,116,109,7,0,0.939655172413793
2024-02-04,"3 - 1008",343,354,341,2,11,0.994169096209913
2024-02-04,"16 - 1022",60,60,57,3,0,0.95
2024-02-04,"24 - 1150",285,287,283,2,2,0.992982456140351
2024-02-04,"24 - 1153",411,414,411,0,3,1
2024-02-05,"62 - 1011",116,116,110,6,0,0.948275862068966
2024-02-05,"3 - 1008",347,354,346,1,7,0.997118155619596
2024-02-05,"16 - 1022",60,60,58,2,0,0.966666666666667
2024-02-05,"24 - 1150",285,287,285,0,2,1
2024-02-05,"24 - 1153",420,420,420,0,0,1
2024-02-06,"62 - 1011",116,116,111,5,0,0.956896551724138
2024-02-06,"3 - 1008",348,354,346,2,6,0.994252873563218
2024-02-06,"16 - 1022",60,60,59,1,0,0.983333333333333
2024-02-06,"24 - 1150",283,287,283,0,4,1
2024-02-06,"24 - 1153",419,420,419,0,1,1
2024-02-07,"62 - 1011",116,116,114,2,0,0.982758620689655
2024-02-07,"3 - 1008",346,354,345,1,8,0.997109826589595
2024-02-07,"16 - 1022",60,60,57,3,0,0.95
2024-02-07,"24 - 1150",285,287,283,2,2,0.992982456140351
2024-02-07,"24 - 1153",419,420,419,0,1,1
2024-02-08,"62 - 1011",116,116,111,5,0,0.956896551724138
2024-02-08,"3 - 1008",347,354,344,3,7,0.99135446685879
2024-02-08,"16 - 1022",60,60,58,2,0,0.966666666666667
2024-02-08,"24 - 1150",284,287,284,0,3,1
2024-02-08,"24 - 1153",417,420,417,0,3,1
2024-02-09,"62 - 1011",116,116,111,5,0,0.956896551724138
2024-02-09,"3 - 1008",347,354,344,3,7,0.99135446685879
2024-02-09,"16 - 1022",60,60,60,0,0,1
2024-02-09,"24 - 1150",283,287,283,0,4,1
2024-02-09,"24 - 1153",416,420,416,0,4,1
2024-02-10,"62 - 1011",116,116,109,7,0,0.939655172413793
2024-02-10,"3 - 1008",347,354,345,2,7,0.994236311239193
2024-02-10,"16 - 1022",60,60,58,2,0,0.966666666666667
2024-02-10,"24 - 1150",285,287,283,2,2,0.992982456140351
2024-02-10,"24 - 1153",416,420,416,0,4,1
2024-02-11,"62 - 1011",116,116,109,7,0,0.939655172413793
2024-02-11,"3 - 1008",347,354,345,2,7,0.994236311239193
2024-02-11,"16 - 1022",60,60,58,2,0,0.966666666666667
2024-02-11,"24 - 1150",285,287,285,0,2,1
2024-02-11,"24 - 1153",416,420,416,0,4,1
2024-02-12,"62 - 1011",116,116,109,7,0,0.939655172413793
2024-02-12,"3 - 1008",346,354,344,2,8,0.994219653179191
2024-02-12,"16 - 1022",60,60,57,3,0,0.95
2024-02-12,"24 - 1150",284,287,284,0,3,1
2024-02-12,"24 - 1153",413,420,413,0,7,1
2024-02-13,"62 - 1011",116,116,108,8,0,0.931034482758621
2024-02-13,"3 - 1008",346,354,345,1,8,0.997109826589595
2024-02-13,"16 - 1022",60,60,58,2,0,0.966666666666667
2024-02-13,"24 - 1150",284,287,283,1,3,0.996478873239437
2024-02-13,"24 - 1153",410,410,410,0,0,1
2024-02-14,"62 - 1011",116,116,107,9,0,0.922413793103448
2024-02-14,"3 - 1008",347,354,346,1,7,0.997118155619596
2024-02-14,"16 - 1022",60,60,58,2,0,0.966666666666667
2024-02-14,"24 - 1150",281,287,281,0,6,1
2024-02-14,"24 - 1153",419,420,419,0,1,1
2024-02-15,"62 - 1011",116,116,107,9,0,0.922413793103448
2024-02-15,"3 - 1008",348,354,347,1,6,0.997126436781609
2024-02-15,"16 - 1022",60,60,58,2,0,0.966666666666667
2024-02-15,"24 - 1150",281,287,281,0,6,1
2024-02-15,"24 - 1153",420,420,420,0,0,1
2024-02-16,"62 - 1011",116,116,107,9,0,0.922413793103448
2024-02-16,"3 - 1008",348,354,345,3,6,0.991379310344828
2024-02-16,"16 - 1022",60,60,58,2,0,0.966666666666667
2024-02-16,"24 - 1150",282,287,281,1,5,0.99645390070922
2024-02-16,"24 - 1153",420,420,420,0,0,1
2024-02-17,"62 - 1011",116,116,108,8,0,0.931034482758621
2024-02-17,"3 - 1008",349,354,347,2,5,0.994269340974212
2024-02-17,"16 - 1022",60,60,58,2,0,0.966666666666667
2024-02-17,"24 - 1150",281,287,281,0,6,1
2024-02-17,"24 - 1153",419,420,419,0,1,1
2024-02-18,"62 - 1011",116,116,108,8,0,0.931034482758621
2024-02-18,"3 - 1008",349,354,347,2,5,0.994269340974212
2024-02-18,"16 - 1022",60,60,57,3,0,0.95
2024-02-18,"24 - 1150",282,287,282,0,5,1
2024-02-18,"24 - 1153",420,420,420,0,0,1
2024-02-19,"62 - 1011",116,116,111,5,0,0.956896551724138
2024-02-19,"3 - 1008",349,354,345,4,5,0.988538681948424
2024-02-19,"16 - 1022",60,60,57,3,0,0.95
2024-02-19,"24 - 1150",282,287,281,1,5,0.99645390070922
2024-02-19,"24 - 1153",420,420,420,0,0,1
2024-02-20,"62 - 1011",116,116,112,4,0,0.96551724137931
2024-02-20,"3 - 1008",349,354,348,1,5,0.997134670487106
2024-02-20,"16 - 1022",60,60,56,4,0,0.933333333333333
2024-02-20,"24 - 1150",280,287,280,0,7,1
2024-02-20,"24 - 1153",420,420,420,0,0,1
2024-02-21,"62 - 1011",116,116,111,5,0,0.956896551724138
2024-02-21,"3 - 1008",349,354,348,1,5,0.997134670487106
2024-02-21,"16 - 1022",60,60,57,3,0,0.95
2024-02-21,"24 - 1150",281,287,281,0,6,1
2024-02-21,"24 - 1153",420,420,420,0,0,1
2024-02-22,"62 - 1011",116,116,109,7,0,0.939655172413793
2024-02-22,"3 - 1008",350,354,349,1,4,0.997142857142857
2024-02-22,"16 - 1022",60,60,58,2,0,0.966666666666667
2024-02-22,"24 - 1150",282,287,281,1,5,0.99645390070922
2024-02-22,"24 - 1153",420,420,420,0,0,1
2024-02-23,"62 - 1011",116,116,108,8,0,0.931034482758621
2024-02-23,"3 - 1008",350,354,349,1,4,0.997142857142857
2024-02-23,"16 - 1022",60,60,59,1,0,0.983333333333333
2024-02-23,"24 - 1150",282,287,281,1,5,0.99645390070922
2024-02-23,"24 - 1153",420,420,420,0,0,1
2024-02-24,"62 - 1011",116,116,108,8,0,0.931034482758621
2024-02-24,"3 - 1008",350,354,348,2,4,0.994285714285714
2024-02-24,"16 - 1022",60,60,58,2,0,0.966666666666667
2024-02-24,"24 - 1150",282,287,282,0,5,1
2024-02-24,"24 - 1153",420,420,420,0,0,1
2024-02-25,"62 - 1011",116,116,108,8,0,0.931034482758621
2024-02-25,"3 - 1008",348,354,347,1,6,0.997126436781609
2024-02-25,"16 - 1022",60,60,58,2,0,0.966666666666667
2024-02-25,"24 - 1150",281,287,281,0,6,1
2024-02-25,"24 - 1153",420,420,420,0,0,1
2024-02-26,"62 - 1011",116,116,108,8,0,0.931034482758621
2024-02-26,"3 - 1008",349,354,348,1,5,0.997134670487106
2024-02-26,"16 - 1022",60,60,59,1,0,0.983333333333333
2024-02-26,"24 - 1150",281,287,281,0,6,1
2024-02-26,"24 - 1153",420,420,420,0,0,1
2024-02-27,"62 - 1011",116,116,108,8,0,0.931034482758621
2024-02-27,"3 - 1008",349,354,346,3,5,0.991404011461318
2024-02-27,"16 - 1022",60,60,60,0,0,1
2024-02-27,"24 - 1150",282,287,282,0,5,1
2024-02-27,"24 - 1153",420,420,420,0,0,1
2024-02-28,"62 - 1011",116,116,107,9,0,0.922413793103448
2024-02-28,"3 - 1008",349,354,346,3,5,0.991404011461318
2024-02-28,"16 - 1022",60,60,59,1,0,0.983333333333333
2024-02-28,"24 - 1150",283,287,283,0,4,1
2024-02-28,"24 - 1153",420,420,420,0,0,1
2024-02-29,"62 - 1011",116,116,108,8,0,0.931034482758621
2024-02-29,"3 - 1008",349,354,348,1,5,0.997134670487106
2024-02-29,"16 - 1022",60,60,59,1,0,0.983333333333333
2024-02-29,"24 - 1150",284,287,284,0,3,1
2024-02-29,"24 - 1153",420,420,420,0,0,1
2024-03-01,"62 - 1011",116,116,108,8,0,0.931034482758621
2024-03-01,"3 - 1008",349,354,348,1,5,0.997134670487106
2024-03-01,"16 - 1022",60,60,59,1,0,0.983333333333333
2024-03-01,"24 - 1150",282,287,282,0,5,1
2024-03-01,"24 - 1153",418,420,417,1,2,0.997607655502392
2024-03-02,"62 - 1011",116,116,108,8,0,0.931034482758621
2024-03-02,"3 - 1008",349,354,348,1,5,0.997134670487106
2024-03-02,"16 - 1022",60,60,58,2,0,0.966666666666667
2024-03-02,"24 - 1150",284,287,284,0,3,1
2024-03-02,"24 - 1153",418,420,418,0,2,1
2024-03-03,"62 - 1011",116,116,109,7,0,0.939655172413793
2024-03-03,"3 - 1008",351,354,350,1,3,0.997150997150997
2024-03-03,"16 - 1022",60,60,58,2,0,0.966666666666667
2024-03-03,"24 - 1150",284,287,284,0,3,1
2024-03-03,"24 - 1153",418,420,418,0,2,1
2024-03-04,"62 - 1011",116,116,110,6,0,0.948275862068966
2024-03-04,"3 - 1008",352,354,350,2,2,0.994318181818182
2024-03-04,"16 - 1022",60,60,58,2,0,0.966666666666667
2024-03-04,"24 - 1150",284,287,284,0,3,1
2024-03-04,"24 - 1153",418,420,417,1,2,0.997607655502392
2024-03-05,"62 - 1011",116,116,110,6,0,0.948275862068966
2024-03-05,"3 - 1008",350,354,349,1,4,0.997142857142857
2024-03-05,"16 - 1022",68,81,64,4,13,0.941176470588235
2024-03-05,"24 - 1150",284,287,284,0,3,1
2024-03-05,"24 - 1153",417,420,417,0,3,1
2024-03-06,"62 - 1011",116,116,111,5,0,0.956896551724138
2024-03-06,"3 - 1008",349,354,348,1,5,0.997134670487106
2024-03-06,"16 - 1022",76,81,71,5,5,0.934210526315789
2024-03-06,"24 - 1150",284,287,284,0,3,1
2024-03-06,"24 - 1153",420,420,420,0,0,1
2024-03-07,"62 - 1011",116,116,112,4,0,0.96551724137931
2024-03-07,"3 - 1008",347,354,342,5,7,0.985590778097983
2024-03-07,"16 - 1022",81,81,76,5,0,0.938271604938272
2024-03-07,"24 - 1150",284,287,282,2,3,0.992957746478873
2024-03-07,"24 - 1153",420,420,420,0,0,1
2024-03-08,"62 - 1011",116,116,114,2,0,0.982758620689655
2024-03-08,"3 - 1008",347,354,344,3,7,0.99135446685879
2024-03-08,"16 - 1022",81,81,77,4,0,0.950617283950617
2024-03-08,"24 - 1150",282,287,282,0,5,1
2024-03-08,"24 - 1153",420,420,420,0,0,1
2024-03-09,"62 - 1011",116,116,114,2,0,0.982758620689655
2024-03-09,"3 - 1008",347,354,345,2,7,0.994236311239193
2024-03-09,"16 - 1022",81,81,76,5,0,0.938271604938272
2024-03-09,"24 - 1150",280,287,280,0,7,1
2024-03-09,"24 - 1153",420,420,420,0,0,1
2024-03-10,"62 - 1011",116,116,114,2,0,0.982758620689655
2024-03-10,"3 - 1008",347,354,345,2,7,0.994236311239193
2024-03-10,"16 - 1022",81,81,75,6,0,0.925925925925926
2024-03-10,"24 - 1150",280,287,279,1,7,0.996428571428571
2024-03-10,"24 - 1153",420,420,420,0,0,1
2024-03-11,"62 - 1011",116,116,115,1,0,0.991379310344828
2024-03-11,"3 - 1008",350,354,345,5,4,0.985714285714286
2024-03-11,"16 - 1022",81,81,74,7,0,0.91358024691358
2024-03-11,"24 - 1150",279,287,279,0,8,1
2024-03-11,"24 - 1153",420,420,420,0,0,1
2024-03-12,"62 - 1011",116,116,115,1,0,0.991379310344828
2024-03-12,"3 - 1008",350,354,346,4,4,0.988571428571429
2024-03-12,"16 - 1022",81,81,75,6,0,0.925925925925926
2024-03-12,"24 - 1150",279,287,279,0,8,1
2024-03-12,"24 - 1153",420,420,420,0,0,1
2024-03-13,"62 - 1011",116,116,116,0,0,1
2024-03-13,"3 - 1008",349,354,346,3,5,0.991404011461318
2024-03-13,"16 - 1022",81,81,76,5,0,0.938271604938272
2024-03-13,"24 - 1150",279,287,278,1,8,0.996415770609319
2024-03-13,"24 - 1153",418,420,418,0,2,1
2024-03-14,"62 - 1011",116,116,115,1,0,0.991379310344828
2024-03-14,"3 - 1008",349,354,344,5,5,0.98567335243553
2024-03-14,"16 - 1022",81,81,76,5,0,0.938271604938272
2024-03-14,"24 - 1150",284,287,282,2,3,0.992957746478873
2024-03-14,"24 - 1153",418,420,418,0,2,1
2024-03-15,"62 - 1011",116,116,116,0,0,1
2024-03-15,"3 - 1008",349,354,344,5,5,0.98567335243553
2024-03-15,"16 - 1022",81,81,78,3,0,0.962962962962963
2024-03-15,"24 - 1150",284,287,284,0,3,1
2024-03-15,"24 - 1153",418,420,418,0,2,1
2024-03-16,"62 - 1011",116,116,116,0,0,1
2024-03-16,"3 - 1008",349,354,343,6,5,0.982808022922636
2024-03-16,"16 - 1022",81,81,78,3,0,0.962962962962963
2024-03-16,"24 - 1150",284,287,284,0,3,1
2024-03-16,"24 - 1153",418,420,418,0,2,1
2024-03-17,"62 - 1011",116,116,116,0,0,1
2024-03-17,"3 - 1008",349,354,341,8,5,0.977077363896848
2024-03-17,"16 - 1022",81,81,78,3,0,0.962962962962963
2024-03-17,"24 - 1150",284,287,284,0,3,1
2024-03-17,"24 - 1153",417,420,417,0,3,1
2024-03-18,"62 - 1011",116,116,116,0,0,1
2024-03-18,"3 - 1008",351,354,343,8,3,0.977207977207977
2024-03-18,"16 - 1022",81,81,76,5,0,0.938271604938272
2024-03-18,"24 - 1150",284,287,284,0,3,1
2024-03-18,"24 - 1153",419,420,419,0,1,1
2024-03-19,"62 - 1011",116,116,116,0,0,1
2024-03-19,"3 - 1008",349,354,346,3,5,0.991404011461318
2024-03-19,"16 - 1022",81,81,78,3,0,0.962962962962963
2024-03-19,"24 - 1150",284,287,283,1,3,0.996478873239437
2024-03-19,"24 - 1153",420,420,420,0,0,1
2024-03-20,"62 - 1011",116,116,116,0,0,1
2024-03-20,"3 - 1008",349,354,346,3,5,0.991404011461318
2024-03-20,"16 - 1022",81,81,80,1,0,0.987654320987654
2024-03-20,"24 - 1150",284,287,284,0,3,1
2024-03-20,"24 - 1153",419,420,419,0,1,1
2024-03-21,"62 - 1011",116,116,116,0,0,1
2024-03-21,"3 - 1008",350,354,348,2,4,0.994285714285714
2024-03-21,"16 - 1022",81,81,79,2,0,0.975308641975309
2024-03-21,"24 - 1150",284,287,284,0,3,1
2024-03-21,"24 - 1153",418,420,418,0,2,1
2024-03-22,"62 - 1011",116,116,116,0,0,1
2024-03-22,"3 - 1008",350,354,348,2,4,0.994285714285714
2024-03-22,"16 - 1022",81,81,81,0,0,1
2024-03-22,"24 - 1150",283,287,282,1,4,0.996466431095406
2024-03-22,"24 - 1153",418,420,418,0,2,1
2024-03-23,"62 - 1011",116,116,116,0,0,1
2024-03-23,"3 - 1008",350,354,348,2,4,0.994285714285714
2024-03-23,"16 - 1022",81,81,81,0,0,1
2024-03-23,"24 - 1150",282,287,282,0,5,1
2024-03-23,"24 - 1153",420,420,420,0,0,1
2024-03-24,"62 - 1011",116,116,116,0,0,1
2024-03-24,"3 - 1008",349,354,347,2,5,0.994269340974212
2024-03-24,"16 - 1022",80,81,79,1,1,0.9875
2024-03-24,"24 - 1150",283,287,283,0,4,1
2024-03-24,"24 - 1153",420,420,420,0,0,1
2024-03-25,"62 - 1011",116,116,116,0,0,1
2024-03-25,"3 - 1008",348,354,345,3,6,0.991379310344828
2024-03-25,"16 - 1022",80,81,79,1,1,0.9875
2024-03-25,"24 - 1150",283,287,283,0,4,1
2024-03-25,"24 - 1153",420,420,420,0,0,1
2024-03-26,"62 - 1011",116,116,116,0,0,1
2024-03-26,"3 - 1008",347,354,342,5,7,0.985590778097983
2024-03-26,"16 - 1022",80,81,79,1,1,0.9875
2024-03-26,"24 - 1150",283,287,283,0,4,1
2024-03-26,"24 - 1153",420,420,420,0,0,1
2024-03-27,"62 - 1011",116,116,116,0,0,1
2024-03-27,"3 - 1008",347,354,343,4,7,0.988472622478386
2024-03-27,"16 - 1022",81,81,80,1,0,0.987654320987654
2024-03-27,"24 - 1150",283,287,282,1,4,0.996466431095406
2024-03-27,"24 - 1153",420,420,419,1,0,0.997619047619048
2024-03-28,"62 - 1011",116,116,116,0,0,1
2024-03-28,"3 - 1008",347,354,344,3,7,0.99135446685879
2024-03-28,"16 - 1022",81,81,80,1,0,0.987654320987654
2024-03-28,"24 - 1150",284,287,283,1,3,0.996478873239437
2024-03-28,"24 - 1153",420,420,420,0,0,1
2024-03-29,"62 - 1011",116,116,116,0,0,1
2024-03-29,"3 - 1008",347,354,343,4,7,0.988472622478386
2024-03-29,"16 - 1022",81,81,76,5,0,0.938271604938272
2024-03-29,"24 - 1150",284,287,284,0,3,1
2024-03-29,"24 - 1153",420,420,420,0,0,1
2024-03-30,"62 - 1011",116,116,115,1,0,0.991379310344828
2024-03-30,"3 - 1008",347,354,342,5,7,0.985590778097983
2024-03-30,"16 - 1022",81,81,76,5,0,0.938271604938272
2024-03-30,"24 - 1150",284,287,284,0,3,1
2024-03-30,"24 - 1153",420,420,420,0,0,1
2024-03-31,"62 - 1011",116,116,114,2,0,0.982758620689655
2024-03-31,"3 - 1008",347,354,343,4,7,0.988472622478386
2024-03-31,"16 - 1022",81,81,76,5,0,0.938271604938272
2024-03-31,"24 - 1150",284,287,284,0,3,1
2024-03-31,"24 - 1153",420,420,420,0,0,1
2024-04-01,"62 - 1011",116,116,115,1,0,0.991379310344828
2024-04-01,"3 - 1008",347,354,342,5,7,0.985590778097983
2024-04-01,"16 - 1022",81,81,78,3,0,0.962962962962963
2024-04-01,"24 - 1150",284,287,284,0,3,1
2024-04-01,"24 - 1153",419,420,419,0,1,1
2024-04-02,"62 - 1011",116,116,116,0,0,1
2024-04-02,"3 - 1008",347,354,343,4,7,0.988472622478386
2024-04-02,"16 - 1022",81,81,80,1,0,0.987654320987654
2024-04-02,"24 - 1150",282,287,282,0,5,1
2024-04-02,"24 - 1153",420,420,420,0,0,1
2024-04-03,"62 - 1011",116,116,113,3,0,0.974137931034483
2024-04-03,"3 - 1008",349,354,343,6,5,0.982808022922636
2024-04-03,"16 - 1022",81,81,80,1,0,0.987654320987654
2024-04-03,"24 - 1150",278,287,278,0,9,1
2024-04-03,"24 - 1153",420,420,420,0,0,1
2024-04-04,"62 - 1011",116,116,116,0,0,1
2024-04-04,"3 - 1008",349,354,343,6,5,0.982808022922636
2024-04-04,"16 - 1022",81,81,80,1,0,0.987654320987654
2024-04-04,"24 - 1150",278,287,278,0,9,1
2024-04-04,"24 - 1153",420,420,419,1,0,0.997619047619048
2024-04-05,"62 - 1011",116,116,116,0,0,1
2024-04-05,"3 - 1008",349,354,344,5,5,0.98567335243553
2024-04-05,"16 - 1022",81,81,80,1,0,0.987654320987654
2024-04-05,"24 - 1150",274,287,273,1,13,0.996350364963504
2024-04-05,"24 - 1153",419,420,419,0,1,1
2024-04-06,"62 - 1011",116,116,116,0,0,1
2024-04-06,"3 - 1008",349,354,344,5,5,0.98567335243553
2024-04-06,"16 - 1022",81,81,80,1,0,0.987654320987654
2024-04-06,"24 - 1150",273,287,273,0,14,1
2024-04-06,"24 - 1153",419,420,419,0,1,1
2024-04-07,"62 - 1011",116,116,116,0,0,1
2024-04-07,"3 - 1008",349,354,344,5,5,0.98567335243553
2024-04-07,"16 - 1022",81,81,80,1,0,0.987654320987654
2024-04-07,"24 - 1150",273,287,273,0,14,1
2024-04-07,"24 - 1153",419,420,419,0,1,1
2024-04-08,"62 - 1011",116,116,116,0,0,1
2024-04-08,"3 - 1008",348,354,342,6,6,0.982758620689655
2024-04-08,"16 - 1022",81,81,79,2,0,0.975308641975309
2024-04-08,"24 - 1150",267,287,267,0,20,1
2024-04-08,"24 - 1153",419,420,419,0,1,1
2024-04-09,"62 - 1011",116,116,116,0,0,1
2024-04-09,"3 - 1008",347,354,343,4,7,0.988472622478386
2024-04-09,"16 - 1022",81,81,80,1,0,0.987654320987654
2024-04-09,"24 - 1150",259,287,258,1,28,0.996138996138996
2024-04-09,"24 - 1153",419,420,419,0,1,1
2024-04-10,"62 - 1011",116,116,115,1,0,0.991379310344828
2024-04-10,"3 - 1008",347,354,341,6,7,0.982708933717579
2024-04-10,"16 - 1022",81,81,80,1,0,0.987654320987654
2024-04-10,"24 - 1150",248,287,248,0,39,1
2024-04-10,"24 - 1153",420,420,420,0,0,1
2024-04-11,"62 - 1011",116,116,116,0,0,1
2024-04-11,"3 - 1008",345,354,339,6,9,0.982608695652174
2024-04-11,"16 - 1022",81,81,80,1,0,0.987654320987654
2024-04-11,"24 - 1150",246,287,246,0,41,1
2024-04-11,"24 - 1153",419,420,419,0,1,1
2024-04-12,"62 - 1011",116,116,115,1,0,0.991379310344828
2024-04-12,"3 - 1008",344,354,338,6,10,0.982558139534884
2024-04-12,"16 - 1022",81,81,80,1,0,0.987654320987654
2024-04-12,"24 - 1150",253,287,253,0,34,1
2024-04-12,"24 - 1153",417,420,416,1,3,0.997601918465228
2024-04-13,"62 - 1011",116,116,115,1,0,0.991379310344828
2024-04-13,"3 - 1008",344,354,338,6,10,0.982558139534884
2024-04-13,"16 - 1022",81,81,80,1,0,0.987654320987654
2024-04-13,"24 - 1150",255,287,255,0,32,1
2024-04-13,"24 - 1153",417,420,417,0,3,1
2024-04-14,"62 - 1011",116,116,115,1,0,0.991379310344828
2024-04-14,"3 - 1008",344,354,338,6,10,0.982558139534884
2024-04-14,"16 - 1022",81,81,80,1,0,0.987654320987654
2024-04-14,"24 - 1150",254,287,254,0,33,1
2024-04-14,"24 - 1153",417,420,417,0,3,1
2024-04-15,"62 - 1011",116,116,116,0,0,1
2024-04-15,"3 - 1008",346,354,339,7,8,0.979768786127168
2024-04-15,"16 - 1022",81,81,79,2,0,0.975308641975309
2024-04-15,"24 - 1150",256,287,256,0,31,1
2024-04-15,"24 - 1153",419,420,419,0,1,1
2024-04-16,"62 - 1011",116,116,115,1,0,0.991379310344828
2024-04-16,"3 - 1008",346,354,341,5,8,0.985549132947977
2024-04-16,"16 - 1022",81,81,79,2,0,0.975308641975309
2024-04-16,"24 - 1150",255,287,255,0,32,1
2024-04-16,"24 - 1153",420,420,420,0,0,1
2024-04-17,"62 - 1011",116,116,115,1,0,0.991379310344828
2024-04-17,"3 - 1008",346,354,340,6,8,0.982658959537572
2024-04-17,"16 - 1022",81,81,78,3,0,0.962962962962963
2024-04-17,"24 - 1150",250,287,250,0,37,1
2024-04-17,"24 - 1153",419,420,418,1,1,0.997613365155131
2024-04-18,"62 - 1011",116,116,116,0,0,1
2024-04-18,"3 - 1008",347,354,342,5,7,0.985590778097983
2024-04-18,"16 - 1022",81,81,79,2,0,0.975308641975309
2024-04-18,"24 - 1150",249,287,249,0,38,1
2024-04-18,"24 - 1153",417,420,417,0,3,1
2024-04-19,"62 - 1011",116,116,116,0,0,1
2024-04-19,"3 - 1008",347,354,343,4,7,0.988472622478386
2024-04-19,"16 - 1022",81,81,80,1,0,0.987654320987654
2024-04-19,"24 - 1150",254,287,250,4,33,0.984251968503937
2024-04-19,"24 - 1153",415,420,415,0,5,1
2024-04-20,"62 - 1011",116,116,116,0,0,1
2024-04-20,"3 - 1008",348,354,344,4,6,0.988505747126437
2024-04-20,"16 - 1022",81,81,80,1,0,0.987654320987654
2024-04-20,"24 - 1150",252,287,252,0,35,1
2024-04-20,"24 - 1153",415,420,415,0,5,1
2024-04-21,"62 - 1011",116,116,116,0,0,1
2024-04-21,"3 - 1008",350,354,347,3,4,0.991428571428571
2024-04-21,"16 - 1022",81,81,80,1,0,0.987654320987654
2024-04-21,"24 - 1150",252,287,252,0,35,1
2024-04-21,"24 - 1153",415,420,415,0,5,1
2024-04-22,"62 - 1011",116,116,116,0,0,1
2024-04-22,"3 - 1008",351,354,347,4,3,0.988603988603989
2024-04-22,"16 - 1022",81,81,80,1,0,0.987654320987654
2024-04-22,"24 - 1150",258,287,256,2,29,0.992248062015504
2024-04-22,"24 - 1153",412,416,412,0,4,1
2024-04-23,"62 - 1011",116,116,116,0,0,1
2024-04-23,"3 - 1008",350,354,348,2,4,0.994285714285714
2024-04-23,"16 - 1022",81,81,79,2,0,0.975308641975309
2024-04-23,"24 - 1150",260,287,255,5,27,0.980769230769231
2024-04-23,"24 - 1153",412,416,412,0,4,1
2024-04-24,"62 - 1011",116,116,116,0,0,1
2024-04-24,"3 - 1008",351,354,348,3,3,0.991452991452991
2024-04-24,"16 - 1022",81,81,79,2,0,0.975308641975309
2024-04-24,"24 - 1150",261,287,261,0,26,1
2024-04-24,"24 - 1153",415,420,415,0,5,1
2024-04-25,"62 - 1011",116,116,116,0,0,1
2024-04-25,"3 - 1008",347,354,345,2,7,0.994236311239193
2024-04-25,"16 - 1022",81,81,80,1,0,0.987654320987654
2024-04-25,"24 - 1150",263,287,259,4,24,0.984790874524715
2024-04-25,"24 - 1153",417,420,417,0,3,1
2024-04-26,"62 - 1011",116,116,116,0,0,1
2024-04-26,"3 - 1008",346,354,343,3,8,0.991329479768786
2024-04-26,"16 - 1022",81,81,80,1,0,0.987654320987654
2024-04-26,"24 - 1150",268,287,267,1,19,0.996268656716418
2024-04-26,"24 - 1153",417,420,417,0,3,1
2024-04-27,"62 - 1011",116,116,115,1,0,0.991379310344828
2024-04-27,"3 - 1008",346,354,340,6,8,0.982658959537572
2024-04-27,"16 - 1022",81,81,80,1,0,0.987654320987654
2024-04-27,"24 - 1150",267,287,267,0,20,1
2024-04-27,"24 - 1153",417,420,417,0,3,1
2024-04-28,"62 - 1011",116,116,116,0,0,1
2024-04-28,"3 - 1008",346,354,339,7,8,0.979768786127168
2024-04-28,"16 - 1022",81,81,78,3,0,0.962962962962963
2024-04-28,"24 - 1150",267,287,265,2,20,0.99250936329588
2024-04-28,"24 - 1153",417,420,417,0,3,1
2024-04-29,"62 - 1011",116,116,116,0,0,1
2024-04-29,"3 - 1008",341,354,335,6,13,0.982404692082111
2024-04-29,"16 - 1022",81,81,81,0,0,1
2024-04-29,"24 - 1150",272,287,271,1,15,0.996323529411765
2024-04-29,"24 - 1153",416,420,416,0,4,1
2024-04-30,"62 - 1011",116,116,116,0,0,1
2024-04-30,"3 - 1008",338,354,333,5,16,0.985207100591716
2024-04-30,"16 - 1022",81,81,81,0,0,1
2024-04-30,"24 - 1150",275,287,275,0,12,1
2024-04-30,"24 - 1153",417,420,417,0,3,1
2024-05-01,"62 - 1011",116,116,116,0,0,1
2024-05-01,"3 - 1008",336,354,330,6,18,0.982142857142857
2024-05-01,"16 - 1022",81,81,80,1,0,0.987654320987654
2024-05-01,"24 - 1150",276,287,276,0,11,1
2024-05-01,"24 - 1153",417,420,417,0,3,1
2024-05-02,"62 - 1011",116,116,115,1,0,0.991379310344828
2024-05-02,"3 - 1008",335,354,330,5,19,0.985074626865672
2024-05-02,"16 - 1022",81,81,80,1,0,0.987654320987654
2024-05-02,"24 - 1150",276,287,276,0,11,1
2024-05-02,"24 - 1153",417,420,417,0,3,1
2024-05-03,"62 - 1011",116,116,116,0,0,1
2024-05-03,"3 - 1008",332,354,328,4,22,0.987951807228916
2024-05-03,"16 - 1022",81,81,80,1,0,0.987654320987654
2024-05-03,"24 - 1150",276,287,276,0,11,1
2024-05-03,"24 - 1153",418,420,418,0,2,1
2024-05-04,"62 - 1011",116,116,116,0,0,1
2024-05-04,"3 - 1008",332,354,328,4,22,0.987951807228916
2024-05-04,"16 - 1022",81,81,80,1,0,0.987654320987654
2024-05-04,"24 - 1150",274,287,273,1,13,0.996350364963504
2024-05-04,"24 - 1153",418,420,418,0,2,1
2024-05-05,"62 - 1011",116,116,116,0,0,1
2024-05-05,"3 - 1008",332,354,328,4,22,0.987951807228916
2024-05-05,"16 - 1022",81,81,80,1,0,0.987654320987654
2024-05-05,"24 - 1150",277,287,277,0,10,1
2024-05-05,"24 - 1153",418,420,418,0,2,1
2024-05-06,"62 - 1011",116,116,116,0,0,1
2024-05-06,"3 - 1008",331,354,328,3,23,0.990936555891239
2024-05-06,"16 - 1022",81,81,78,3,0,0.962962962962963
2024-05-06,"24 - 1150",277,287,275,2,10,0.992779783393502
2024-05-06,"24 - 1153",417,420,417,0,3,1
2024-05-07,"62 - 1011",116,116,116,0,0,1
2024-05-07,"3 - 1008",328,354,325,3,26,0.990853658536585
2024-05-07,"16 - 1022",81,81,78,3,0,0.962962962962963
2024-05-07,"24 - 1150",276,287,276,0,11,1
2024-05-07,"24 - 1153",415,420,415,0,5,1
2024-05-08,"62 - 1011",116,116,113,3,0,0.974137931034483
2024-05-08,"3 - 1008",328,354,325,3,26,0.990853658536585
2024-05-08,"16 - 1022",81,81,79,2,0,0.975308641975309
2024-05-08,"24 - 1150",276,287,276,0,11,1
2024-05-08,"24 - 1153",414,420,414,0,6,1
2024-05-09,"62 - 1011",116,116,115,1,0,0.991379310344828
2024-05-09,"3 - 1008",328,354,325,3,26,0.990853658536585
2024-05-09,"16 - 1022",81,81,78,3,0,0.962962962962963
2024-05-09,"24 - 1150",275,287,272,3,12,0.989090909090909
2024-05-09,"24 - 1153",415,420,415,0,5,1
2024-05-10,"62 - 1011",116,116,116,0,0,1
2024-05-10,"3 - 1008",327,354,324,3,27,0.990825688073395
2024-05-10,"16 - 1022",81,81,78,3,0,0.962962962962963
2024-05-10,"24 - 1150",278,287,278,0,9,1
2024-05-10,"24 - 1153",415,420,415,0,5,1
2024-05-11,"62 - 1011",116,116,116,0,0,1
2024-05-11,"3 - 1008",327,354,324,3,27,0.990825688073395
2024-05-11,"16 - 1022",81,81,78,3,0,0.962962962962963
2024-05-11,"24 - 1150",280,287,280,0,7,1
2024-05-11,"24 - 1153",415,420,415,0,5,1
2024-05-12,"62 - 1011",116,116,116,0,0,1
2024-05-12,"3 - 1008",327,354,323,4,27,0.987767584097859
2024-05-12,"16 - 1022",81,81,78,3,0,0.962962962962963
2024-05-12,"24 - 1150",280,287,280,0,7,1
2024-05-12,"24 - 1153",415,420,415,0,5,1
2024-05-13,"62 - 1011",116,116,116,0,0,1
2024-05-13,"3 - 1008",325,354,321,4,29,0.987692307692308
2024-05-13,"16 - 1022",81,81,78,3,0,0.962962962962963
2024-05-13,"24 - 1150",284,287,283,1,3,0.996478873239437
2024-05-13,"24 - 1153",413,416,413,0,3,1
2024-05-14,"62 - 1011",116,116,116,0,0,1
2024-05-14,"3 - 1008",324,354,320,4,30,0.987654320987654
2024-05-14,"16 - 1022",81,81,76,5,0,0.938271604938272
2024-05-14,"24 - 1150",283,287,283,0,4,1
2024-05-14,"24 - 1153",414,416,414,0,2,1
2024-05-15,"62 - 1011",116,116,116,0,0,1
2024-05-15,"3 - 1008",323,354,319,4,31,0.987616099071207
2024-05-15,"16 - 1022",81,81,78,3,0,0.962962962962963
2024-05-15,"24 - 1150",284,287,284,0,3,1
2024-05-15,"24 - 1153",412,416,412,0,4,1
2024-05-16,"62 - 1011",116,116,116,0,0,1
2024-05-16,"3 - 1008",323,354,320,3,31,0.990712074303406
2024-05-16,"16 - 1022",81,81,78,3,0,0.962962962962963
2024-05-16,"24 - 1150",283,287,283,0,4,1
2024-05-16,"24 - 1153",412,416,412,0,4,1
2024-05-17,"62 - 1011",116,116,116,0,0,1
2024-05-17,"3 - 1008",321,354,317,4,33,0.987538940809969
2024-05-17,"16 - 1022",81,81,78,3,0,0.962962962962963
2024-05-17,"24 - 1150",283,287,283,0,4,1
2024-05-17,"24 - 1153",413,420,413,0,7,1
2024-05-18,"62 - 1011",116,116,116,0,0,1
2024-05-18,"3 - 1008",321,354,317,4,33,0.987538940809969
2024-05-18,"16 - 1022",81,81,79,2,0,0.975308641975309
2024-05-18,"24 - 1150",283,287,283,0,4,1
2024-05-18,"24 - 1153",412,416,412,0,4,1
2024-05-19,"62 - 1011",116,116,116,0,0,1
2024-05-19,"3 - 1008",321,354,316,5,33,0.984423676012461
2024-05-19,"16 - 1022",81,81,79,2,0,0.975308641975309
2024-05-19,"24 - 1150",283,287,283,0,4,1
2024-05-19,"24 - 1153",411,416,411,0,5,1
2024-05-20,"62 - 1011",116,116,115,1,0,0.991379310344828
2024-05-20,"3 - 1008",320,354,316,4,34,0.9875
2024-05-20,"16 - 1022",81,81,79,2,0,0.975308641975309
2024-05-20,"24 - 1150",283,287,283,0,4,1
2024-05-20,"24 - 1153",410,416,410,0,6,1
2024-05-21,"62 - 1011",116,116,113,3,0,0.974137931034483
2024-05-21,"3 - 1008",317,333,313,4,16,0.987381703470032
2024-05-21,"16 - 1022",81,81,81,0,0,1
2024-05-21,"24 - 1150",284,287,284,0,3,1
2024-05-21,"24 - 1153",410,416,410,0,6,1
2024-05-22,"62 - 1011",116,116,113,3,0,0.974137931034483
2024-05-22,"3 - 1008",316,333,313,3,17,0.990506329113924
2024-05-22,"16 - 1022",81,81,81,0,0,1
2024-05-22,"24 - 1150",284,287,283,1,3,0.996478873239437
2024-05-22,"24 - 1153",410,416,410,0,6,1
2024-05-23,"62 - 1011",116,116,116,0,0,1
2024-05-23,"3 - 1008",316,333,313,3,17,0.990506329113924
2024-05-23,"16 - 1022",81,81,78,3,0,0.962962962962963
2024-05-23,"24 - 1150",284,287,284,0,3,1
2024-05-23,"24 - 1153",417,420,417,0,3,1
2024-05-24,"62 - 1011",116,116,114,2,0,0.982758620689655
2024-05-24,"3 - 1008",316,333,312,4,17,0.987341772151899
2024-05-24,"16 - 1022",81,81,80,1,0,0.987654320987654
2024-05-24,"24 - 1150",284,287,284,0,3,1
2024-05-24,"24 - 1153",417,420,417,0,3,1
2024-05-25,"62 - 1011",116,116,114,2,0,0.982758620689655
2024-05-25,"3 - 1008",315,333,313,2,18,0.993650793650794
2024-05-25,"16 - 1022",81,81,80,1,0,0.987654320987654
2024-05-25,"24 - 1150",279,287,279,0,8,1
2024-05-25,"24 - 1153",417,420,417,0,3,1
2024-05-26,"62 - 1011",116,116,114,2,0,0.982758620689655
2024-05-26,"3 - 1008",315,333,313,2,18,0.993650793650794
2024-05-26,"16 - 1022",81,81,80,1,0,0.987654320987654
2024-05-26,"24 - 1150",279,287,279,0,8,1
2024-05-26,"24 - 1153",417,420,414,3,3,0.992805755395683
2024-05-27,"62 - 1011",116,116,116,0,0,1
2024-05-27,"3 - 1008",316,333,313,3,17,0.990506329113924
2024-05-27,"16 - 1022",81,81,80,1,0,0.987654320987654
2024-05-27,"24 - 1150",276,287,276,0,11,1
2024-05-27,"24 - 1153",417,420,417,0,3,1
2024-05-28,"62 - 1011",116,116,116,0,0,1
2024-05-28,"3 - 1008",315,333,312,3,18,0.990476190476191
2024-05-28,"16 - 1022",81,81,80,1,0,0.987654320987654
2024-05-28,"24 - 1150",274,287,274,0,13,1
2024-05-28,"24 - 1153",416,420,416,0,4,1
2024-05-29,"62 - 1011",116,116,116,0,0,1
2024-05-29,"3 - 1008",315,333,312,3,18,0.990476190476191
2024-05-29,"16 - 1022",81,81,79,2,0,0.975308641975309
2024-05-29,"24 - 1150",267,287,267,0,20,1
2024-05-29,"24 - 1153",416,420,416,0,4,1
2024-05-30,"62 - 1011",116,116,116,0,0,1
2024-05-30,"3 - 1008",313,333,311,2,20,0.993610223642173
2024-05-30,"16 - 1022",81,81,80,1,0,0.987654320987654
2024-05-30,"24 - 1150",262,287,262,0,25,1
2024-05-30,"24 - 1153",416,420,416,0,4,1
2024-05-31,"62 - 1011",116,116,116,0,0,1
2024-05-31,"3 - 1008",312,333,307,5,21,0.983974358974359
2024-05-31,"16 - 1022",81,81,80,1,0,0.987654320987654
2024-05-31,"24 - 1150",262,287,262,0,25,1
2024-05-31,"24 - 1153",414,420,414,0,6,1
2024-06-01,"62 - 1011",116,116,116,0,0,1
2024-06-01,"3 - 1008",311,333,308,3,22,0.990353697749196
2024-06-01,"16 - 1022",81,81,80,1,0,0.987654320987654
2024-06-01,"24 - 1150",260,287,260,0,27,1
2024-06-01,"24 - 1153",414,420,414,0,6,1
2024-06-02,"62 - 1011",115,116,115,0,1,1
2024-06-02,"3 - 1008",311,333,307,4,22,0.987138263665595
2024-06-02,"16 - 1022",81,81,80,1,0,0.987654320987654
2024-06-02,"24 - 1150",257,287,257,0,30,1
2024-06-02,"24 - 1153",414,420,414,0,6,1
2024-06-03,"62 - 1011",115,116,115,0,1,1
2024-06-03,"3 - 1008",310,333,305,5,23,0.983870967741935
2024-06-03,"16 - 1022",81,81,79,2,0,0.975308641975309
2024-06-03,"24 - 1150",256,287,256,0,31,1
2024-06-03,"24 - 1153",414,420,414,0,6,1
2024-06-04,"62 - 1011",115,116,115,0,1,1
2024-06-04,"3 - 1008",306,333,300,6,27,0.980392156862745
2024-06-04,"16 - 1022",81,81,78,3,0,0.962962962962963
2024-06-04,"24 - 1150",259,287,259,0,28,1
2024-06-04,"24 - 1153",412,420,412,0,8,1
2024-06-05,"62 - 1011",115,116,115,0,1,1
2024-06-05,"3 - 1008",303,333,301,2,30,0.993399339933993
2024-06-05,"16 - 1022",81,81,78,3,0,0.962962962962963
2024-06-05,"24 - 1150",260,287,260,0,27,1
2024-06-05,"24 - 1153",412,420,412,0,8,1
2024-06-06,"62 - 1011",115,116,115,0,1,1
2024-06-06,"3 - 1008",302,333,300,2,31,0.993377483443709
2024-06-06,"16 - 1022",81,81,80,1,0,0.987654320987654
2024-06-06,"24 - 1150",260,287,260,0,27,1
2024-06-06,"24 - 1153",411,414,411,0,3,1
2024-06-07,"62 - 1011",115,116,115,0,1,1
2024-06-07,"3 - 1008",301,333,299,2,32,0.993355481727575
2024-06-07,"16 - 1022",81,81,80,1,0,0.987654320987654
2024-06-07,"24 - 1150",257,287,257,0,30,1
2024-06-07,"24 - 1153",411,414,411,0,3,1
2024-06-08,"62 - 1011",115,116,115,0,1,1
2024-06-08,"3 - 1008",301,333,298,3,32,0.990033222591362
2024-06-08,"16 - 1022",81,81,80,1,0,0.987654320987654
2024-06-08,"24 - 1150",256,287,256,0,31,1
2024-06-08,"24 - 1153",411,414,411,0,3,1
2024-06-09,"62 - 1011",115,116,115,0,1,1
2024-06-09,"3 - 1008",300,333,298,2,33,0.993333333333333
2024-06-09,"16 - 1022",81,81,79,2,0,0.975308641975309
2024-06-09,"24 - 1150",255,287,255,0,32,1
2024-06-09,"24 - 1153",411,414,411,0,3,1
2024-06-10,"62 - 1011",115,116,115,0,1,1
2024-06-10,"3 - 1008",300,333,298,2,33,0.993333333333333
2024-06-10,"16 - 1022",80,81,78,2,1,0.975
2024-06-10,"24 - 1150",258,287,258,0,29,1
2024-06-10,"24 - 1153",411,414,411,0,3,1
2024-06-11,"62 - 1011",115,116,115,0,1,1
2024-06-11,"3 - 1008",300,333,297,3,33,0.99
2024-06-11,"16 - 1022",80,81,78,2,1,0.975
2024-06-11,"24 - 1150",259,287,259,0,28,1
2024-06-11,"24 - 1153",419,420,418,1,1,0.997613365155131
2024-06-12,"62 - 1011",116,116,116,0,0,1
2024-06-12,"3 - 1008",299,333,297,2,34,0.993311036789298
2024-06-12,"16 - 1022",80,81,78,2,1,0.975
2024-06-12,"24 - 1150",259,287,259,0,28,1
2024-06-12,"24 - 1153",419,420,419,0,1,1
2024-06-13,"62 - 1011",116,116,115,1,0,0.991379310344828
2024-06-13,"3 - 1008",296,333,296,0,37,1
2024-06-13,"16 - 1022",80,81,78,2,1,0.975
2024-06-13,"24 - 1150",260,287,260,0,27,1
2024-06-13,"24 - 1153",419,420,419,0,1,1
2024-06-14,"62 - 1011",116,116,116,0,0,1
2024-06-14,"3 - 1008",295,333,295,0,38,1
2024-06-14,"16 - 1022",80,81,78,2,1,0.975
2024-06-14,"24 - 1150",261,287,261,0,26,1
2024-06-14,"24 - 1153",417,420,417,0,3,1
2024-06-15,"62 - 1011",116,116,116,0,0,1
2024-06-15,"3 - 1008",295,333,295,0,38,1
2024-06-15,"16 - 1022",80,81,78,2,1,0.975
2024-06-15,"24 - 1150",260,287,260,0,27,1
2024-06-15,"24 - 1153",418,420,417,1,2,0.997607655502392
2024-06-16,"62 - 1011",116,116,116,0,0,1
2024-06-16,"3 - 1008",295,333,295,0,38,1
2024-06-16,"16 - 1022",80,81,78,2,1,0.975
2024-06-16,"24 - 1150",260,287,260,0,27,1
2024-06-16,"24 - 1153",417,420,417,0,3,1
2024-06-17,"62 - 1011",116,116,115,1,0,0.991379310344828
2024-06-17,"3 - 1008",295,333,295,0,38,1
2024-06-17,"16 - 1022",80,81,78,2,1,0.975
2024-06-17,"24 - 1150",259,287,259,0,28,1
2024-06-17,"24 - 1153",417,420,417,0,3,1
2024-06-18,"62 - 1011",116,116,116,0,0,1
2024-06-18,"3 - 1008",295,333,295,0,38,1
2024-06-18,"16 - 1022",81,81,78,3,0,0.962962962962963
2024-06-18,"24 - 1150",259,287,259,0,28,1
2024-06-18,"24 - 1153",417,420,417,0,3,1
2024-06-19,"62 - 1011",116,116,115,1,0,0.991379310344828
2024-06-19,"3 - 1008",295,333,295,0,38,1
2024-06-19,"16 - 1022",81,81,79,2,0,0.975308641975309
2024-06-19,"24 - 1150",259,287,259,0,28,1
2024-06-19,"24 - 1153",420,420,420,0,0,1
2024-06-20,"62 - 1011",116,116,115,1,0,0.991379310344828
2024-06-20,"3 - 1008",295,333,293,2,38,0.993220338983051
2024-06-20,"16 - 1022",81,81,80,1,0,0.987654320987654
2024-06-20,"24 - 1150",256,287,256,0,31,1
2024-06-20,"24 - 1153",420,420,420,0,0,1
2024-06-21,"62 - 1011",116,116,115,1,0,0.991379310344828
2024-06-21,"3 - 1008",294,333,294,0,39,1
2024-06-21,"16 - 1022",81,81,80,1,0,0.987654320987654
2024-06-21,"24 - 1150",257,287,257,0,30,1
2024-06-21,"24 - 1153",420,420,419,1,0,0.997619047619048
2024-06-22,"62 - 1011",116,116,116,0,0,1
2024-06-22,"3 - 1008",294,333,294,0,39,1
2024-06-22,"16 - 1022",81,81,80,1,0,0.987654320987654
2024-06-22,"24 - 1150",259,287,259,0,28,1
2024-06-22,"24 - 1153",419,420,419,0,1,1
2024-06-23,"62 - 1011",116,116,116,0,0,1
2024-06-23,"3 - 1008",294,333,294,0,39,1
2024-06-23,"16 - 1022",81,81,79,2,0,0.975308641975309
2024-06-23,"24 - 1150",256,287,256,0,31,1
2024-06-23,"24 - 1153",418,420,418,0,2,1
2024-06-24,"62 - 1011",116,116,116,0,0,1
2024-06-24,"3 - 1008",294,333,293,1,39,0.996598639455782
2024-06-24,"16 - 1022",81,81,79,2,0,0.975308641975309
2024-06-24,"24 - 1150",254,287,254,0,33,1
2024-06-24,"24 - 1153",418,420,418,0,2,1
2024-06-25,"62 - 1011",116,116,116,0,0,1
2024-06-25,"3 - 1008",294,333,293,1,39,0.996598639455782
2024-06-25,"16 - 1022",81,81,79,2,0,0.975308641975309
2024-06-25,"24 - 1150",251,287,251,0,36,1
2024-06-25,"24 - 1153",418,420,418,0,2,1
2024-06-26,"62 - 1011",116,116,116,0,0,1
2024-06-26,"3 - 1008",291,333,291,0,42,1
2024-06-26,"16 - 1022",81,81,79,2,0,0.975308641975309
2024-06-26,"24 - 1150",250,287,249,1,37,0.996
2024-06-26,"24 - 1153",419,420,419,0,1,1
2024-06-27,"62 - 1011",116,116,115,1,0,0.991379310344828
2024-06-27,"3 - 1008",291,333,291,0,42,1
2024-06-27,"16 - 1022",81,81,80,1,0,0.987654320987654
2024-06-27,"24 - 1150",249,287,249,0,38,1
2024-06-27,"24 - 1153",420,420,419,1,0,0.997619047619048
2024-06-28,"62 - 1011",116,116,116,0,0,1
2024-06-28,"3 - 1008",292,333,290,2,41,0.993150684931507
2024-06-28,"16 - 1022",81,81,79,2,0,0.975308641975309
2024-06-28,"24 - 1150",247,287,247,0,40,1
2024-06-28,"24 - 1153",420,420,419,1,0,0.997619047619048
2024-06-29,"62 - 1011",116,116,116,0,0,1
2024-06-29,"3 - 1008",289,333,289,0,44,1
2024-06-29,"16 - 1022",81,81,79,2,0,0.975308641975309
2024-06-29,"24 - 1150",247,287,247,0,40,1
2024-06-29,"24 - 1153",420,420,420,0,0,1
2024-06-30,"62 - 1011",116,116,115,1,0,0.991379310344828
2024-06-30,"3 - 1008",288,333,287,1,45,0.996527777777778
2024-06-30,"16 - 1022",81,81,79,2,0,0.975308641975309
2024-06-30,"24 - 1150",246,287,246,0,41,1
2024-06-30,"24 - 1153",420,420,420,0,0,1
2024-07-01,"62 - 1011",116,116,116,0,0,1
2024-07-01,"3 - 1008",288,333,288,0,45,1
2024-07-01,"16 - 1022",81,81,79,2,0,0.975308641975309
2024-07-01,"24 - 1150",245,287,245,0,42,1
2024-07-01,"24 - 1153",419,420,419,0,1,1
2024-07-02,"62 - 1011",116,116,116,0,0,1
2024-07-02,"3 - 1008",287,333,285,2,46,0.993031358885017
2024-07-02,"16 - 1022",81,81,79,2,0,0.975308641975309
2024-07-02,"24 - 1150",246,287,246,0,41,1
2024-07-02,"24 - 1153",420,420,420,0,0,1
2024-07-03,"62 - 1011",116,116,115,1,0,0.991379310344828
2024-07-03,"3 - 1008",287,333,284,3,46,0.989547038327526
2024-07-03,"16 - 1022",81,81,80,1,0,0.987654320987654
2024-07-03,"24 - 1150",247,287,247,0,40,1
2024-07-03,"24 - 1153",420,420,418,2,0,0.995238095238095
2024-07-04,"62 - 1011",116,116,115,1,0,0.991379310344828
2024-07-04,"3 - 1008",285,333,282,3,48,0.989473684210526
2024-07-04,"16 - 1022",81,81,81,0,0,1
2024-07-04,"24 - 1150",245,287,245,0,42,1
2024-07-04,"24 - 1153",419,420,416,3,1,0.992840095465394
2024-07-05,"62 - 1011",116,116,115,1,0,0.991379310344828
2024-07-05,"3 - 1008",280,333,278,2,53,0.992857142857143
2024-07-05,"16 - 1022",81,81,80,1,0,0.987654320987654
2024-07-05,"24 - 1150",252,287,245,7,35,0.972222222222222
2024-07-05,"24 - 1153",418,420,418,0,2,1
2024-07-06,"62 - 1011",116,116,116,0,0,1
2024-07-06,"3 - 1008",279,333,277,2,54,0.992831541218638
2024-07-06,"16 - 1022",81,81,79,2,0,0.975308641975309
2024-07-06,"24 - 1150",253,287,249,4,34,0.984189723320158
2024-07-06,"24 - 1153",419,420,419,0,1,1
2024-07-07,"62 - 1011",116,116,116,0,0,1
2024-07-07,"3 - 1008",279,333,277,2,54,0.992831541218638
2024-07-07,"16 - 1022",81,81,79,2,0,0.975308641975309
2024-07-07,"24 - 1150",253,287,247,6,34,0.976284584980237
2024-07-07,"24 - 1153",419,420,419,0,1,1
2024-07-08,"62 - 1011",116,116,116,0,0,1
2024-07-08,"3 - 1008",279,333,276,3,54,0.989247311827957
2024-07-08,"16 - 1022",81,81,80,1,0,0.987654320987654
2024-07-08,"24 - 1150",254,287,252,2,33,0.992125984251969
2024-07-08,"24 - 1153",419,420,419,0,1,1
2024-07-09,"62 - 1011",116,116,116,0,0,1
2024-07-09,"3 - 1008",277,333,275,2,56,0.992779783393502
2024-07-09,"16 - 1022",81,81,81,0,0,1
2024-07-09,"24 - 1150",258,287,252,6,29,0.976744186046512
2024-07-09,"24 - 1153",417,420,417,0,3,1
2024-07-10,"62 - 1011",116,116,116,0,0,1
2024-07-10,"3 - 1008",276,333,276,0,57,1
2024-07-10,"16 - 1022",81,81,81,0,0,1
2024-07-10,"24 - 1150",257,287,253,4,30,0.98443579766537
2024-07-10,"24 - 1153",419,420,417,2,1,0.995226730310263
2024-07-11,"62 - 1011",116,116,116,0,0,1
2024-07-11,"3 - 1008",276,333,276,0,57,1
2024-07-11,"16 - 1022",81,81,81,0,0,1
2024-07-11,"24 - 1150",263,287,250,13,24,0.950570342205323
2024-07-11,"24 - 1153",419,420,419,0,1,1
2024-07-12,"62 - 1011",116,116,116,0,0,1
2024-07-12,"3 - 1008",276,333,276,0,57,1
2024-07-12,"16 - 1022",81,81,81,0,0,1
2024-07-12,"24 - 1150",259,287,249,10,28,0.961389961389961
2024-07-12,"24 - 1153",419,420,419,0,1,1
2024-07-13,"62 - 1011",116,116,116,0,0,1
2024-07-13,"3 - 1008",276,333,276,0,57,1
2024-07-13,"16 - 1022",81,81,81,0,0,1
2024-07-13,"24 - 1150",248,287,248,0,39,1
2024-07-13,"24 - 1153",419,420,419,0,1,1
2024-07-14,"62 - 1011",116,116,116,0,0,1
2024-07-14,"3 - 1008",276,333,276,0,57,1
2024-07-14,"16 - 1022",81,81,81,0,0,1
2024-07-14,"24 - 1150",244,287,244,0,43,1
2024-07-14,"24 - 1153",418,420,418,0,2,1
2024-07-15,"62 - 1011",116,116,116,0,0,1
2024-07-15,"3 - 1008",276,333,276,0,57,1
2024-07-15,"16 - 1022",81,81,81,0,0,1
2024-07-15,"24 - 1150",253,287,247,6,34,0.976284584980237
2024-07-15,"24 - 1153",418,420,418,0,2,1
2024-07-16,"62 - 1011",116,116,115,1,0,0.991379310344828
2024-07-16,"3 - 1008",275,333,275,0,58,1
2024-07-16,"16 - 1022",81,81,81,0,0,1
2024-07-16,"24 - 1150",255,287,249,6,32,0.976470588235294
2024-07-16,"24 - 1153",418,420,418,0,2,1
2024-07-17,"62 - 1011",116,116,116,0,0,1
2024-07-17,"3 - 1008",275,333,274,1,58,0.996363636363636
2024-07-17,"16 - 1022",81,81,80,1,0,0.987654320987654
2024-07-17,"24 - 1150",260,287,254,6,27,0.976923076923077
2024-07-17,"24 - 1153",419,420,419,0,1,1
2024-07-18,"62 - 1011",116,116,116,0,0,1
2024-07-18,"3 - 1008",275,333,275,0,58,1
2024-07-18,"16 - 1022",81,81,81,0,0,1
2024-07-18,"24 - 1150",262,287,260,2,25,0.99236641221374
2024-07-18,"24 - 1153",419,420,419,0,1,1
2024-07-19,"62 - 1011",116,116,116,0,0,1
2024-07-19,"3 - 1008",275,333,275,0,58,1
2024-07-19,"16 - 1022",81,81,81,0,0,1
2024-07-19,"24 - 1150",260,287,257,3,27,0.988461538461539
2024-07-19,"24 - 1153",419,420,419,0,1,1
2024-07-20,"62 - 1011",116,116,116,0,0,1
2024-07-20,"3 - 1008",275,333,275,0,58,1
2024-07-20,"16 - 1022",81,81,80,1,0,0.987654320987654
2024-07-20,"24 - 1150",259,287,259,0,28,1
2024-07-20,"24 - 1153",419,420,419,0,1,1
2024-07-21,"62 - 1011",116,116,116,0,0,1
2024-07-21,"3 - 1008",275,333,274,1,58,0.996363636363636
2024-07-21,"16 - 1022",81,81,80,1,0,0.987654320987654
2024-07-21,"24 - 1150",258,287,258,0,29,1
2024-07-21,"24 - 1153",419,420,419,0,1,1
2024-07-22,"62 - 1011",116,116,116,0,0,1
2024-07-22,"3 - 1008",276,333,274,2,57,0.992753623188406
2024-07-22,"16 - 1022",80,81,80,0,1,1
2024-07-22,"24 - 1150",268,287,260,8,19,0.970149253731343
2024-07-22,"24 - 1153",419,420,419,0,1,1
2024-07-23,"62 - 1011",116,116,116,0,0,1
2024-07-23,"3 - 1008",276,333,276,0,57,1
2024-07-23,"16 - 1022",81,81,80,1,0,0.987654320987654
2024-07-23,"24 - 1150",270,287,259,11,17,0.959259259259259
2024-07-23,"24 - 1153",419,420,419,0,1,1
2024-07-24,"62 - 1011",116,116,116,0,0,1
2024-07-24,"3 - 1008",276,333,275,1,57,0.996376811594203
2024-07-24,"16 - 1022",81,81,80,1,0,0.987654320987654
2024-07-24,"24 - 1150",265,287,263,2,22,0.992452830188679
2024-07-24,"24 - 1153",419,420,419,0,1,1
2024-07-25,"62 - 1011",116,116,116,0,0,1
2024-07-25,"3 - 1008",276,333,275,1,57,0.996376811594203
2024-07-25,"16 - 1022",81,81,80,1,0,0.987654320987654
2024-07-25,"24 - 1150",266,287,266,0,21,1
2024-07-25,"24 - 1153",419,420,419,0,1,1
2024-07-26,"62 - 1011",116,116,116,0,0,1
2024-07-26,"3 - 1008",275,333,274,1,58,0.996363636363636
2024-07-26,"16 - 1022",81,81,81,0,0,1
2024-07-26,"24 - 1150",259,287,258,1,28,0.996138996138996
2024-07-26,"24 - 1153",417,420,417,0,3,1
2024-07-27,"62 - 1011",116,116,116,0,0,1
2024-07-27,"3 - 1008",276,333,275,1,57,0.996376811594203
2024-07-27,"16 - 1022",81,81,80,1,0,0.987654320987654
2024-07-27,"24 - 1150",270,287,260,10,17,0.962962962962963
2024-07-27,"24 - 1153",417,420,417,0,3,1
2024-07-28,"62 - 1011",116,116,116,0,0,1
2024-07-28,"3 - 1008",276,333,275,1,57,0.996376811594203
2024-07-28,"16 - 1022",81,81,80,1,0,0.987654320987654
2024-07-28,"24 - 1150",267,287,265,2,20,0.99250936329588
2024-07-28,"24 - 1153",417,420,417,0,3,1
2024-07-29,"62 - 1011",116,116,116,0,0,1
2024-07-29,"3 - 1008",276,333,274,2,57,0.992753623188406
2024-07-29,"16 - 1022",81,81,81,0,0,1
2024-07-29,"24 - 1150",263,287,263,0,24,1
2024-07-29,"24 - 1153",418,420,418,0,2,1
2024-07-30,"62 - 1011",116,116,116,0,0,1
2024-07-30,"3 - 1008",274,333,273,1,59,0.996350364963504
2024-07-30,"16 - 1022",81,81,81,0,0,1
2024-07-30,"24 - 1150",263,287,263,0,24,1
2024-07-30,"24 - 1153",418,420,418,0,2,1
2024-07-31,"62 - 1011",116,116,116,0,0,1
2024-07-31,"3 - 1008",273,333,272,1,60,0.996336996336996
2024-07-31,"16 - 1022",80,81,79,1,1,0.9875
2024-07-31,"24 - 1150",262,287,262,0,25,1
2024-07-31,"24 - 1153",418,420,418,0,2,1
2024-08-01,"62 - 1011",116,116,116,0,0,1
2024-08-01,"3 - 1008",272,333,271,1,61,0.996323529411765
2024-08-01,"16 - 1022",81,81,76,5,0,0.938271604938272
2024-08-01,"24 - 1150",252,287,250,2,35,0.992063492063492
2024-08-01,"24 - 1153",419,420,419,0,1,1
2024-08-02,"62 - 1011",116,116,116,0,0,1
2024-08-02,"3 - 1008",269,333,268,1,64,0.996282527881041
2024-08-02,"16 - 1022",81,81,75,6,0,0.925925925925926
2024-08-02,"24 - 1150",245,287,245,0,42,1
2024-08-02,"24 - 1153",418,420,418,0,2,1
2024-08-03,"62 - 1011",116,116,116,0,0,1
2024-08-03,"3 - 1008",269,333,269,0,64,1
2024-08-03,"16 - 1022",81,81,74,7,0,0.91358024691358
2024-08-03,"24 - 1150",243,287,243,0,44,1
2024-08-03,"24 - 1153",418,420,418,0,2,1
2024-08-04,"62 - 1011",116,116,116,0,0,1
2024-08-04,"3 - 1008",270,333,270,0,63,1
2024-08-04,"16 - 1022",81,81,74,7,0,0.91358024691358
2024-08-04,"24 - 1150",243,287,243,0,44,1
2024-08-04,"24 - 1153",417,420,417,0,3,1
2024-08-05,"62 - 1011",116,116,116,0,0,1
2024-08-05,"3 - 1008",269,333,269,0,64,1
2024-08-05,"16 - 1022",81,81,74,7,0,0.91358024691358
2024-08-05,"24 - 1150",241,287,241,0,46,1
2024-08-05,"24 - 1153",417,420,417,0,3,1
2024-08-06,"62 - 1011",116,116,115,1,0,0.991379310344828
2024-08-06,"3 - 1008",269,333,269,0,64,1
2024-08-06,"16 - 1022",81,81,78,3,0,0.962962962962963
2024-08-06,"24 - 1150",244,287,244,0,43,1
2024-08-06,"24 - 1153",418,420,418,0,2,1
2024-08-07,"62 - 1011",116,116,115,1,0,0.991379310344828
2024-08-07,"3 - 1008",268,333,267,1,65,0.996268656716418
2024-08-07,"16 - 1022",81,81,79,2,0,0.975308641975309
2024-08-07,"24 - 1150",251,287,247,4,36,0.98406374501992
2024-08-07,"24 - 1153",418,420,418,0,2,1
2024-08-08,"62 - 1011",116,116,116,0,0,1
2024-08-08,"3 - 1008",266,333,266,0,67,1
2024-08-08,"16 - 1022",81,81,79,2,0,0.975308641975309
2024-08-08,"24 - 1150",254,287,253,1,33,0.996062992125984
2024-08-08,"24 - 1153",416,420,416,0,4,1
2024-08-09,"62 - 1011",116,116,116,0,0,1
2024-08-09,"3 - 1008",264,333,264,0,69,1
2024-08-09,"16 - 1022",81,81,79,2,0,0.975308641975309
2024-08-09,"24 - 1150",253,287,254,-1,34,1.00395256916996
2024-08-09,"24 - 1153",419,420,417,2,1,0.995226730310263
2024-08-10,"62 - 1011",116,116,116,0,0,1
2024-08-10,"3 - 1008",264,333,263,1,69,0.996212121212121
2024-08-10,"16 - 1022",81,81,78,3,0,0.962962962962963
2024-08-10,"24 - 1150",253,287,254,-1,34,1.00395256916996
2024-08-10,"24 - 1153",419,420,419,0,1,1
2024-08-11,"62 - 1011",116,116,116,0,0,1
2024-08-11,"3 - 1008",265,333,264,1,68,0.99622641509434
2024-08-11,"16 - 1022",81,81,78,3,0,0.962962962962963
2024-08-11,"24 - 1150",252,287,253,-1,35,1.00396825396825
2024-08-11,"24 - 1153",419,420,419,0,1,1
2024-08-12,"62 - 1011",116,116,115,1,0,0.991379310344828
2024-08-12,"3 - 1008",264,333,264,0,69,1
2024-08-12,"16 - 1022",81,81,79,2,0,0.975308641975309
2024-08-12,"24 - 1150",255,287,252,3,32,0.988235294117647
2024-08-12,"24 - 1153",418,420,418,0,2,1
2024-08-13,"62 - 1011",116,116,116,0,0,1
2024-08-13,"3 - 1008",264,333,264,0,69,1
2024-08-13,"16 - 1022",81,81,79,2,0,0.975308641975309
2024-08-13,"24 - 1150",265,287,256,9,22,0.966037735849057
2024-08-13,"24 - 1153",418,420,418,0,2,1
2024-08-14,"62 - 1011",116,116,116,0,0,1
2024-08-14,"3 - 1008",263,333,261,2,70,0.992395437262357
2024-08-14,"16 - 1022",81,81,79,2,0,0.975308641975309
2024-08-14,"24 - 1150",270,287,262,8,17,0.97037037037037
2024-08-14,"24 - 1153",418,420,417,1,2,0.997607655502392
2024-08-15,"62 - 1011",116,116,116,0,0,1
2024-08-15,"3 - 1008",262,333,260,2,71,0.99236641221374
2024-08-15,"16 - 1022",81,81,77,4,0,0.950617283950617
2024-08-15,"24 - 1150",263,287,263,0,24,1
2024-08-15,"24 - 1153",418,420,418,0,2,1
2024-08-16,"62 - 1011",116,116,116,0,0,1
2024-08-16,"3 - 1008",260,333,259,1,73,0.996153846153846
2024-08-16,"16 - 1022",81,81,79,2,0,0.975308641975309
2024-08-16,"24 - 1150",267,287,267,0,20,1
2024-08-16,"24 - 1153",418,420,418,0,2,1
2024-08-17,"62 - 1011",116,116,116,0,0,1
2024-08-17,"3 - 1008",259,333,258,1,74,0.996138996138996
2024-08-17,"16 - 1022",81,81,79,2,0,0.975308641975309
2024-08-17,"24 - 1150",264,287,264,0,23,1
2024-08-17,"24 - 1153",418,420,418,0,2,1
2024-08-18,"62 - 1011",116,116,116,0,0,1
2024-08-18,"3 - 1008",258,333,256,2,75,0.992248062015504
2024-08-18,"16 - 1022",81,81,79,2,0,0.975308641975309
2024-08-18,"24 - 1150",263,287,263,0,24,1
2024-08-18,"24 - 1153",418,420,418,0,2,1
2024-08-19,"62 - 1011",116,116,116,0,0,1
2024-08-19,"3 - 1008",258,333,256,2,75,0.992248062015504
2024-08-19,"16 - 1022",81,81,77,4,0,0.950617283950617
2024-08-19,"24 - 1150",265,287,265,0,22,1
2024-08-19,"24 - 1153",418,420,418,0,2,1
2024-08-20,"62 - 1011",116,116,116,0,0,1
2024-08-20,"3 - 1008",257,333,254,3,76,0.988326848249027
2024-08-20,"16 - 1022",81,81,79,2,0,0.975308641975309
2024-08-20,"24 - 1150",275,287,268,7,12,0.974545454545454
2024-08-20,"24 - 1153",418,420,418,0,2,1
2024-08-21,"62 - 1011",116,116,116,0,0,1
2024-08-21,"3 - 1008",256,333,254,2,77,0.9921875
2024-08-21,"16 - 1022",81,81,80,1,0,0.987654320987654
2024-08-21,"24 - 1150",275,287,265,10,12,0.963636363636364
2024-08-21,"24 - 1153",418,420,418,0,2,1
2024-08-22,"62 - 1011",116,116,116,0,0,1
2024-08-22,"3 - 1008",256,333,255,1,77,0.99609375
2024-08-22,"16 - 1022",81,81,79,2,0,0.975308641975309
2024-08-22,"24 - 1150",275,287,265,10,12,0.963636363636364
2024-08-22,"24 - 1153",417,420,417,0,3,1
2024-08-23,"62 - 1011",116,116,116,0,0,1
2024-08-23,"3 - 1008",255,333,255,0,78,1
2024-08-23,"16 - 1022",81,81,78,3,0,0.962962962962963
2024-08-23,"24 - 1150",274,287,266,8,13,0.970802919708029
2024-08-23,"24 - 1153",416,420,416,0,4,1
2024-08-24,"62 - 1011",116,116,115,1,0,0.991379310344828
2024-08-24,"3 - 1008",255,333,255,0,78,1
2024-08-24,"16 - 1022",81,81,78,3,0,0.962962962962963
2024-08-24,"24 - 1150",270,287,262,8,17,0.97037037037037
2024-08-24,"24 - 1153",416,420,416,0,4,1
2024-08-25,"62 - 1011",116,116,115,1,0,0.991379310344828
2024-08-25,"3 - 1008",255,333,255,0,78,1
2024-08-25,"16 - 1022",81,81,78,3,0,0.962962962962963
2024-08-25,"24 - 1150",269,287,267,2,18,0.992565055762082
2024-08-25,"24 - 1153",416,420,416,0,4,1
2024-08-26,"62 - 1011",116,116,116,0,0,1
2024-08-26,"3 - 1008",255,333,255,0,78,1
2024-08-26,"16 - 1022",81,81,78,3,0,0.962962962962963
2024-08-26,"24 - 1150",274,287,272,2,13,0.992700729927007
2024-08-26,"24 - 1153",415,420,415,0,5,1
2024-08-27,"62 - 1011",116,116,116,0,0,1
2024-08-27,"3 - 1008",254,333,253,1,79,0.996062992125984
2024-08-27,"16 - 1022",81,81,79,2,0,0.975308641975309
2024-08-27,"24 - 1150",276,287,275,1,11,0.996376811594203
2024-08-27,"24 - 1153",418,420,418,0,2,1
2024-08-28,"62 - 1011",116,116,116,0,0,1
2024-08-28,"3 - 1008",253,333,253,0,80,1
2024-08-28,"16 - 1022",81,81,79,2,0,0.975308641975309
2024-08-28,"24 - 1150",273,287,270,3,14,0.989010989010989
2024-08-28,"24 - 1153",416,420,416,0,4,1
2024-08-29,"62 - 1011",116,116,116,0,0,1
2024-08-29,"3 - 1008",253,333,253,0,80,1
2024-08-29,"16 - 1022",81,81,80,1,0,0.987654320987654
2024-08-29,"24 - 1150",271,287,271,0,16,1
2024-08-29,"24 - 1153",417,420,417,0,3,1
2024-08-30,"62 - 1011",116,116,116,0,0,1
2024-08-30,"3 - 1008",253,333,252,1,80,0.99604743083004
2024-08-30,"16 - 1022",81,81,80,1,0,0.987654320987654
2024-08-30,"24 - 1150",271,287,271,0,16,1
2024-08-30,"24 - 1153",417,420,417,0,3,1
2024-08-31,"62 - 1011",116,116,116,0,0,1
2024-08-31,"3 - 1008",251,333,251,0,82,1
2024-08-31,"16 - 1022",81,81,79,2,0,0.975308641975309
2024-08-31,"24 - 1150",268,287,268,0,19,1
2024-08-31,"24 - 1153",416,420,415,1,4,0.997596153846154
2024-09-01,"62 - 1011",116,116,116,0,0,1
2024-09-01,"3 - 1008",251,333,251,0,82,1
2024-09-01,"16 - 1022",81,81,79,2,0,0.975308641975309
2024-09-01,"24 - 1150",262,287,262,0,25,1
2024-09-01,"24 - 1153",415,420,415,0,5,1
2024-09-02,"62 - 1011",116,116,116,0,0,1
2024-09-02,"3 - 1008",251,333,250,1,82,0.99601593625498
2024-09-02,"16 - 1022",81,81,79,2,0,0.975308641975309
2024-09-02,"24 - 1150",261,287,261,0,26,1
2024-09-02,"24 - 1153",413,414,413,0,1,1
2024-09-03,"62 - 1011",116,116,116,0,0,1
2024-09-03,"3 - 1008",251,333,248,3,82,0.98804780876494
2024-09-03,"16 - 1022",81,81,79,2,0,0.975308641975309
2024-09-03,"24 - 1150",265,287,260,5,22,0.981132075471698
2024-09-03,"24 - 1153",411,414,411,0,3,1
2024-09-04,"62 - 1011",116,116,115,1,0,0.991379310344828
2024-09-04,"3 - 1008",251,333,245,6,82,0.97609561752988
2024-09-04,"16 - 1022",81,81,78,3,0,0.962962962962963
2024-09-04,"24 - 1150",265,287,265,0,22,1
2024-09-04,"24 - 1153",419,420,419,0,1,1
2024-09-05,"62 - 1011",116,116,115,1,0,0.991379310344828
2024-09-05,"3 - 1008",245,333,245,0,88,1
2024-09-05,"16 - 1022",81,81,80,1,0,0.987654320987654
2024-09-05,"24 - 1150",263,287,262,1,24,0.996197718631179
2024-09-05,"24 - 1153",418,420,418,0,2,1
2024-09-06,"62 - 1011",116,116,115,1,0,0.991379310344828
2024-09-06,"3 - 1008",245,333,245,0,88,1
2024-09-06,"16 - 1022",81,81,80,1,0,0.987654320987654
2024-09-06,"24 - 1150",263,287,262,1,24,0.996197718631179
2024-09-06,"24 - 1153",417,420,417,0,3,1
2024-09-07,"62 - 1011",116,116,116,0,0,1
2024-09-07,"3 - 1008",244,333,244,0,89,1
2024-09-07,"16 - 1022",81,81,79,2,0,0.975308641975309
2024-09-07,"24 - 1150",261,287,261,0,26,1
2024-09-07,"24 - 1153",414,420,414,0,6,1
2024-09-08,"62 - 1011",116,116,116,0,0,1
2024-09-08,"3 - 1008",244,333,244,0,89,1
2024-09-08,"16 - 1022",81,81,79,2,0,0.975308641975309
2024-09-08,"24 - 1150",255,287,255,0,32,1
2024-09-08,"24 - 1153",412,416,412,0,4,1
2024-09-09,"62 - 1011",116,116,116,0,0,1
2024-09-09,"3 - 1008",243,333,241,2,90,0.991769547325103
2024-09-09,"16 - 1022",81,81,80,1,0,0.987654320987654
2024-09-09,"24 - 1150",256,287,256,0,31,1
2024-09-09,"24 - 1153",411,416,411,0,5,1
2024-09-10,"62 - 1011",116,116,116,0,0,1
2024-09-10,"3 - 1008",242,333,241,1,91,0.995867768595041
2024-09-10,"16 - 1022",81,81,81,0,0,1
2024-09-10,"24 - 1150",260,287,259,1,27,0.996153846153846
2024-09-10,"24 - 1153",409,410,409,0,1,1
2024-09-11,"62 - 1011",116,116,115,1,0,0.991379310344828
2024-09-11,"3 - 1008",241,333,241,0,92,1
2024-09-11,"16 - 1022",81,81,81,0,0,1
2024-09-11,"24 - 1150",268,287,262,6,19,0.977611940298508
2024-09-11,"24 - 1153",415,420,415,0,5,1
2024-09-12,"62 - 1011",116,116,115,1,0,0.991379310344828
2024-09-12,"3 - 1008",241,333,241,0,92,1
2024-09-12,"16 - 1022",81,81,81,0,0,1
2024-09-12,"24 - 1150",269,287,266,3,18,0.988847583643123
2024-09-12,"24 - 1153",420,420,420,0,0,1
2024-09-13,"62 - 1011",116,116,115,1,0,0.991379310344828
2024-09-13,"3 - 1008",241,333,241,0,92,1
2024-09-13,"16 - 1022",81,81,80,1,0,0.987654320987654
2024-09-13,"24 - 1150",269,287,267,2,18,0.992565055762082
2024-09-13,"24 - 1153",420,420,420,0,0,1
2024-09-14,"62 - 1011",116,116,115,1,0,0.991379310344828
2024-09-14,"3 - 1008",241,333,241,0,92,1
2024-09-14,"16 - 1022",81,81,79,2,0,0.975308641975309
2024-09-14,"24 - 1150",269,287,269,0,18,1
2024-09-14,"24 - 1153",419,420,419,0,1,1
2024-09-15,"62 - 1011",116,116,116,0,0,1
2024-09-15,"3 - 1008",240,333,240,0,93,1
2024-09-15,"16 - 1022",81,81,79,2,0,0.975308641975309
2024-09-15,"24 - 1150",269,287,269,0,18,1
2024-09-15,"24 - 1153",419,420,419,0,1,1
2024-09-16,"62 - 1011",116,116,116,0,0,1
2024-09-16,"3 - 1008",240,333,239,1,93,0.995833333333333
2024-09-16,"16 - 1022",81,81,79,2,0,0.975308641975309
2024-09-16,"24 - 1150",268,287,268,0,19,1
2024-09-16,"24 - 1153",417,420,417,0,3,1
2024-09-17,"62 - 1011",116,116,115,1,0,0.991379310344828
2024-09-17,"3 - 1008",240,333,238,2,93,0.991666666666667
2024-09-17,"16 - 1022",81,81,80,1,0,0.987654320987654
2024-09-17,"24 - 1150",264,287,264,0,23,1
2024-09-17,"24 - 1153",415,420,415,0,5,1
2024-09-18,"62 - 1011",116,116,116,0,0,1
2024-09-18,"3 - 1008",240,333,238,2,93,0.991666666666667
2024-09-18,"16 - 1022",81,81,80,1,0,0.987654320987654
2024-09-18,"24 - 1150",264,287,264,0,23,1
2024-09-18,"24 - 1153",415,420,415,0,5,1
2024-09-19,"62 - 1011",116,116,116,0,0,1
2024-09-19,"3 - 1008",238,333,237,1,95,0.995798319327731
2024-09-19,"16 - 1022",81,81,81,0,0,1
2024-09-19,"24 - 1150",269,287,263,6,18,0.977695167286245
2024-09-19,"24 - 1153",418,420,418,0,2,1
2024-09-20,"62 - 1011",116,116,116,0,0,1
2024-09-20,"3 - 1008",237,333,237,0,96,1
2024-09-20,"16 - 1022",81,81,80,1,0,0.987654320987654
2024-09-20,"24 - 1150",268,287,263,5,19,0.98134328358209
2024-09-20,"24 - 1153",418,420,418,0,2,1
2024-09-21,"62 - 1011",116,116,116,0,0,1
2024-09-21,"3 - 1008",237,333,237,0,96,1
2024-09-21,"16 - 1022",81,81,80,1,0,0.987654320987654
2024-09-21,"24 - 1150",263,287,258,5,24,0.980988593155893
2024-09-21,"24 - 1153",417,420,417,0,3,1
2024-09-22,"62 - 1011",116,116,116,0,0,1
2024-09-22,"3 - 1008",237,333,237,0,96,1
2024-09-22,"16 - 1022",81,81,79,2,0,0.975308641975309
2024-09-22,"24 - 1150",262,287,260,2,25,0.99236641221374
2024-09-22,"24 - 1153",417,420,417,0,3,1
2024-09-23,"62 - 1011",116,116,116,0,0,1
2024-09-23,"3 - 1008",236,333,236,0,97,1
2024-09-23,"16 - 1022",81,81,81,0,0,1
2024-09-23,"24 - 1150",259,287,259,0,28,1
2024-09-23,"24 - 1153",416,420,416,0,4,1
2024-09-24,"62 - 1011",116,116,114,2,0,0.982758620689655
2024-09-24,"3 - 1008",236,333,236,0,97,1
2024-09-24,"16 - 1022",81,81,81,0,0,1
2024-09-24,"24 - 1150",270,287,264,6,17,0.977777777777778
2024-09-24,"24 - 1153",419,420,419,0,1,1
2024-09-25,"62 - 1011",116,116,115,1,0,0.991379310344828
2024-09-25,"3 - 1008",236,333,236,0,97,1
2024-09-25,"16 - 1022",81,81,81,0,0,1
2024-09-25,"24 - 1150",269,287,261,8,18,0.970260223048327
2024-09-25,"24 - 1153",419,420,419,0,1,1
2024-09-26,"62 - 1011",116,116,115,1,0,0.991379310344828
2024-09-26,"3 - 1008",236,333,236,0,97,1
2024-09-26,"16 - 1022",81,81,81,0,0,1
2024-09-26,"24 - 1150",269,287,263,6,18,0.977695167286245
2024-09-26,"24 - 1153",419,420,419,0,1,1
2024-09-27,"62 - 1011",116,116,116,0,0,1
2024-09-27,"3 - 1008",236,333,236,0,97,1
2024-09-27,"16 - 1022",81,81,81,0,0,1
2024-09-27,"24 - 1150",265,287,259,6,22,0.977358490566038
2024-09-27,"24 - 1153",419,420,419,0,1,1
2024-09-28,"62 - 1011",116,116,116,0,0,1
2024-09-28,"3 - 1008",236,333,236,0,97,1
2024-09-28,"16 - 1022",81,81,77,4,0,0.950617283950617
2024-09-28,"24 - 1150",262,287,258,4,25,0.984732824427481
2024-09-28,"24 - 1153",419,420,419,0,1,1
2024-09-29,"62 - 1011",116,116,116,0,0,1
2024-09-29,"3 - 1008",236,333,236,0,97,1
2024-09-29,"16 - 1022",81,81,77,4,0,0.950617283950617
2024-09-29,"24 - 1150",261,287,259,2,26,0.992337164750958
2024-09-29,"24 - 1153",419,420,419,0,1,1
2024-09-30,"62 - 1011",116,116,116,0,0,1
2024-09-30,"3 - 1008",236,333,236,0,97,1
2024-09-30,"16 - 1022",81,81,77,4,0,0.950617283950617
2024-09-30,"24 - 1150",268,287,258,10,19,0.962686567164179
2024-09-30,"24 - 1153",419,420,419,0,1,1
2024-10-01,"62 - 1011",116,116,116,0,0,1
2024-10-01,"3 - 1008",236,333,236,0,97,1
2024-10-01,"16 - 1022",81,81,79,2,0,0.975308641975309
2024-10-01,"24 - 1150",269,287,259,10,18,0.962825278810409
2024-10-01,"24 - 1153",419,420,419,0,1,1
2024-10-02,"62 - 1011",116,116,115,1,0,0.991379310344828
2024-10-02,"3 - 1008",235,333,235,0,98,1
2024-10-02,"16 - 1022",81,81,79,2,0,0.975308641975309
2024-10-02,"24 - 1150",271,287,269,2,16,0.992619926199262
2024-10-02,"24 - 1153",417,420,417,0,3,1
2024-10-03,"62 - 1011",116,116,115,1,0,0.991379310344828
2024-10-03,"3 - 1008",235,241,234,1,6,0.995744680851064
2024-10-03,"16 - 1022",81,81,80,1,0,0.987654320987654
2024-10-03,"24 - 1150",269,287,269,0,18,1
2024-10-03,"24 - 1153",418,420,418,0,2,1
2024-10-04,"62 - 1011",116,116,115,1,0,0.991379310344828
2024-10-04,"3 - 1008",235,241,235,0,6,1
2024-10-04,"16 - 1022",81,81,81,0,0,1
2024-10-04,"24 - 1150",267,287,265,2,20,0.99250936329588
2024-10-04,"24 - 1153",417,420,417,0,3,1
2024-10-05,"62 - 1011",116,116,116,0,0,1
2024-10-05,"3 - 1008",235,241,235,0,6,1
2024-10-05,"16 - 1022",81,81,81,0,0,1
2024-10-05,"24 - 1150",267,287,263,4,20,0.98501872659176
2024-10-05,"24 - 1153",417,420,417,0,3,1
2024-10-06,"62 - 1011",116,116,114,2,0,0.982758620689655
2024-10-06,"3 - 1008",235,241,235,0,6,1
2024-10-06,"16 - 1022",81,81,81,0,0,1
2024-10-06,"24 - 1150",268,287,264,4,19,0.985074626865672
2024-10-06,"24 - 1153",414,420,414,0,6,1
2024-10-07,"62 - 1011",116,116,115,1,0,0.991379310344828
2024-10-07,"3 - 1008",235,241,232,3,6,0.987234042553191
2024-10-07,"16 - 1022",81,81,79,2,0,0.975308641975309
2024-10-07,"24 - 1150",262,287,260,2,25,0.99236641221374
2024-10-07,"24 - 1153",415,416,415,0,1,1
2024-10-08,"62 - 1011",116,116,115,1,0,0.991379310344828
2024-10-08,"3 - 1008",230,241,229,1,11,0.995652173913044
2024-10-08,"16 - 1022",81,81,79,2,0,0.975308641975309
2024-10-08,"24 - 1150",261,287,261,0,26,1
2024-10-08,"24 - 1153",417,420,417,0,3,1
2024-10-09,"62 - 1011",116,116,115,1,0,0.991379310344828
2024-10-09,"3 - 1008",231,241,231,0,10,1
2024-10-09,"16 - 1022",81,81,81,0,0,1
2024-10-09,"24 - 1150",257,287,255,2,30,0.992217898832685
2024-10-09,"24 - 1153",418,420,418,0,2,1
2024-10-10,"62 - 1011",116,116,115,1,0,0.991379310344828
2024-10-10,"3 - 1008",231,241,230,1,10,0.995670995670996
2024-10-10,"16 - 1022",81,81,81,0,0,1
2024-10-10,"24 - 1150",255,287,255,0,32,1
2024-10-10,"24 - 1153",418,420,418,0,2,1
2024-10-11,"62 - 1011",116,116,115,1,0,0.991379310344828
2024-10-11,"3 - 1008",229,241,229,0,12,1
2024-10-11,"16 - 1022",81,81,81,0,0,1
2024-10-11,"24 - 1150",264,287,259,5,23,0.981060606060606
2024-10-11,"24 - 1153",419,420,419,0,1,1
2024-10-12,"62 - 1011",116,116,116,0,0,1
2024-10-12,"3 - 1008",229,241,229,0,12,1
2024-10-12,"16 - 1022",81,81,80,1,0,0.987654320987654
2024-10-12,"24 - 1150",262,287,258,4,25,0.984732824427481
2024-10-12,"24 - 1153",419,420,419,0,1,1
2024-10-13,"62 - 1011",116,116,116,0,0,1
2024-10-13,"3 - 1008",229,241,229,0,12,1
2024-10-13,"16 - 1022",81,81,79,2,0,0.975308641975309
2024-10-13,"24 - 1150",257,287,257,0,30,1
2024-10-13,"24 - 1153",419,420,419,0,1,1
2024-10-14,"62 - 1011",116,116,116,0,0,1
2024-10-14,"3 - 1008",229,241,229,0,12,1
2024-10-14,"16 - 1022",81,81,79,2,0,0.975308641975309
2024-10-14,"24 - 1150",257,287,257,0,30,1
2024-10-14,"24 - 1153",418,420,418,0,2,1
2024-10-15,"62 - 1011",116,116,116,0,0,1
2024-10-15,"3 - 1008",229,241,228,1,12,0.995633187772926
2024-10-15,"16 - 1022",81,81,80,1,0,0.987654320987654
2024-10-15,"24 - 1150",263,287,262,1,24,0.996197718631179
2024-10-15,"24 - 1153",418,420,418,0,2,1
2024-10-16,"62 - 1011",116,116,116,0,0,1
2024-10-16,"3 - 1008",228,231,228,0,3,1
2024-10-16,"16 - 1022",81,81,81,0,0,1
2024-10-16,"24 - 1150",260,287,260,0,27,1
2024-10-16,"24 - 1153",417,420,417,0,3,1
2024-10-17,"62 - 1011",116,116,116,0,0,1
2024-10-17,"3 - 1008",228,231,228,0,3,1
2024-10-17,"16 - 1022",81,81,81,0,0,1
2024-10-17,"24 - 1150",256,287,256,0,31,1
2024-10-17,"24 - 1153",417,420,417,0,3,1
2024-10-18,"62 - 1011",116,116,116,0,0,1
2024-10-18,"3 - 1008",227,231,227,0,4,1
2024-10-18,"16 - 1022",81,81,78,3,0,0.962962962962963
2024-10-18,"24 - 1150",259,287,257,2,28,0.992277992277992
2024-10-18,"24 - 1153",418,420,418,0,2,1
2024-10-19,"62 - 1011",116,116,116,0,0,1
2024-10-19,"3 - 1008",227,231,227,0,4,1
2024-10-19,"16 - 1022",81,81,79,2,0,0.975308641975309
2024-10-19,"24 - 1150",259,287,257,2,28,0.992277992277992
2024-10-19,"24 - 1153",418,420,418,0,2,1
2024-10-20,"62 - 1011",116,116,116,0,0,1
2024-10-20,"3 - 1008",227,231,227,0,4,1
2024-10-20,"16 - 1022",81,81,79,2,0,0.975308641975309
2024-10-20,"24 - 1150",258,287,258,0,29,1
2024-10-20,"24 - 1153",418,420,418,0,2,1
2024-10-21,"62 - 1011",116,116,115,1,0,0.991379310344828
2024-10-21,"3 - 1008",227,231,227,0,4,1
2024-10-21,"16 - 1022",81,81,81,0,0,1
2024-10-21,"24 - 1150",269,287,258,11,18,0.95910780669145
2024-10-21,"24 - 1153",418,420,418,0,2,1
2024-10-22,"62 - 1011",116,116,116,0,0,1
2024-10-22,"3 - 1008",227,231,227,0,4,1
2024-10-22,"16 - 1022",81,81,80,1,0,0.987654320987654
2024-10-22,"24 - 1150",267,287,259,8,20,0.970037453183521
2024-10-22,"24 - 1153",418,420,418,0,2,1
2024-10-23,"62 - 1011",116,116,116,0,0,1
2024-10-23,"3 - 1008",227,231,227,0,4,1
2024-10-23,"16 - 1022",81,81,79,2,0,0.975308641975309
2024-10-23,"24 - 1150",267,287,263,4,20,0.98501872659176
2024-10-23,"24 - 1153",418,420,418,0,2,1
2024-10-24,"62 - 1011",116,116,114,2,0,0.982758620689655
2024-10-24,"3 - 1008",227,231,227,0,4,1
2024-10-24,"16 - 1022",81,81,79,2,0,0.975308641975309
2024-10-24,"24 - 1150",268,287,266,2,19,0.992537313432836
2024-10-24,"24 - 1153",418,420,418,0,2,1
2024-10-25,"62 - 1011",116,116,114,2,0,0.982758620689655
2024-10-25,"3 - 1008",227,231,227,0,4,1
2024-10-25,"16 - 1022",81,81,79,2,0,0.975308641975309
2024-10-25,"24 - 1150",269,287,267,2,18,0.992565055762082
2024-10-25,"24 - 1153",418,420,418,0,2,1
2024-10-26,"62 - 1011",116,116,115,1,0,0.991379310344828
2024-10-26,"3 - 1008",227,231,227,0,4,1
2024-10-26,"16 - 1022",81,81,79,2,0,0.975308641975309
2024-10-26,"24 - 1150",269,287,267,2,18,0.992565055762082
2024-10-26,"24 - 1153",417,420,417,0,3,1
2024-10-27,"62 - 1011",116,116,116,0,0,1
2024-10-27,"3 - 1008",227,231,227,0,4,1
2024-10-27,"16 - 1022",81,81,79,2,0,0.975308641975309
2024-10-27,"24 - 1150",269,287,268,1,18,0.996282527881041
2024-10-27,"24 - 1153",417,420,417,0,3,1
2024-10-28,"62 - 1011",116,116,116,0,0,1
2024-10-28,"3 - 1008",227,231,227,0,4,1
2024-10-28,"16 - 1022",81,81,79,2,0,0.975308641975309
2024-10-28,"24 - 1150",275,287,266,9,12,0.967272727272727
2024-10-28,"24 - 1153",419,420,419,0,1,1
2024-10-29,"62 - 1011",116,116,114,2,0,0.982758620689655
2024-10-29,"3 - 1008",227,231,224,3,4,0.986784140969163
2024-10-29,"16 - 1022",81,81,79,2,0,0.975308641975309
2024-10-29,"24 - 1150",271,287,267,4,16,0.985239852398524
2024-10-29,"24 - 1153",420,420,420,0,0,1
2024-10-30,"62 - 1011",116,116,113,3,0,0.974137931034483
2024-10-30,"3 - 1008",227,231,226,1,4,0.995594713656388
2024-10-30,"16 - 1022",81,81,81,0,0,1
2024-10-30,"24 - 1150",270,287,267,3,17,0.988888888888889
2024-10-30,"24 - 1153",419,420,419,0,1,1
2024-10-31,"62 - 1011",116,116,114,2,0,0.982758620689655
2024-10-31,"3 - 1008",225,226,225,0,1,1
2024-10-31,"16 - 1022",81,81,81,0,0,1
2024-10-31,"24 - 1150",271,287,265,6,16,0.977859778597786
2024-10-31,"24 - 1153",418,420,418,0,2,1
2024-11-01,"62 - 1011",116,116,115,1,0,0.991379310344828
2024-11-01,"3 - 1008",225,226,225,0,1,1
2024-11-01,"16 - 1022",81,81,81,0,0,1
2024-11-01,"24 - 1150",272,287,263,9,15,0.966911764705882
2024-11-01,"24 - 1153",417,420,417,0,3,1
2024-11-02,"62 - 1011",116,116,115,1,0,0.991379310344828
2024-11-02,"3 - 1008",225,226,225,0,1,1
2024-11-02,"16 - 1022",81,81,81,0,0,1
2024-11-02,"24 - 1150",270,287,266,4,17,0.985185185185185
2024-11-02,"24 - 1153",416,420,416,0,4,1
2024-11-03,"62 - 1011",116,116,114,2,0,0.982758620689655
2024-11-03,"3 - 1008",225,226,225,0,1,1
2024-11-03,"16 - 1022",81,81,81,0,0,1
2024-11-03,"24 - 1150",271,287,263,8,16,0.970479704797048
2024-11-03,"24 - 1153",413,414,413,0,1,1
2024-11-04,"62 - 1011",116,116,114,2,0,0.982758620689655
2024-11-04,"3 - 1008",225,231,225,0,6,1
2024-11-04,"16 - 1022",81,81,81,0,0,1
2024-11-04,"24 - 1150",269,287,268,1,18,0.996282527881041
2024-11-04,"24 - 1153",411,414,411,0,3,1
2024-11-05,"62 - 1011",116,116,114,2,0,0.982758620689655
2024-11-05,"3 - 1008",226,231,223,3,5,0.986725663716814
2024-11-05,"16 - 1022",81,81,81,0,0,1
2024-11-05,"24 - 1150",271,287,267,4,16,0.985239852398524
2024-11-05,"24 - 1153",415,420,415,0,5,1
2024-11-06,"62 - 1011",116,116,114,2,0,0.982758620689655
2024-11-06,"3 - 1008",225,226,223,2,1,0.991111111111111
2024-11-06,"16 - 1022",81,81,81,0,0,1
2024-11-06,"24 - 1150",275,287,273,2,12,0.992727272727273
2024-11-06,"24 - 1153",415,420,415,0,5,1
2024-11-07,"62 - 1011",116,116,114,2,0,0.982758620689655
2024-11-07,"3 - 1008",225,226,223,2,1,0.991111111111111
2024-11-07,"16 - 1022",81,81,81,0,0,1
2024-11-07,"24 - 1150",272,287,272,0,15,1
2024-11-07,"24 - 1153",413,420,413,0,7,1
2024-11-08,"62 - 1011",116,116,111,5,0,0.956896551724138
2024-11-08,"3 - 1008",225,226,224,1,1,0.995555555555556
2024-11-08,"16 - 1022",81,81,79,2,0,0.975308641975309
2024-11-08,"24 - 1150",271,287,271,0,16,1
2024-11-08,"24 - 1153",410,420,410,0,10,1
2024-11-09,"62 - 1011",116,116,112,4,0,0.96551724137931
2024-11-09,"3 - 1008",225,226,225,0,1,1
2024-11-09,"16 - 1022",81,81,79,2,0,0.975308641975309
2024-11-09,"24 - 1150",269,287,269,0,18,1
2024-11-09,"24 - 1153",409,414,409,0,5,1
2024-11-10,"62 - 1011",116,116,113,3,0,0.974137931034483
2024-11-10,"3 - 1008",225,226,224,1,1,0.995555555555556
2024-11-10,"16 - 1022",81,81,79,2,0,0.975308641975309
2024-11-10,"24 - 1150",265,287,263,2,22,0.992452830188679
2024-11-10,"24 - 1153",409,414,409,0,5,1
2024-11-11,"62 - 1011",116,116,112,4,0,0.96551724137931
2024-11-11,"3 - 1008",226,226,225,1,0,0.995575221238938
2024-11-11,"16 - 1022",81,81,79,2,0,0.975308641975309
2024-11-11,"24 - 1150",266,287,264,2,21,0.992481203007519
2024-11-11,"24 - 1153",412,414,412,0,2,1
2024-11-12,"62 - 1011",116,116,111,5,0,0.956896551724138
2024-11-12,"3 - 1008",226,226,225,1,0,0.995575221238938
2024-11-12,"16 - 1022",81,81,78,3,0,0.962962962962963
2024-11-12,"24 - 1150",261,287,261,0,26,1
2024-11-12,"24 - 1153",418,420,418,0,2,1
2024-11-13,"62 - 1011",116,116,111,5,0,0.956896551724138
2024-11-13,"3 - 1008",227,231,227,0,4,1
2024-11-13,"16 - 1022",81,81,78,3,0,0.962962962962963
2024-11-13,"24 - 1150",261,287,260,1,26,0.996168582375479
2024-11-13,"24 - 1153",418,420,418,0,2,1
2024-11-14,"62 - 1011",116,116,111,5,0,0.956896551724138
2024-11-14,"3 - 1008",227,231,227,0,4,1
2024-11-14,"16 - 1022",81,81,79,2,0,0.975308641975309
2024-11-14,"24 - 1150",260,287,260,0,27,1
2024-11-14,"24 - 1153",416,420,416,0,4,1
2024-11-15,"62 - 1011",116,116,113,3,0,0.974137931034483
2024-11-15,"3 - 1008",247,251,245,2,4,0.991902834008097
2024-11-15,"16 - 1022",81,81,76,5,0,0.938271604938272
2024-11-15,"24 - 1150",258,287,258,0,29,1
2024-11-15,"24 - 1153",414,420,414,0,6,1
2024-11-16,"62 - 1011",116,116,114,2,0,0.982758620689655
2024-11-16,"3 - 1008",246,251,244,2,5,0.991869918699187
2024-11-16,"16 - 1022",81,81,76,5,0,0.938271604938272
2024-11-16,"24 - 1150",250,287,250,0,37,1
2024-11-16,"24 - 1153",413,420,413,0,7,1
2024-11-17,"62 - 1011",116,116,114,2,0,0.982758620689655
2024-11-17,"3 - 1008",246,251,244,2,5,0.991869918699187
2024-11-17,"16 - 1022",81,81,77,4,0,0.950617283950617
2024-11-17,"24 - 1150",248,287,247,1,39,0.995967741935484
2024-11-17,"24 - 1153",412,420,412,0,8,1
2024-11-18,"62 - 1011",116,116,113,3,0,0.974137931034483
2024-11-18,"3 - 1008",270,271,263,7,1,0.974074074074074
2024-11-18,"16 - 1022",81,81,77,4,0,0.950617283950617
2024-11-18,"24 - 1150",249,287,248,1,38,0.995983935742972
2024-11-18,"24 - 1153",411,420,411,0,9,1
2024-11-19,"62 - 1011",116,116,113,3,0,0.974137931034483
2024-11-19,"3 - 1008",291,291,275,16,0,0.945017182130584
2024-11-19,"16 - 1022",81,81,80,1,0,0.987654320987654
2024-11-19,"24 - 1150",250,287,250,0,37,1
2024-11-19,"24 - 1153",411,420,411,0,9,1
2024-11-20,"62 - 1011",116,116,113,3,0,0.974137931034483
2024-11-20,"3 - 1008",311,311,289,22,0,0.929260450160772
2024-11-20,"16 - 1022",81,81,81,0,0,1
2024-11-20,"24 - 1150",259,287,255,4,28,0.984555984555985
2024-11-20,"24 - 1153",411,420,411,0,9,1
2024-11-21,"62 - 1011",116,116,112,4,0,0.96551724137931
2024-11-21,"3 - 1008",333,333,307,26,0,0.921921921921922
2024-11-21,"16 - 1022",81,81,78,3,0,0.962962962962963
2024-11-21,"24 - 1150",256,287,254,2,31,0.9921875
2024-11-21,"24 - 1153",411,420,411,0,9,1
2024-11-22,"62 - 1011",116,116,113,3,0,0.974137931034483
2024-11-22,"3 - 1008",333,333,316,17,0,0.948948948948949
2024-11-22,"16 - 1022",81,81,80,1,0,0.987654320987654
2024-11-22,"24 - 1150",255,287,255,0,32,1
2024-11-22,"24 - 1153",411,416,411,0,5,1
2024-11-23,"62 - 1011",116,116,114,2,0,0.982758620689655
2024-11-23,"3 - 1008",333,333,322,11,0,0.966966966966967
2024-11-23,"16 - 1022",81,81,80,1,0,0.987654320987654
2024-11-23,"24 - 1150",253,287,253,0,34,1
2024-11-23,"24 - 1153",415,420,413,2,5,0.995180722891566
2024-11-24,"62 - 1011",116,116,114,2,0,0.982758620689655
2024-11-24,"3 - 1008",333,333,323,10,0,0.96996996996997
2024-11-24,"16 - 1022",81,81,80,1,0,0.987654320987654
2024-11-24,"24 - 1150",250,287,250,0,37,1
2024-11-24,"24 - 1153",415,420,413,2,5,0.995180722891566
2024-11-25,"62 - 1011",116,116,114,2,0,0.982758620689655
2024-11-25,"3 - 1008",330,333,322,8,3,0.975757575757576
2024-11-25,"16 - 1022",81,81,78,3,0,0.962962962962963
2024-11-25,"24 - 1150",259,287,258,1,28,0.996138996138996
2024-11-25,"24 - 1153",415,420,412,3,5,0.992771084337349
2024-11-26,"62 - 1011",116,116,114,2,0,0.982758620689655
2024-11-26,"3 - 1008",330,333,320,10,3,0.96969696969697
2024-11-26,"16 - 1022",81,81,77,4,0,0.950617283950617
2024-11-26,"24 - 1150",262,287,261,1,25,0.99618320610687
2024-11-26,"24 - 1153",416,420,413,3,4,0.992788461538462
2024-11-27,"62 - 1011",116,116,114,2,0,0.982758620689655
2024-11-27,"3 - 1008",330,333,323,7,3,0.978787878787879
2024-11-27,"16 - 1022",81,81,78,3,0,0.962962962962963
2024-11-27,"24 - 1150",265,287,260,5,22,0.981132075471698
2024-11-27,"24 - 1153",416,420,416,0,4,1
2024-11-28,"62 - 1011",116,116,114,2,0,0.982758620689655
2024-11-28,"3 - 1008",330,333,324,6,3,0.981818181818182
2024-11-28,"16 - 1022",81,81,80,1,0,0.987654320987654
2024-11-28,"24 - 1150",262,287,262,0,25,1
2024-11-28,"24 - 1153",415,420,415,0,5,1
2024-11-29,"62 - 1011",116,116,114,2,0,0.982758620689655
2024-11-29,"3 - 1008",330,333,325,5,3,0.984848484848485
2024-11-29,"16 - 1022",81,81,79,2,0,0.975308641975309
2024-11-29,"24 - 1150",260,287,260,0,27,1
2024-11-29,"24 - 1153",414,420,414,0,6,1
2024-11-30,"62 - 1011",116,116,114,2,0,0.982758620689655
2024-11-30,"3 - 1008",331,333,326,5,2,0.984894259818731
2024-11-30,"16 - 1022",81,81,79,2,0,0.975308641975309
2024-11-30,"24 - 1150",259,287,259,0,28,1
2024-11-30,"24 - 1153",413,420,413,0,7,1
2024-12-01,"62 - 1011",116,116,114,2,0,0.982758620689655
2024-12-01,"3 - 1008",331,333,325,6,2,0.981873111782477
2024-12-01,"16 - 1022",81,81,78,3,0,0.962962962962963
2024-12-01,"24 - 1150",258,287,258,0,29,1
2024-12-01,"24 - 1153",411,420,410,1,9,0.997566909975669
2024-12-02,"62 - 1011",116,116,113,3,0,0.974137931034483
2024-12-02,"3 - 1008",330,333,325,5,3,0.984848484848485
2024-12-02,"16 - 1022",81,81,79,2,0,0.975308641975309
2024-12-02,"24 - 1150",261,287,258,3,26,0.988505747126437
2024-12-02,"24 - 1153",409,420,408,1,11,0.997555012224939
2024-12-03,"62 - 1011",116,116,113,3,0,0.974137931034483
2024-12-03,"3 - 1008",330,333,325,5,3,0.984848484848485
2024-12-03,"16 - 1022",81,81,80,1,0,0.987654320987654
2024-12-03,"24 - 1150",257,287,257,0,30,1
2024-12-03,"24 - 1153",412,420,411,1,8,0.997572815533981
2024-12-04,"62 - 1011",116,116,113,3,0,0.974137931034483
2024-12-04,"3 - 1008",330,333,324,6,3,0.981818181818182
2024-12-04,"16 - 1022",81,81,81,0,0,1
2024-12-04,"24 - 1150",260,287,260,0,27,1
2024-12-04,"24 - 1153",411,420,410,1,9,0.997566909975669
2024-12-05,"62 - 1011",116,116,113,3,0,0.974137931034483
2024-12-05,"3 - 1008",329,333,323,6,4,0.981762917933131
2024-12-05,"16 - 1022",81,81,81,0,0,1
2024-12-05,"24 - 1150",255,287,254,1,32,0.996078431372549
2024-12-05,"24 - 1153",411,420,411,0,9,1
2024-12-06,"62 - 1011",116,116,113,3,0,0.974137931034483
2024-12-06,"3 - 1008",331,333,323,8,2,0.97583081570997
2024-12-06,"16 - 1022",81,81,80,1,0,0.987654320987654
2024-12-06,"24 - 1150",257,287,257,0,30,1
2024-12-06,"24 - 1153",411,420,411,0,9,1
2024-12-07,"62 - 1011",116,116,113,3,0,0.974137931034483
2024-12-07,"3 - 1008",331,333,325,6,2,0.981873111782477
2024-12-07,"16 - 1022",81,81,79,2,0,0.975308641975309
2024-12-07,"24 - 1150",262,287,260,2,25,0.99236641221374
2024-12-07,"24 - 1153",410,420,409,1,10,0.997560975609756
2024-12-08,"62 - 1011",116,116,113,3,0,0.974137931034483
2024-12-08,"3 - 1008",330,333,323,7,3,0.978787878787879
2024-12-08,"16 - 1022",81,81,76,5,0,0.938271604938272
2024-12-08,"24 - 1150",262,287,262,0,25,1
2024-12-08,"24 - 1153",409,420,409,0,11,1
2024-12-09,"62 - 1011",116,116,113,3,0,0.974137931034483
2024-12-09,"3 - 1008",330,333,319,11,3,0.966666666666667
2024-12-09,"16 - 1022",81,81,80,1,0,0.987654320987654
2024-12-09,"24 - 1150",261,287,261,0,26,1
2024-12-09,"24 - 1153",408,420,407,1,12,0.997549019607843
2024-12-10,"62 - 1011",116,116,113,3,0,0.974137931034483
2024-12-10,"3 - 1008",330,333,319,11,3,0.966666666666667
2024-12-10,"16 - 1022",81,81,77,4,0,0.950617283950617
2024-12-10,"24 - 1150",263,287,263,0,24,1
2024-12-10,"24 - 1153",405,420,405,0,15,1
2024-12-11,"62 - 1011",116,116,113,3,0,0.974137931034483
2024-12-11,"3 - 1008",330,333,321,9,3,0.972727272727273
2024-12-11,"16 - 1022",81,81,78,3,0,0.962962962962963
2024-12-11,"24 - 1150",263,287,263,0,24,1
2024-12-11,"24 - 1153",401,414,401,0,13,1
2024-12-12,"62 - 1011",116,116,112,4,0,0.96551724137931
2024-12-12,"3 - 1008",330,333,321,9,3,0.972727272727273
2024-12-12,"16 - 1022",81,81,78,3,0,0.962962962962963
2024-12-12,"24 - 1150",259,287,258,1,28,0.996138996138996
2024-12-12,"24 - 1153",402,414,402,0,12,1
2024-12-13,"62 - 1011",116,116,112,4,0,0.96551724137931
2024-12-13,"3 - 1008",330,333,320,10,3,0.96969696969697
2024-12-13,"16 - 1022",81,81,78,3,0,0.962962962962963
2024-12-13,"24 - 1150",256,287,256,0,31,1
2024-12-13,"24 - 1153",408,414,407,1,6,0.997549019607843
2024-12-14,"62 - 1011",116,116,114,2,0,0.982758620689655
2024-12-14,"3 - 1008",330,333,321,9,3,0.972727272727273
2024-12-14,"16 - 1022",81,81,78,3,0,0.962962962962963
2024-12-14,"24 - 1150",255,287,255,0,32,1
2024-12-14,"24 - 1153",408,414,408,0,6,1
2024-12-15,"62 - 1011",116,116,115,1,0,0.991379310344828
2024-12-15,"3 - 1008",329,333,321,8,4,0.975683890577508
2024-12-15,"16 - 1022",81,81,78,3,0,0.962962962962963
2024-12-15,"24 - 1150",255,287,255,0,32,1
2024-12-15,"24 - 1153",408,414,408,0,6,1
2024-12-16,"62 - 1011",116,116,116,0,0,1
2024-12-16,"3 - 1008",329,333,321,8,4,0.975683890577508
2024-12-16,"16 - 1022",81,81,79,2,0,0.975308641975309
2024-12-16,"24 - 1150",254,287,254,0,33,1
2024-12-16,"24 - 1153",411,414,411,0,3,1
2024-12-17,"62 - 1011",116,116,115,1,0,0.991379310344828
2024-12-17,"3 - 1008",329,333,320,9,4,0.972644376899696
2024-12-17,"16 - 1022",81,81,79,2,0,0.975308641975309
2024-12-17,"24 - 1150",255,287,255,0,32,1
2024-12-17,"24 - 1153",415,420,415,0,5,1
2024-12-18,"62 - 1011",116,116,116,0,0,1
2024-12-18,"3 - 1008",329,333,322,7,4,0.978723404255319
2024-12-18,"16 - 1022",81,81,79,2,0,0.975308641975309
2024-12-18,"24 - 1150",252,287,251,1,35,0.996031746031746
2024-12-18,"24 - 1153",420,420,420,0,0,1
2024-12-19,"62 - 1011",116,116,116,0,0,1
2024-12-19,"3 - 1008",329,333,319,10,4,0.969604863221885
2024-12-19,"16 - 1022",81,81,80,1,0,0.987654320987654
2024-12-19,"24 - 1150",252,287,252,0,35,1
2024-12-19,"24 - 1153",420,420,420,0,0,1
2024-12-20,"62 - 1011",116,116,115,1,0,0.991379310344828
2024-12-20,"3 - 1008",328,333,317,11,5,0.966463414634146
2024-12-20,"16 - 1022",81,81,80,1,0,0.987654320987654
2024-12-20,"24 - 1150",252,287,252,0,35,1
2024-12-20,"24 - 1153",419,420,419,0,1,1
2024-12-21,"62 - 1011",116,116,115,1,0,0.991379310344828
2024-12-21,"3 - 1008",333,343,320,13,10,0.960960960960961
2024-12-21,"16 - 1022",81,81,80,1,0,0.987654320987654
2024-12-21,"24 - 1150",252,287,252,0,35,1
2024-12-21,"24 - 1153",420,420,419,1,0,0.997619047619048
2024-12-22,"62 - 1011",116,116,115,1,0,0.991379310344828
2024-12-22,"3 - 1008",333,343,318,15,10,0.954954954954955
2024-12-22,"16 - 1022",81,81,80,1,0,0.987654320987654
2024-12-22,"24 - 1150",251,287,251,0,36,1
2024-12-22,"24 - 1153",418,420,418,0,2,1
2024-12-23,"62 - 1011",116,116,115,1,0,0.991379310344828
2024-12-23,"3 - 1008",328,333,318,10,5,0.969512195121951
2024-12-23,"16 - 1022",81,81,81,0,0,1
2024-12-23,"24 - 1150",252,287,252,0,35,1
2024-12-23,"24 - 1153",418,420,418,0,2,1
2024-12-24,"62 - 1011",116,116,116,0,0,1
2024-12-24,"3 - 1008",328,333,315,13,5,0.960365853658537
2024-12-24,"16 - 1022",81,81,81,0,0,1
2024-12-24,"24 - 1150",252,287,252,0,35,1
2024-12-24,"24 - 1153",418,420,418,0,2,1
2024-12-25,"62 - 1011",116,116,116,0,0,1
2024-12-25,"3 - 1008",328,333,316,12,5,0.963414634146341
2024-12-25,"16 - 1022",81,81,81,0,0,1
2024-12-25,"24 - 1150",253,287,252,1,34,0.99604743083004
2024-12-25,"24 - 1153",418,420,418,0,2,1
2024-12-26,"62 - 1011",116,116,116,0,0,1
2024-12-26,"3 - 1008",328,333,316,12,5,0.963414634146341
2024-12-26,"16 - 1022",81,81,81,0,0,1
2024-12-26,"24 - 1150",253,287,252,1,34,0.99604743083004
2024-12-26,"24 - 1153",417,420,417,0,3,1
2024-12-27,"62 - 1011",116,116,116,0,0,1
2024-12-27,"3 - 1008",328,333,315,13,5,0.960365853658537
2024-12-27,"16 - 1022",81,81,79,2,0,0.975308641975309
2024-12-27,"24 - 1150",253,287,253,0,34,1
2024-12-27,"24 - 1153",417,420,417,0,3,1
2024-12-28,"62 - 1011",116,116,116,0,0,1
2024-12-28,"3 - 1008",328,333,315,13,5,0.960365853658537
2024-12-28,"16 - 1022",81,81,79,2,0,0.975308641975309
2024-12-28,"24 - 1150",253,287,253,0,34,1
2024-12-28,"24 - 1153",416,420,416,0,4,1
2024-12-29,"62 - 1011",116,116,116,0,0,1
2024-12-29,"3 - 1008",328,333,315,13,5,0.960365853658537
2024-12-29,"16 - 1022",81,81,79,2,0,0.975308641975309
2024-12-29,"24 - 1150",253,287,253,0,34,1
2024-12-29,"24 - 1153",416,420,416,0,4,1
2024-12-30,"62 - 1011",116,116,115,1,0,0.991379310344828
2024-12-30,"3 - 1008",328,333,315,13,5,0.960365853658537
2024-12-30,"16 - 1022",81,81,80,1,0,0.987654320987654
2024-12-30,"24 - 1150",254,287,254,0,33,1
2024-12-30,"24 - 1153",416,420,416,0,4,1
2024-12-31,"62 - 1011",116,116,115,1,0,0.991379310344828
2024-12-31,"3 - 1008",327,333,314,13,6,0.960244648318043
2024-12-31,"16 - 1022",81,81,79,2,0,0.975308641975309
2024-12-31,"24 - 1150",254,287,254,0,33,1
2024-12-31,"24 - 1153",415,420,415,0,5,1
