"","OCCUPANCY_DATE","shelter_location_pair","capacity_actual_sum","capacity_funding_sum","occupied_sum","unoccupied_sum","unavailable_sum","occupancy_rate"
"1",2021-01-01,"62 - 1011",55,61,55,0,6,1
"2",2021-01-01,"3 - 1008",201,208,185,16,7,0.920398009950249
"3",2021-01-01,"16 - 1022",50,50,45,5,0,0.9
"4",2021-01-01,"24 - 1150",172,173,161,11,1,0.936046511627907
"5",2021-01-01,"24 - 1153",125,125,123,2,0,0.984
"6",2021-01-02,"62 - 1011",55,61,54,1,6,0.981818181818182
"7",2021-01-02,"3 - 1008",201,208,186,15,7,0.925373134328358
"8",2021-01-02,"16 - 1022",50,50,45,5,0,0.9
"9",2021-01-02,"24 - 1150",170,173,158,12,3,0.929411764705882
"10",2021-01-02,"24 - 1153",125,125,125,0,0,1
"11",2021-01-03,"62 - 1011",55,61,53,2,6,0.963636363636364
"12",2021-01-03,"3 - 1008",201,208,186,15,7,0.925373134328358
"13",2021-01-03,"16 - 1022",48,50,42,6,2,0.875
"14",2021-01-03,"24 - 1150",170,173,150,20,3,0.88235294117647
"15",2021-01-03,"24 - 1153",125,125,125,0,0,1
"16",2021-01-04,"62 - 1011",52,61,52,0,9,1
"17",2021-01-04,"3 - 1008",201,208,188,13,7,0.935323383084577
"18",2021-01-04,"16 - 1022",49,50,48,1,1,0.979591836734694
"19",2021-01-04,"24 - 1150",170,173,157,13,3,0.923529411764706
"20",2021-01-04,"24 - 1153",125,125,123,2,0,0.984
"21",2021-01-05,"62 - 1011",51,61,50,1,10,0.980392156862745
"22",2021-01-05,"3 - 1008",201,208,185,16,7,0.920398009950249
"23",2021-01-05,"16 - 1022",50,50,48,2,0,0.96
"24",2021-01-05,"24 - 1150",169,173,153,16,4,0.905325443786982
"25",2021-01-05,"24 - 1153",125,125,125,0,0,1
"26",2021-01-06,"62 - 1011",51,61,49,2,10,0.96078431372549
"27",2021-01-06,"3 - 1008",201,208,188,13,7,0.935323383084577
"28",2021-01-06,"16 - 1022",50,50,50,0,0,1
"29",2021-01-06,"24 - 1150",152,173,152,0,21,1
"30",2021-01-06,"24 - 1153",125,125,125,0,0,1
"31",2021-01-07,"62 - 1011",51,61,49,2,10,0.96078431372549
"32",2021-01-07,"3 - 1008",201,208,188,13,7,0.935323383084577
"33",2021-01-07,"16 - 1022",50,50,48,2,0,0.96
"34",2021-01-07,"24 - 1150",147,173,147,0,26,1
"35",2021-01-07,"24 - 1153",125,125,123,2,0,0.984
"36",2021-01-08,"62 - 1011",52,61,49,3,9,0.942307692307692
"37",2021-01-08,"3 - 1008",201,208,188,13,7,0.935323383084577
"38",2021-01-08,"16 - 1022",50,50,50,0,0,1
"39",2021-01-08,"24 - 1150",144,173,144,0,29,1
"40",2021-01-08,"24 - 1153",125,125,124,1,0,0.992
"41",2021-01-09,"62 - 1011",53,61,52,1,8,0.981132075471698
"42",2021-01-09,"3 - 1008",201,208,189,12,7,0.940298507462687
"43",2021-01-09,"16 - 1022",50,50,50,0,0,1
"44",2021-01-09,"24 - 1150",139,173,139,0,34,1
"45",2021-01-09,"24 - 1153",125,125,123,2,0,0.984
"46",2021-01-10,"62 - 1011",53,61,52,1,8,0.981132075471698
"47",2021-01-10,"3 - 1008",201,208,184,17,7,0.915422885572139
"48",2021-01-10,"16 - 1022",50,50,48,2,0,0.96
"49",2021-01-10,"24 - 1150",132,173,131,1,41,0.992424242424242
"50",2021-01-10,"24 - 1153",125,125,123,2,0,0.984
"51",2021-01-11,"62 - 1011",52,61,52,0,9,1
"52",2021-01-11,"3 - 1008",201,208,184,17,7,0.915422885572139
"53",2021-01-11,"16 - 1022",50,50,48,2,0,0.96
"54",2021-01-11,"24 - 1150",128,173,128,0,45,1
"55",2021-01-11,"24 - 1153",125,125,124,1,0,0.992
"56",2021-01-12,"62 - 1011",52,61,52,0,9,1
"57",2021-01-12,"3 - 1008",201,208,180,21,7,0.895522388059702
"58",2021-01-12,"16 - 1022",50,50,47,3,0,0.94
"59",2021-01-12,"24 - 1150",126,173,126,0,47,1
"60",2021-01-12,"24 - 1153",125,125,125,0,0,1
"61",2021-01-13,"62 - 1011",53,61,53,0,8,1
"62",2021-01-13,"3 - 1008",200,208,178,22,8,0.89
"63",2021-01-13,"16 - 1022",50,50,48,2,0,0.96
"64",2021-01-13,"24 - 1150",123,173,123,0,50,1
"65",2021-01-13,"24 - 1153",125,125,124,1,0,0.992
"66",2021-01-14,"62 - 1011",53,61,52,1,8,0.981132075471698
"67",2021-01-14,"3 - 1008",202,208,177,25,6,0.876237623762376
"68",2021-01-14,"16 - 1022",50,50,50,0,0,1
"69",2021-01-14,"24 - 1150",119,173,119,0,54,1
"70",2021-01-14,"24 - 1153",125,125,125,0,0,1
"71",2021-01-15,"62 - 1011",55,61,48,7,6,0.872727272727273
"72",2021-01-15,"3 - 1008",201,208,176,25,7,0.875621890547264
"73",2021-01-15,"16 - 1022",50,50,49,1,0,0.98
"74",2021-01-15,"24 - 1150",118,173,118,0,55,1
"75",2021-01-15,"24 - 1153",125,125,124,1,0,0.992
"76",2021-01-16,"62 - 1011",55,61,41,14,6,0.745454545454545
"77",2021-01-16,"3 - 1008",201,208,176,25,7,0.875621890547264
"78",2021-01-16,"16 - 1022",50,50,50,0,0,1
"79",2021-01-16,"24 - 1150",117,173,117,0,56,1
"80",2021-01-16,"24 - 1153",125,125,125,0,0,1
"81",2021-01-17,"62 - 1011",55,61,44,11,6,0.8
"82",2021-01-17,"3 - 1008",201,208,175,26,7,0.870646766169154
"83",2021-01-17,"16 - 1022",50,50,50,0,0,1
"84",2021-01-17,"24 - 1150",127,173,126,1,46,0.992125984251969
"85",2021-01-17,"24 - 1153",125,125,125,0,0,1
"86",2021-01-18,"62 - 1011",55,61,45,10,6,0.818181818181818
"87",2021-01-18,"3 - 1008",199,208,176,23,9,0.884422110552764
"88",2021-01-18,"16 - 1022",50,50,50,0,0,1
"89",2021-01-18,"24 - 1150",173,173,131,42,0,0.757225433526012
"90",2021-01-18,"24 - 1153",125,125,125,0,0,1
"91",2021-01-19,"62 - 1011",55,61,47,8,6,0.854545454545454
"92",2021-01-19,"3 - 1008",199,208,181,18,9,0.909547738693467
"93",2021-01-19,"16 - 1022",50,50,50,0,0,1
"94",2021-01-19,"24 - 1150",171,173,136,35,2,0.7953216374269
"95",2021-01-19,"24 - 1153",125,125,119,6,0,0.952
"96",2021-01-20,"62 - 1011",55,61,51,4,6,0.927272727272727
"97",2021-01-20,"3 - 1008",199,208,187,12,9,0.939698492462312
"98",2021-01-20,"16 - 1022",50,50,49,1,0,0.98
"99",2021-01-20,"24 - 1150",170,173,140,30,3,0.823529411764706
"100",2021-01-20,"24 - 1153",125,125,122,3,0,0.976
"101",2021-01-21,"62 - 1011",54,61,51,3,7,0.944444444444444
"102",2021-01-21,"3 - 1008",199,208,188,11,9,0.944723618090452
"103",2021-01-21,"16 - 1022",50,50,49,1,0,0.98
"104",2021-01-21,"24 - 1150",172,173,143,29,1,0.831395348837209
"105",2021-01-21,"24 - 1153",125,125,123,2,0,0.984
"106",2021-01-22,"62 - 1011",54,61,53,1,7,0.981481481481482
"107",2021-01-22,"3 - 1008",206,208,190,16,2,0.922330097087379
"108",2021-01-22,"16 - 1022",50,50,50,0,0,1
"109",2021-01-22,"24 - 1150",171,173,145,26,2,0.847953216374269
"110",2021-01-22,"24 - 1153",157,157,129,28,0,0.821656050955414
"111",2021-01-23,"62 - 1011",54,61,52,2,7,0.962962962962963
"112",2021-01-23,"3 - 1008",206,208,191,15,2,0.927184466019418
"113",2021-01-23,"16 - 1022",50,50,50,0,0,1
"114",2021-01-23,"24 - 1150",172,173,150,22,1,0.872093023255814
"115",2021-01-23,"24 - 1153",157,157,153,4,0,0.974522292993631
"116",2021-01-24,"62 - 1011",54,61,51,3,7,0.944444444444444
"117",2021-01-24,"3 - 1008",206,208,189,17,2,0.91747572815534
"118",2021-01-24,"16 - 1022",50,50,50,0,0,1
"119",2021-01-24,"24 - 1150",172,173,157,15,1,0.912790697674419
"120",2021-01-24,"24 - 1153",157,157,155,2,0,0.987261146496815
"121",2021-01-25,"62 - 1011",55,61,53,2,6,0.963636363636364
"122",2021-01-25,"3 - 1008",205,208,191,14,3,0.931707317073171
"123",2021-01-25,"16 - 1022",50,50,50,0,0,1
"124",2021-01-25,"24 - 1150",173,173,164,9,0,0.947976878612717
"125",2021-01-25,"24 - 1153",136,157,126,10,21,0.926470588235294
"126",2021-01-26,"62 - 1011",55,61,54,1,6,0.981818181818182
"127",2021-01-26,"3 - 1008",205,208,189,16,3,0.921951219512195
"128",2021-01-26,"16 - 1022",50,50,50,0,0,1
"129",2021-01-26,"24 - 1150",172,173,155,17,1,0.901162790697674
"130",2021-01-26,"24 - 1153",125,125,125,0,0,1
"131",2021-01-27,"62 - 1011",55,61,55,0,6,1
"132",2021-01-27,"3 - 1008",205,208,191,14,3,0.931707317073171
"133",2021-01-27,"16 - 1022",50,50,49,1,0,0.98
"134",2021-01-27,"24 - 1150",154,173,154,0,19,1
"135",2021-01-27,"24 - 1153",157,157,144,13,0,0.917197452229299
"136",2021-01-28,"62 - 1011",54,61,54,0,7,1
"137",2021-01-28,"3 - 1008",206,208,190,16,2,0.922330097087379
"138",2021-01-28,"16 - 1022",50,50,46,4,0,0.92
"139",2021-01-28,"24 - 1150",148,173,148,0,25,1
"140",2021-01-28,"24 - 1153",175,175,154,21,0,0.88
"141",2021-01-29,"62 - 1011",55,61,55,0,6,1
"142",2021-01-29,"3 - 1008",206,208,193,13,2,0.936893203883495
"143",2021-01-29,"16 - 1022",50,50,46,4,0,0.92
"144",2021-01-29,"24 - 1150",145,173,145,0,28,1
"145",2021-01-29,"24 - 1153",175,175,169,6,0,0.965714285714286
"146",2021-01-30,"62 - 1011",57,61,57,0,4,1
"147",2021-01-30,"3 - 1008",206,208,188,18,2,0.912621359223301
"148",2021-01-30,"16 - 1022",50,50,46,4,0,0.92
"149",2021-01-30,"24 - 1150",144,173,144,0,29,1
"150",2021-01-30,"24 - 1153",175,175,172,3,0,0.982857142857143
"151",2021-01-31,"62 - 1011",56,61,56,0,5,1
"152",2021-01-31,"3 - 1008",206,208,186,20,2,0.902912621359223
"153",2021-01-31,"16 - 1022",50,50,46,4,0,0.92
"154",2021-01-31,"24 - 1150",144,173,144,0,29,1
"155",2021-01-31,"24 - 1153",175,175,173,2,0,0.988571428571429
"156",2021-02-01,"62 - 1011",54,61,53,1,7,0.981481481481482
"157",2021-02-01,"3 - 1008",207,208,184,23,1,0.888888888888889
"158",2021-02-01,"16 - 1022",50,50,49,1,0,0.98
"159",2021-02-01,"24 - 1150",134,173,134,0,39,1
"160",2021-02-01,"24 - 1153",175,175,173,2,0,0.988571428571429
"161",2021-02-02,"62 - 1011",55,61,54,1,6,0.981818181818182
"162",2021-02-02,"3 - 1008",205,208,166,39,3,0.809756097560976
"163",2021-02-02,"16 - 1022",50,50,48,2,0,0.96
"164",2021-02-02,"24 - 1150",123,173,123,0,50,1
"165",2021-02-02,"24 - 1153",125,125,125,0,0,1
"166",2021-02-03,"62 - 1011",55,61,54,1,6,0.981818181818182
"167",2021-02-03,"3 - 1008",169,208,164,5,39,0.970414201183432
"168",2021-02-03,"16 - 1022",50,50,49,1,0,0.98
"169",2021-02-03,"24 - 1150",117,173,117,0,56,1
"170",2021-02-03,"24 - 1153",124,125,124,0,1,1
"171",2021-02-04,"62 - 1011",55,61,51,4,6,0.927272727272727
"172",2021-02-04,"3 - 1008",166,208,162,4,42,0.975903614457831
"173",2021-02-04,"16 - 1022",50,50,47,3,0,0.94
"174",2021-02-04,"24 - 1150",115,173,115,0,58,1
"175",2021-02-04,"24 - 1153",122,125,122,0,3,1
"176",2021-02-05,"62 - 1011",55,61,49,6,6,0.890909090909091
"177",2021-02-05,"3 - 1008",156,208,155,1,52,0.993589743589744
"178",2021-02-05,"16 - 1022",50,50,48,2,0,0.96
"179",2021-02-05,"24 - 1150",112,173,112,0,61,1
"180",2021-02-05,"24 - 1153",118,125,118,0,7,1
"181",2021-02-06,"62 - 1011",54,61,49,5,7,0.907407407407407
"182",2021-02-06,"3 - 1008",155,208,152,3,53,0.980645161290323
"183",2021-02-06,"16 - 1022",50,50,47,3,0,0.94
"184",2021-02-06,"24 - 1150",109,173,109,0,64,1
"185",2021-02-06,"24 - 1153",117,125,117,0,8,1
"186",2021-02-07,"62 - 1011",54,61,49,5,7,0.907407407407407
"187",2021-02-07,"3 - 1008",155,208,154,1,53,0.993548387096774
"188",2021-02-07,"16 - 1022",50,50,47,3,0,0.94
"189",2021-02-07,"24 - 1150",108,173,107,1,65,0.990740740740741
"190",2021-02-07,"24 - 1153",167,175,141,26,8,0.844311377245509
"191",2021-02-08,"62 - 1011",54,61,51,3,7,0.944444444444444
"192",2021-02-08,"3 - 1008",155,208,155,0,53,1
"193",2021-02-08,"16 - 1022",50,50,47,3,0,0.94
"194",2021-02-08,"24 - 1150",101,173,101,0,72,1
"195",2021-02-08,"24 - 1153",163,175,163,0,12,1
"196",2021-02-09,"62 - 1011",54,61,48,6,7,0.888888888888889
"197",2021-02-09,"3 - 1008",155,208,154,1,53,0.993548387096774
"198",2021-02-09,"16 - 1022",50,50,48,2,0,0.96
"199",2021-02-09,"24 - 1150",96,173,96,0,77,1
"200",2021-02-09,"24 - 1153",160,175,160,0,15,1
"201",2021-02-10,"62 - 1011",54,61,47,7,7,0.87037037037037
"202",2021-02-10,"3 - 1008",153,208,149,4,55,0.973856209150327
"203",2021-02-10,"16 - 1022",50,50,48,2,0,0.96
"204",2021-02-10,"24 - 1150",173,173,122,51,0,0.705202312138728
"205",2021-02-10,"24 - 1153",159,175,159,0,16,1
"206",2021-02-11,"62 - 1011",54,61,47,7,7,0.87037037037037
"207",2021-02-11,"3 - 1008",147,208,145,2,61,0.986394557823129
"208",2021-02-11,"16 - 1022",50,50,48,2,0,0.96
"209",2021-02-11,"24 - 1150",173,173,132,41,0,0.763005780346821
"210",2021-02-11,"24 - 1153",158,175,158,0,17,1
"211",2021-02-12,"62 - 1011",54,61,46,8,7,0.851851851851852
"212",2021-02-12,"3 - 1008",155,208,154,1,53,0.993548387096774
"213",2021-02-12,"16 - 1022",50,50,48,2,0,0.96
"214",2021-02-12,"24 - 1150",172,173,134,38,1,0.77906976744186
"215",2021-02-12,"24 - 1153",175,175,171,4,0,0.977142857142857
"216",2021-02-13,"62 - 1011",54,61,46,8,7,0.851851851851852
"217",2021-02-13,"3 - 1008",159,208,159,0,49,1
"218",2021-02-13,"16 - 1022",50,50,48,2,0,0.96
"219",2021-02-13,"24 - 1150",171,173,135,36,2,0.789473684210526
"220",2021-02-13,"24 - 1153",175,175,174,1,0,0.994285714285714
"221",2021-02-14,"62 - 1011",54,61,46,8,7,0.851851851851852
"222",2021-02-14,"3 - 1008",158,208,158,0,50,1
"223",2021-02-14,"16 - 1022",49,50,47,2,1,0.959183673469388
"224",2021-02-14,"24 - 1150",172,173,137,35,1,0.796511627906977
"225",2021-02-14,"24 - 1153",175,175,172,3,0,0.982857142857143
"226",2021-02-15,"62 - 1011",54,61,44,10,7,0.814814814814815
"227",2021-02-15,"3 - 1008",162,208,162,0,46,1
"228",2021-02-15,"16 - 1022",48,50,47,1,2,0.979166666666667
"229",2021-02-15,"24 - 1150",172,173,138,34,1,0.802325581395349
"230",2021-02-15,"24 - 1153",175,175,165,10,0,0.942857142857143
"231",2021-02-16,"62 - 1011",53,61,44,9,8,0.830188679245283
"232",2021-02-16,"3 - 1008",159,208,159,0,49,1
"233",2021-02-16,"16 - 1022",46,50,45,1,4,0.978260869565217
"234",2021-02-16,"24 - 1150",172,173,148,24,1,0.86046511627907
"235",2021-02-16,"24 - 1153",175,175,172,3,0,0.982857142857143
"236",2021-02-17,"62 - 1011",54,61,46,8,7,0.851851851851852
"237",2021-02-17,"3 - 1008",160,208,160,0,48,1
"238",2021-02-17,"16 - 1022",45,50,43,2,5,0.955555555555556
"239",2021-02-17,"24 - 1150",171,173,151,20,2,0.883040935672515
"240",2021-02-17,"24 - 1153",175,175,175,0,0,1
"241",2021-02-18,"62 - 1011",54,61,46,8,7,0.851851851851852
"242",2021-02-18,"3 - 1008",160,208,160,0,48,1
"243",2021-02-18,"16 - 1022",49,50,48,1,1,0.979591836734694
"244",2021-02-18,"24 - 1150",170,173,146,24,3,0.858823529411765
"245",2021-02-18,"24 - 1153",174,175,174,0,1,1
"246",2021-02-19,"62 - 1011",54,61,51,3,7,0.944444444444444
"247",2021-02-19,"3 - 1008",161,208,161,0,47,1
"248",2021-02-19,"16 - 1022",49,50,48,1,1,0.979591836734694
"249",2021-02-19,"24 - 1150",171,173,151,20,2,0.883040935672515
"250",2021-02-19,"24 - 1153",175,175,175,0,0,1
"251",2021-02-20,"62 - 1011",54,61,54,0,7,1
"252",2021-02-20,"3 - 1008",162,208,162,0,46,1
"253",2021-02-20,"16 - 1022",50,50,49,1,0,0.98
"254",2021-02-20,"24 - 1150",171,173,150,21,2,0.87719298245614
"255",2021-02-20,"24 - 1153",175,175,173,2,0,0.988571428571429
"256",2021-02-21,"62 - 1011",54,61,53,1,7,0.981481481481482
"257",2021-02-21,"3 - 1008",164,208,164,0,44,1
"258",2021-02-21,"16 - 1022",50,50,50,0,0,1
"259",2021-02-21,"24 - 1150",171,173,151,20,2,0.883040935672515
"260",2021-02-21,"24 - 1153",175,175,172,3,0,0.982857142857143
"261",2021-02-22,"62 - 1011",54,61,53,1,7,0.981481481481482
"262",2021-02-22,"3 - 1008",165,208,162,3,43,0.981818181818182
"263",2021-02-22,"16 - 1022",50,50,48,2,0,0.96
"264",2021-02-22,"24 - 1150",171,173,145,26,2,0.847953216374269
"265",2021-02-22,"24 - 1153",170,175,170,0,5,1
"266",2021-02-23,"62 - 1011",54,61,53,1,7,0.981481481481482
"267",2021-02-23,"3 - 1008",164,208,164,0,44,1
"268",2021-02-23,"16 - 1022",50,50,50,0,0,1
"269",2021-02-23,"24 - 1150",169,173,146,23,4,0.863905325443787
"270",2021-02-23,"24 - 1153",157,175,157,0,18,1
"271",2021-02-24,"62 - 1011",54,61,53,1,7,0.981481481481482
"272",2021-02-24,"3 - 1008",164,208,164,0,44,1
"273",2021-02-24,"16 - 1022",50,50,49,1,0,0.98
"274",2021-02-24,"24 - 1150",172,173,152,20,1,0.883720930232558
"275",2021-02-24,"24 - 1153",140,175,140,0,35,1
"276",2021-02-25,"62 - 1011",54,61,54,0,7,1
"277",2021-02-25,"3 - 1008",164,208,164,0,44,1
"278",2021-02-25,"16 - 1022",50,50,50,0,0,1
"279",2021-02-25,"24 - 1150",172,173,153,19,1,0.88953488372093
"280",2021-02-25,"24 - 1153",130,175,130,0,45,1
"281",2021-02-26,"62 - 1011",54,61,54,0,7,1
"282",2021-02-26,"3 - 1008",166,208,166,0,42,1
"283",2021-02-26,"16 - 1022",50,50,49,1,0,0.98
"284",2021-02-26,"24 - 1150",170,173,155,15,3,0.911764705882353
"285",2021-02-26,"24 - 1153",125,125,125,0,0,1
"286",2021-02-27,"62 - 1011",52,61,50,2,9,0.961538461538462
"287",2021-02-27,"3 - 1008",167,208,167,0,41,1
"288",2021-02-27,"16 - 1022",50,50,49,1,0,0.98
"289",2021-02-27,"24 - 1150",169,173,157,12,4,0.928994082840237
"290",2021-02-27,"24 - 1153",125,125,123,2,0,0.984
"291",2021-02-28,"62 - 1011",53,61,51,2,8,0.962264150943396
"292",2021-02-28,"3 - 1008",167,208,166,1,41,0.994011976047904
"293",2021-02-28,"16 - 1022",50,50,49,1,0,0.98
"294",2021-02-28,"24 - 1150",170,173,163,7,3,0.958823529411765
"295",2021-02-28,"24 - 1153",125,125,125,0,0,1
"296",2021-03-01,"62 - 1011",52,61,50,2,9,0.961538461538462
"297",2021-03-01,"3 - 1008",167,208,167,0,41,1
"298",2021-03-01,"16 - 1022",49,50,48,1,1,0.979591836734694
"299",2021-03-01,"24 - 1150",172,173,163,9,1,0.947674418604651
"300",2021-03-01,"24 - 1153",175,175,138,37,0,0.788571428571429
"301",2021-03-02,"62 - 1011",54,61,50,4,7,0.925925925925926
"302",2021-03-02,"3 - 1008",167,208,166,1,41,0.994011976047904
"303",2021-03-02,"16 - 1022",47,50,46,1,3,0.978723404255319
"304",2021-03-02,"24 - 1150",173,173,157,16,0,0.907514450867052
"305",2021-03-02,"24 - 1153",174,175,155,19,1,0.890804597701149
"306",2021-03-03,"62 - 1011",54,61,51,3,7,0.944444444444444
"307",2021-03-03,"3 - 1008",165,208,163,2,43,0.987878787878788
"308",2021-03-03,"16 - 1022",46,50,45,1,4,0.978260869565217
"309",2021-03-03,"24 - 1150",173,173,155,18,0,0.895953757225434
"310",2021-03-03,"24 - 1153",174,175,156,18,1,0.896551724137931
"311",2021-03-04,"62 - 1011",54,61,50,4,7,0.925925925925926
"312",2021-03-04,"3 - 1008",165,208,163,2,43,0.987878787878788
"313",2021-03-04,"16 - 1022",46,50,45,1,4,0.978260869565217
"314",2021-03-04,"24 - 1150",173,173,155,18,0,0.895953757225434
"315",2021-03-04,"24 - 1153",174,175,172,2,1,0.988505747126437
"316",2021-03-05,"62 - 1011",54,61,50,4,7,0.925925925925926
"317",2021-03-05,"3 - 1008",167,208,164,3,41,0.982035928143713
"318",2021-03-05,"16 - 1022",47,50,44,3,3,0.936170212765957
"319",2021-03-05,"24 - 1150",173,173,155,18,0,0.895953757225434
"320",2021-03-05,"24 - 1153",173,175,173,0,2,1
"321",2021-03-06,"62 - 1011",58,61,47,11,3,0.810344827586207
"322",2021-03-06,"3 - 1008",167,208,164,3,41,0.982035928143713
"323",2021-03-06,"16 - 1022",47,50,44,3,3,0.936170212765957
"324",2021-03-06,"24 - 1150",173,173,158,15,0,0.913294797687861
"325",2021-03-06,"24 - 1153",169,175,169,0,6,1
"326",2021-03-07,"62 - 1011",58,61,47,11,3,0.810344827586207
"327",2021-03-07,"3 - 1008",167,208,164,3,41,0.982035928143713
"328",2021-03-07,"16 - 1022",46,50,43,3,4,0.934782608695652
"329",2021-03-07,"24 - 1150",173,173,157,16,0,0.907514450867052
"330",2021-03-07,"24 - 1153",167,175,165,2,8,0.988023952095808
"331",2021-03-08,"62 - 1011",59,61,48,11,2,0.813559322033898
"332",2021-03-08,"3 - 1008",167,208,164,3,41,0.982035928143713
"333",2021-03-08,"16 - 1022",50,50,45,5,0,0.9
"334",2021-03-08,"24 - 1150",173,173,162,11,0,0.936416184971098
"335",2021-03-08,"24 - 1153",157,175,155,2,18,0.987261146496815
"336",2021-03-09,"62 - 1011",60,61,48,12,1,0.8
"337",2021-03-09,"3 - 1008",167,208,164,3,41,0.982035928143713
"338",2021-03-09,"16 - 1022",50,50,47,3,0,0.94
"339",2021-03-09,"24 - 1150",173,173,166,7,0,0.959537572254335
"340",2021-03-09,"24 - 1153",131,175,127,4,44,0.969465648854962
"341",2021-03-10,"62 - 1011",60,61,51,9,1,0.85
"342",2021-03-10,"3 - 1008",167,208,164,3,41,0.982035928143713
"343",2021-03-10,"16 - 1022",50,50,48,2,0,0.96
"344",2021-03-10,"24 - 1150",173,173,165,8,0,0.953757225433526
"345",2021-03-10,"24 - 1153",115,175,115,0,60,1
"346",2021-03-11,"62 - 1011",60,61,54,6,1,0.9
"347",2021-03-11,"3 - 1008",167,208,163,4,41,0.976047904191617
"348",2021-03-11,"16 - 1022",50,50,46,4,0,0.92
"349",2021-03-11,"24 - 1150",173,173,164,9,0,0.947976878612717
"350",2021-03-11,"24 - 1153",110,175,110,0,65,1
"351",2021-03-12,"62 - 1011",60,61,54,6,1,0.9
"352",2021-03-12,"3 - 1008",167,208,163,4,41,0.976047904191617
"353",2021-03-12,"16 - 1022",50,50,48,2,0,0.96
"354",2021-03-12,"24 - 1150",171,173,165,6,2,0.964912280701754
"355",2021-03-12,"24 - 1153",146,175,120,26,29,0.821917808219178
"356",2021-03-13,"62 - 1011",60,61,56,4,1,0.933333333333333
"357",2021-03-13,"3 - 1008",167,208,160,7,41,0.958083832335329
"358",2021-03-13,"16 - 1022",50,50,48,2,0,0.96
"359",2021-03-13,"24 - 1150",171,173,166,5,2,0.970760233918129
"360",2021-03-13,"24 - 1153",145,175,136,9,30,0.937931034482759
"361",2021-03-14,"62 - 1011",60,61,55,5,1,0.916666666666667
"362",2021-03-14,"3 - 1008",160,208,160,0,48,1
"363",2021-03-14,"16 - 1022",50,50,48,2,0,0.96
"364",2021-03-14,"24 - 1150",172,173,171,1,1,0.994186046511628
"365",2021-03-14,"24 - 1153",128,175,122,6,47,0.953125
"366",2021-03-15,"62 - 1011",60,61,54,6,1,0.9
"367",2021-03-15,"3 - 1008",160,208,160,0,48,1
"368",2021-03-15,"16 - 1022",50,50,50,0,0,1
"369",2021-03-15,"24 - 1150",162,173,162,0,11,1
"370",2021-03-15,"24 - 1153",126,175,125,1,49,0.992063492063492
"371",2021-03-16,"62 - 1011",60,61,56,4,1,0.933333333333333
"372",2021-03-16,"3 - 1008",160,208,160,0,48,1
"373",2021-03-16,"16 - 1022",50,50,47,3,0,0.94
"374",2021-03-16,"24 - 1150",157,173,157,0,16,1
"375",2021-03-16,"24 - 1153",114,175,114,0,61,1
"376",2021-03-17,"62 - 1011",60,61,58,2,1,0.966666666666667
"377",2021-03-17,"3 - 1008",160,208,158,2,48,0.9875
"378",2021-03-17,"16 - 1022",50,50,49,1,0,0.98
"379",2021-03-17,"24 - 1150",148,173,148,0,25,1
"380",2021-03-17,"24 - 1153",98,175,97,1,77,0.989795918367347
"381",2021-03-18,"62 - 1011",60,61,58,2,1,0.966666666666667
"382",2021-03-18,"3 - 1008",160,208,158,2,48,0.9875
"383",2021-03-18,"16 - 1022",50,50,46,4,0,0.92
"384",2021-03-18,"24 - 1150",145,173,145,0,28,1
"385",2021-03-18,"24 - 1153",84,175,84,0,91,1
"386",2021-03-19,"62 - 1011",60,61,59,1,1,0.983333333333333
"387",2021-03-19,"3 - 1008",159,208,157,2,49,0.987421383647799
"388",2021-03-19,"16 - 1022",50,50,47,3,0,0.94
"389",2021-03-19,"24 - 1150",135,173,135,0,38,1
"390",2021-03-19,"24 - 1153",77,175,77,0,98,1
"391",2021-03-20,"62 - 1011",60,61,59,1,1,0.983333333333333
"392",2021-03-20,"3 - 1008",158,208,156,2,50,0.987341772151899
"393",2021-03-20,"16 - 1022",50,50,46,4,0,0.92
"394",2021-03-20,"24 - 1150",125,173,125,0,48,1
"395",2021-03-20,"24 - 1153",75,175,72,3,100,0.96
"396",2021-03-21,"62 - 1011",60,61,60,0,1,1
"397",2021-03-21,"3 - 1008",158,208,157,1,50,0.993670886075949
"398",2021-03-21,"16 - 1022",50,50,46,4,0,0.92
"399",2021-03-21,"24 - 1150",121,173,121,0,52,1
"400",2021-03-21,"24 - 1153",70,175,70,0,105,1
"401",2021-03-22,"62 - 1011",60,61,60,0,1,1
"402",2021-03-22,"3 - 1008",157,208,156,1,51,0.993630573248408
"403",2021-03-22,"16 - 1022",50,50,46,4,0,0.92
"404",2021-03-22,"24 - 1150",115,173,115,0,58,1
"405",2021-03-22,"24 - 1153",66,175,66,0,109,1
"406",2021-03-23,"62 - 1011",60,61,59,1,1,0.983333333333333
"407",2021-03-23,"3 - 1008",156,208,155,1,52,0.993589743589744
"408",2021-03-23,"16 - 1022",50,50,46,4,0,0.92
"409",2021-03-23,"24 - 1150",110,173,110,0,63,1
"410",2021-03-23,"24 - 1153",67,125,67,0,58,1
"411",2021-03-24,"62 - 1011",60,61,59,1,1,0.983333333333333
"412",2021-03-24,"3 - 1008",157,208,155,2,51,0.987261146496815
"413",2021-03-24,"16 - 1022",49,50,47,2,1,0.959183673469388
"414",2021-03-24,"24 - 1150",106,173,106,0,67,1
"415",2021-03-24,"24 - 1153",76,125,76,0,49,1
"416",2021-03-25,"62 - 1011",60,61,58,2,1,0.966666666666667
"417",2021-03-25,"3 - 1008",158,208,155,3,50,0.981012658227848
"418",2021-03-25,"16 - 1022",49,50,46,3,1,0.938775510204082
"419",2021-03-25,"24 - 1150",92,173,92,0,81,1
"420",2021-03-25,"24 - 1153",83,175,80,3,92,0.963855421686747
"421",2021-03-26,"62 - 1011",60,61,60,0,1,1
"422",2021-03-26,"3 - 1008",159,208,156,3,49,0.981132075471698
"423",2021-03-26,"16 - 1022",49,50,48,1,1,0.979591836734694
"424",2021-03-26,"24 - 1150",89,173,89,0,84,1
"425",2021-03-26,"24 - 1153",78,175,78,0,97,1
"426",2021-03-27,"62 - 1011",60,61,60,0,1,1
"427",2021-03-27,"3 - 1008",159,208,156,3,49,0.981132075471698
"428",2021-03-27,"16 - 1022",49,50,49,0,1,1
"429",2021-03-27,"24 - 1150",88,173,88,0,85,1
"430",2021-03-27,"24 - 1153",87,175,86,1,88,0.988505747126437
"431",2021-03-28,"62 - 1011",60,61,59,1,1,0.983333333333333
"432",2021-03-28,"3 - 1008",159,208,156,3,49,0.981132075471698
"433",2021-03-28,"16 - 1022",49,50,49,0,1,1
"434",2021-03-28,"24 - 1150",87,173,87,0,86,1
"435",2021-03-28,"24 - 1153",92,175,92,0,83,1
"436",2021-03-29,"62 - 1011",60,61,59,1,1,0.983333333333333
"437",2021-03-29,"3 - 1008",168,208,165,3,40,0.982142857142857
"438",2021-03-29,"16 - 1022",49,50,48,1,1,0.979591836734694
"439",2021-03-29,"24 - 1150",87,173,87,0,86,1
"440",2021-03-29,"24 - 1153",91,175,91,0,84,1
"441",2021-03-30,"62 - 1011",60,61,59,1,1,0.983333333333333
"442",2021-03-30,"3 - 1008",171,208,168,3,37,0.982456140350877
"443",2021-03-30,"16 - 1022",50,50,47,3,0,0.94
"444",2021-03-30,"24 - 1150",85,173,85,0,88,1
"445",2021-03-30,"24 - 1153",95,175,95,0,80,1
"446",2021-03-31,"62 - 1011",60,61,60,0,1,1
"447",2021-03-31,"3 - 1008",174,208,169,5,34,0.971264367816092
"448",2021-03-31,"16 - 1022",50,50,49,1,0,0.98
"449",2021-03-31,"24 - 1150",81,173,81,0,92,1
"450",2021-03-31,"24 - 1153",93,175,92,1,82,0.989247311827957
"451",2021-04-01,"62 - 1011",60,61,59,1,1,0.983333333333333
"452",2021-04-01,"3 - 1008",180,208,179,1,28,0.994444444444444
"453",2021-04-01,"16 - 1022",50,50,48,2,0,0.96
"454",2021-04-01,"24 - 1150",80,173,80,0,93,1
"455",2021-04-01,"24 - 1153",86,175,86,0,89,1
"456",2021-04-02,"62 - 1011",60,61,59,1,1,0.983333333333333
"457",2021-04-02,"3 - 1008",184,208,179,5,24,0.972826086956522
"458",2021-04-02,"16 - 1022",50,50,48,2,0,0.96
"459",2021-04-02,"24 - 1150",80,173,80,0,93,1
"460",2021-04-02,"24 - 1153",87,175,87,0,88,1
"461",2021-04-03,"62 - 1011",60,61,59,1,1,0.983333333333333
"462",2021-04-03,"3 - 1008",187,208,185,2,21,0.989304812834225
"463",2021-04-03,"16 - 1022",50,50,47,3,0,0.94
"464",2021-04-03,"24 - 1150",80,173,80,0,93,1
"465",2021-04-03,"24 - 1153",84,125,84,0,41,1
"466",2021-04-04,"62 - 1011",60,61,59,1,1,0.983333333333333
"467",2021-04-04,"3 - 1008",186,208,183,3,22,0.983870967741935
"468",2021-04-04,"16 - 1022",50,50,48,2,0,0.96
"469",2021-04-04,"24 - 1150",84,173,84,0,89,1
"470",2021-04-04,"24 - 1153",84,125,84,0,41,1
"471",2021-04-05,"62 - 1011",60,61,59,1,1,0.983333333333333
"472",2021-04-05,"3 - 1008",186,208,182,4,22,0.978494623655914
"473",2021-04-05,"16 - 1022",50,50,46,4,0,0.92
"474",2021-04-05,"24 - 1150",86,173,86,0,87,1
"475",2021-04-05,"24 - 1153",84,125,84,0,41,1
"476",2021-04-06,"62 - 1011",59,61,56,3,2,0.949152542372881
"477",2021-04-06,"3 - 1008",185,186,174,11,1,0.940540540540541
"478",2021-04-06,"16 - 1022",50,50,46,4,0,0.92
"479",2021-04-06,"24 - 1150",84,173,84,0,89,1
"480",2021-04-06,"24 - 1153",82,125,82,0,43,1
"481",2021-04-07,"62 - 1011",60,61,57,3,1,0.95
"482",2021-04-07,"3 - 1008",183,186,168,15,3,0.918032786885246
"483",2021-04-07,"16 - 1022",50,50,47,3,0,0.94
"484",2021-04-07,"24 - 1150",77,173,77,0,96,1
"485",2021-04-07,"24 - 1153",83,125,83,0,42,1
"486",2021-04-08,"62 - 1011",60,61,60,0,1,1
"487",2021-04-08,"3 - 1008",183,186,165,18,3,0.901639344262295
"488",2021-04-08,"16 - 1022",49,50,49,0,1,1
"489",2021-04-08,"24 - 1150",72,173,72,0,101,1
"490",2021-04-08,"24 - 1153",83,125,83,0,42,1
"491",2021-04-09,"62 - 1011",60,61,59,1,1,0.983333333333333
"492",2021-04-09,"3 - 1008",166,186,165,1,20,0.993975903614458
"493",2021-04-09,"16 - 1022",47,50,47,0,3,1
"494",2021-04-09,"24 - 1150",72,173,72,0,101,1
"495",2021-04-09,"24 - 1153",83,125,83,0,42,1
"496",2021-04-10,"62 - 1011",60,61,59,1,1,0.983333333333333
"497",2021-04-10,"3 - 1008",166,186,165,1,20,0.993975903614458
"498",2021-04-10,"16 - 1022",46,50,46,0,4,1
"499",2021-04-10,"24 - 1150",75,173,75,0,98,1
"500",2021-04-10,"24 - 1153",82,125,82,0,43,1
"501",2021-04-11,"62 - 1011",60,61,58,2,1,0.966666666666667
"502",2021-04-11,"3 - 1008",166,186,164,2,20,0.987951807228916
"503",2021-04-11,"16 - 1022",46,50,45,1,4,0.978260869565217
"504",2021-04-11,"24 - 1150",76,173,76,0,97,1
"505",2021-04-11,"24 - 1153",82,125,82,0,43,1
"506",2021-04-12,"62 - 1011",60,61,58,2,1,0.966666666666667
"507",2021-04-12,"3 - 1008",164,186,163,1,22,0.99390243902439
"508",2021-04-12,"16 - 1022",44,50,43,1,6,0.977272727272727
"509",2021-04-12,"24 - 1150",74,173,74,0,99,1
"510",2021-04-12,"24 - 1153",82,125,80,2,43,0.975609756097561
"511",2021-04-13,"62 - 1011",60,61,59,1,1,0.983333333333333
"512",2021-04-13,"3 - 1008",164,186,163,1,22,0.99390243902439
"513",2021-04-13,"16 - 1022",42,50,40,2,8,0.952380952380952
"514",2021-04-13,"24 - 1150",71,173,71,0,102,1
"515",2021-04-13,"24 - 1153",80,125,80,0,45,1
"516",2021-04-14,"62 - 1011",60,61,59,1,1,0.983333333333333
"517",2021-04-14,"3 - 1008",163,186,161,2,23,0.987730061349693
"518",2021-04-14,"16 - 1022",40,50,39,1,10,0.975
"519",2021-04-14,"24 - 1150",73,173,73,0,100,1
"520",2021-04-14,"24 - 1153",80,125,79,1,45,0.9875
"521",2021-04-15,"62 - 1011",60,61,59,1,1,0.983333333333333
"522",2021-04-15,"3 - 1008",168,186,161,7,18,0.958333333333333
"523",2021-04-15,"16 - 1022",40,50,39,1,10,0.975
"524",2021-04-15,"24 - 1150",73,173,73,0,100,1
"525",2021-04-15,"24 - 1153",79,125,79,0,46,1
"526",2021-04-16,"62 - 1011",61,61,60,1,0,0.983606557377049
"527",2021-04-16,"3 - 1008",178,208,170,8,30,0.955056179775281
"528",2021-04-16,"16 - 1022",40,50,38,2,10,0.95
"529",2021-04-16,"24 - 1150",73,173,73,0,100,1
"530",2021-04-16,"24 - 1153",77,125,77,0,48,1
"531",2021-04-17,"62 - 1011",60,61,59,1,1,0.983333333333333
"532",2021-04-17,"3 - 1008",187,208,174,13,21,0.93048128342246
"533",2021-04-17,"16 - 1022",40,50,38,2,10,0.95
"534",2021-04-17,"24 - 1150",73,173,73,0,100,1
"535",2021-04-17,"24 - 1153",142,172,124,18,30,0.873239436619718
"536",2021-04-18,"62 - 1011",59,61,59,0,2,1
"537",2021-04-18,"3 - 1008",188,208,181,7,20,0.962765957446808
"538",2021-04-18,"16 - 1022",39,50,37,2,11,0.948717948717949
"539",2021-04-18,"24 - 1150",72,173,71,1,101,0.986111111111111
"540",2021-04-18,"24 - 1153",143,172,136,7,29,0.951048951048951
"541",2021-04-19,"62 - 1011",59,61,58,1,2,0.983050847457627
"542",2021-04-19,"3 - 1008",185,208,182,3,23,0.983783783783784
"543",2021-04-19,"16 - 1022",39,50,37,2,11,0.948717948717949
"544",2021-04-19,"24 - 1150",72,173,72,0,101,1
"545",2021-04-19,"24 - 1153",142,172,140,2,30,0.985915492957746
"546",2021-04-20,"62 - 1011",59,61,58,1,2,0.983050847457627
"547",2021-04-20,"3 - 1008",185,208,180,5,23,0.972972972972973
"548",2021-04-20,"16 - 1022",39,50,35,4,11,0.897435897435897
"549",2021-04-20,"24 - 1150",73,173,73,0,100,1
"550",2021-04-20,"24 - 1153",140,172,140,0,32,1
"551",2021-04-21,"62 - 1011",59,61,57,2,2,0.966101694915254
"552",2021-04-21,"3 - 1008",184,208,176,8,24,0.956521739130435
"553",2021-04-21,"16 - 1022",37,50,35,2,13,0.945945945945946
"554",2021-04-21,"24 - 1150",72,173,72,0,101,1
"555",2021-04-21,"24 - 1153",140,172,136,4,32,0.971428571428571
"556",2021-04-22,"62 - 1011",59,61,57,2,2,0.966101694915254
"557",2021-04-22,"3 - 1008",181,208,172,9,27,0.950276243093923
"558",2021-04-22,"16 - 1022",37,50,35,2,13,0.945945945945946
"559",2021-04-22,"24 - 1150",72,173,72,0,101,1
"560",2021-04-22,"24 - 1153",140,172,140,0,32,1
"561",2021-04-23,"62 - 1011",59,61,57,2,2,0.966101694915254
"562",2021-04-23,"3 - 1008",181,208,173,8,27,0.955801104972376
"563",2021-04-23,"16 - 1022",32,50,32,0,18,1
"564",2021-04-23,"24 - 1150",71,173,71,0,102,1
"565",2021-04-23,"24 - 1153",141,172,141,0,31,1
"566",2021-04-24,"62 - 1011",59,61,57,2,2,0.966101694915254
"567",2021-04-24,"3 - 1008",181,208,173,8,27,0.955801104972376
"568",2021-04-24,"16 - 1022",32,50,31,1,18,0.96875
"569",2021-04-24,"24 - 1150",73,173,73,0,100,1
"570",2021-04-24,"24 - 1153",139,172,139,0,33,1
"571",2021-04-25,"62 - 1011",59,61,57,2,2,0.966101694915254
"572",2021-04-25,"3 - 1008",181,208,173,8,27,0.955801104972376
"573",2021-04-25,"16 - 1022",32,50,32,0,18,1
"574",2021-04-25,"24 - 1150",73,173,73,0,100,1
"575",2021-04-25,"24 - 1153",139,172,137,2,33,0.985611510791367
"576",2021-04-26,"62 - 1011",59,61,56,3,2,0.949152542372881
"577",2021-04-26,"3 - 1008",177,208,169,8,31,0.954802259887006
"578",2021-04-26,"16 - 1022",34,50,33,1,16,0.970588235294118
"579",2021-04-26,"24 - 1150",74,173,74,0,99,1
"580",2021-04-26,"24 - 1153",139,172,139,0,33,1
"581",2021-04-27,"62 - 1011",59,61,55,4,2,0.932203389830508
"582",2021-04-27,"3 - 1008",167,208,167,0,41,1
"583",2021-04-27,"16 - 1022",34,50,33,1,16,0.970588235294118
"584",2021-04-27,"24 - 1150",73,173,73,0,100,1
"585",2021-04-27,"24 - 1153",139,172,138,1,33,0.992805755395683
"586",2021-04-28,"62 - 1011",59,61,55,4,2,0.932203389830508
"587",2021-04-28,"3 - 1008",166,208,166,0,42,1
"588",2021-04-28,"16 - 1022",33,50,32,1,17,0.96969696969697
"589",2021-04-28,"24 - 1150",74,173,74,0,99,1
"590",2021-04-28,"24 - 1153",137,172,136,1,35,0.992700729927007
"591",2021-04-29,"62 - 1011",59,61,53,6,2,0.898305084745763
"592",2021-04-29,"3 - 1008",162,208,161,1,46,0.993827160493827
"593",2021-04-29,"16 - 1022",31,50,31,0,19,1
"594",2021-04-29,"24 - 1150",146,173,97,49,27,0.664383561643836
"595",2021-04-29,"24 - 1153",139,172,139,0,33,1
"596",2021-04-30,"62 - 1011",59,61,53,6,2,0.898305084745763
"597",2021-04-30,"3 - 1008",166,208,157,9,42,0.94578313253012
"598",2021-04-30,"16 - 1022",31,50,31,0,19,1
"599",2021-04-30,"24 - 1150",167,173,113,54,6,0.676646706586826
"600",2021-04-30,"24 - 1153",139,172,138,1,33,0.992805755395683
"601",2021-05-01,"62 - 1011",59,61,52,7,2,0.88135593220339
"602",2021-05-01,"3 - 1008",165,208,157,8,43,0.951515151515152
"603",2021-05-01,"16 - 1022",29,50,29,0,21,1
"604",2021-05-01,"24 - 1150",169,173,123,46,4,0.727810650887574
"605",2021-05-01,"24 - 1153",139,172,138,1,33,0.992805755395683
"606",2021-05-02,"62 - 1011",59,61,51,8,2,0.864406779661017
"607",2021-05-02,"3 - 1008",165,208,155,10,43,0.93939393939394
"608",2021-05-02,"16 - 1022",29,50,29,0,21,1
"609",2021-05-02,"24 - 1150",170,173,131,39,3,0.770588235294118
"610",2021-05-02,"24 - 1153",139,172,137,2,33,0.985611510791367
"611",2021-05-03,"62 - 1011",59,61,51,8,2,0.864406779661017
"612",2021-05-03,"3 - 1008",158,208,154,4,50,0.974683544303797
"613",2021-05-03,"16 - 1022",29,50,28,1,21,0.96551724137931
"614",2021-05-03,"24 - 1150",171,173,133,38,2,0.777777777777778
"615",2021-05-03,"24 - 1153",140,172,137,3,32,0.978571428571429
"616",2021-05-04,"62 - 1011",59,61,52,7,2,0.88135593220339
"617",2021-05-04,"3 - 1008",158,208,152,6,50,0.962025316455696
"618",2021-05-04,"16 - 1022",29,50,28,1,21,0.96551724137931
"619",2021-05-04,"24 - 1150",132,173,132,0,41,1
"620",2021-05-04,"24 - 1153",140,172,140,0,32,1
"621",2021-05-05,"62 - 1011",59,61,51,8,2,0.864406779661017
"622",2021-05-05,"3 - 1008",158,208,152,6,50,0.962025316455696
"623",2021-05-05,"16 - 1022",30,50,29,1,20,0.966666666666667
"624",2021-05-05,"24 - 1150",126,173,126,0,47,1
"625",2021-05-05,"24 - 1153",140,172,140,0,32,1
"626",2021-05-06,"62 - 1011",59,61,53,6,2,0.898305084745763
"627",2021-05-06,"3 - 1008",167,201,150,17,34,0.898203592814371
"628",2021-05-06,"16 - 1022",29,50,26,3,21,0.896551724137931
"629",2021-05-06,"24 - 1150",121,173,121,0,52,1
"630",2021-05-06,"24 - 1153",140,172,140,0,32,1
"631",2021-05-07,"62 - 1011",59,61,54,5,2,0.915254237288136
"632",2021-05-07,"3 - 1008",168,201,157,11,33,0.93452380952381
"633",2021-05-07,"16 - 1022",50,50,44,6,0,0.88
"634",2021-05-07,"24 - 1150",112,173,112,0,61,1
"635",2021-05-07,"24 - 1153",141,172,141,0,31,1
"636",2021-05-08,"62 - 1011",59,61,53,6,2,0.898305084745763
"637",2021-05-08,"3 - 1008",169,201,161,8,32,0.952662721893491
"638",2021-05-08,"16 - 1022",50,50,44,6,0,0.88
"639",2021-05-08,"24 - 1150",112,173,111,1,61,0.991071428571429
"640",2021-05-08,"24 - 1153",141,172,140,1,31,0.99290780141844
"641",2021-05-09,"62 - 1011",59,61,54,5,2,0.915254237288136
"642",2021-05-09,"3 - 1008",169,201,159,10,32,0.940828402366864
"643",2021-05-09,"16 - 1022",50,50,43,7,0,0.86
"644",2021-05-09,"24 - 1150",171,173,121,50,2,0.707602339181287
"645",2021-05-09,"24 - 1153",140,172,137,3,32,0.978571428571429
"646",2021-05-10,"62 - 1011",59,61,55,4,2,0.932203389830508
"647",2021-05-10,"3 - 1008",166,201,159,7,35,0.957831325301205
"648",2021-05-10,"16 - 1022",49,50,45,4,1,0.918367346938776
"649",2021-05-10,"24 - 1150",173,173,131,42,0,0.757225433526012
"650",2021-05-10,"24 - 1153",124,125,123,1,1,0.991935483870968
"651",2021-05-11,"62 - 1011",59,61,55,4,2,0.932203389830508
"652",2021-05-11,"3 - 1008",168,201,159,9,33,0.946428571428571
"653",2021-05-11,"16 - 1022",50,50,40,10,0,0.8
"654",2021-05-11,"24 - 1150",173,173,130,43,0,0.751445086705202
"655",2021-05-11,"24 - 1153",124,125,122,2,1,0.983870967741935
"656",2021-05-12,"62 - 1011",59,61,55,4,2,0.932203389830508
"657",2021-05-12,"3 - 1008",168,201,158,10,33,0.94047619047619
"658",2021-05-12,"16 - 1022",50,50,46,4,0,0.92
"659",2021-05-12,"24 - 1150",173,173,135,38,0,0.780346820809249
"660",2021-05-12,"24 - 1153",124,125,124,0,1,1
"661",2021-05-13,"62 - 1011",59,61,55,4,2,0.932203389830508
"662",2021-05-13,"3 - 1008",168,201,157,11,33,0.93452380952381
"663",2021-05-13,"16 - 1022",50,50,44,6,0,0.88
"664",2021-05-13,"24 - 1150",173,173,136,37,0,0.786127167630058
"665",2021-05-13,"24 - 1153",124,125,120,4,1,0.967741935483871
"666",2021-05-14,"62 - 1011",59,61,56,3,2,0.949152542372881
"667",2021-05-14,"3 - 1008",168,201,158,10,33,0.94047619047619
"668",2021-05-14,"16 - 1022",50,50,46,4,0,0.92
"669",2021-05-14,"24 - 1150",172,173,128,44,1,0.744186046511628
"670",2021-05-14,"24 - 1153",124,125,117,7,1,0.943548387096774
"671",2021-05-15,"62 - 1011",60,61,58,2,1,0.966666666666667
"672",2021-05-15,"3 - 1008",168,201,157,11,33,0.93452380952381
"673",2021-05-15,"16 - 1022",50,50,45,5,0,0.9
"674",2021-05-15,"24 - 1150",173,173,130,43,0,0.751445086705202
"675",2021-05-15,"24 - 1153",124,125,118,6,1,0.951612903225806
"676",2021-05-16,"62 - 1011",60,61,59,1,1,0.983333333333333
"677",2021-05-16,"3 - 1008",167,201,161,6,34,0.964071856287425
"678",2021-05-16,"16 - 1022",50,50,45,5,0,0.9
"679",2021-05-16,"24 - 1150",173,173,137,36,0,0.791907514450867
"680",2021-05-16,"24 - 1153",120,125,119,1,5,0.991666666666667
"681",2021-05-17,"62 - 1011",60,61,59,1,1,0.983333333333333
"682",2021-05-17,"3 - 1008",168,201,160,8,33,0.952380952380952
"683",2021-05-17,"16 - 1022",50,50,45,5,0,0.9
"684",2021-05-17,"24 - 1150",173,173,134,39,0,0.774566473988439
"685",2021-05-17,"24 - 1153",116,125,116,0,9,1
"686",2021-05-18,"62 - 1011",60,61,59,1,1,0.983333333333333
"687",2021-05-18,"3 - 1008",168,201,157,11,33,0.93452380952381
"688",2021-05-18,"16 - 1022",50,50,45,5,0,0.9
"689",2021-05-18,"24 - 1150",173,173,140,33,0,0.809248554913295
"690",2021-05-18,"24 - 1153",111,125,111,0,14,1
"691",2021-05-19,"62 - 1011",60,61,59,1,1,0.983333333333333
"692",2021-05-19,"3 - 1008",167,201,156,11,34,0.934131736526946
"693",2021-05-19,"16 - 1022",50,50,45,5,0,0.9
"694",2021-05-19,"24 - 1150",173,173,134,39,0,0.774566473988439
"695",2021-05-19,"24 - 1153",110,125,110,0,15,1
"696",2021-05-20,"62 - 1011",60,61,59,1,1,0.983333333333333
"697",2021-05-20,"3 - 1008",165,201,155,10,36,0.93939393939394
"698",2021-05-20,"16 - 1022",50,50,44,6,0,0.88
"699",2021-05-20,"24 - 1150",173,173,141,32,0,0.815028901734104
"700",2021-05-20,"24 - 1153",108,125,108,0,17,1
"701",2021-05-21,"62 - 1011",60,61,57,3,1,0.95
"702",2021-05-21,"3 - 1008",166,201,155,11,35,0.933734939759036
"703",2021-05-21,"16 - 1022",50,50,41,9,0,0.82
"704",2021-05-21,"24 - 1150",173,173,137,36,0,0.791907514450867
"705",2021-05-21,"24 - 1153",106,125,106,0,19,1
"706",2021-05-22,"62 - 1011",60,61,57,3,1,0.95
"707",2021-05-22,"3 - 1008",166,201,155,11,35,0.933734939759036
"708",2021-05-22,"16 - 1022",50,50,43,7,0,0.86
"709",2021-05-22,"24 - 1150",173,173,140,33,0,0.809248554913295
"710",2021-05-22,"24 - 1153",105,125,105,0,20,1
"711",2021-05-23,"62 - 1011",60,61,57,3,1,0.95
"712",2021-05-23,"3 - 1008",165,201,155,10,36,0.93939393939394
"713",2021-05-23,"16 - 1022",50,50,43,7,0,0.86
"714",2021-05-23,"24 - 1150",173,173,142,31,0,0.820809248554913
"715",2021-05-23,"24 - 1153",103,125,103,0,22,1
"716",2021-05-24,"62 - 1011",60,61,57,3,1,0.95
"717",2021-05-24,"3 - 1008",165,201,155,10,36,0.93939393939394
"718",2021-05-24,"16 - 1022",50,50,41,9,0,0.82
"719",2021-05-24,"24 - 1150",173,173,145,28,0,0.838150289017341
"720",2021-05-24,"24 - 1153",102,125,102,0,23,1
"721",2021-05-25,"62 - 1011",60,61,57,3,1,0.95
"722",2021-05-25,"3 - 1008",165,201,155,10,36,0.93939393939394
"723",2021-05-25,"16 - 1022",50,50,43,7,0,0.86
"724",2021-05-25,"24 - 1150",173,173,145,28,0,0.838150289017341
"725",2021-05-25,"24 - 1153",125,125,109,16,0,0.872
"726",2021-05-26,"62 - 1011",60,61,57,3,1,0.95
"727",2021-05-26,"3 - 1008",165,201,155,10,36,0.93939393939394
"728",2021-05-26,"16 - 1022",50,50,49,1,0,0.98
"729",2021-05-26,"24 - 1150",173,173,147,26,0,0.84971098265896
"730",2021-05-26,"24 - 1153",125,125,112,13,0,0.896
"731",2021-05-27,"62 - 1011",60,61,57,3,1,0.95
"732",2021-05-27,"3 - 1008",169,201,158,11,32,0.93491124260355
"733",2021-05-27,"16 - 1022",50,50,49,1,0,0.98
"734",2021-05-27,"24 - 1150",172,173,143,29,1,0.831395348837209
"735",2021-05-27,"24 - 1153",125,125,115,10,0,0.92
"736",2021-05-28,"62 - 1011",60,61,58,2,1,0.966666666666667
"737",2021-05-28,"3 - 1008",171,201,161,10,30,0.941520467836257
"738",2021-05-28,"16 - 1022",50,50,49,1,0,0.98
"739",2021-05-28,"24 - 1150",172,173,144,28,1,0.837209302325581
"740",2021-05-28,"24 - 1153",125,125,124,1,0,0.992
"741",2021-05-29,"62 - 1011",60,61,58,2,1,0.966666666666667
"742",2021-05-29,"3 - 1008",171,201,161,10,30,0.941520467836257
"743",2021-05-29,"16 - 1022",50,50,48,2,0,0.96
"744",2021-05-29,"24 - 1150",172,173,145,27,1,0.843023255813954
"745",2021-05-29,"24 - 1153",125,125,122,3,0,0.976
"746",2021-05-30,"62 - 1011",60,61,57,3,1,0.95
"747",2021-05-30,"3 - 1008",172,201,163,9,29,0.947674418604651
"748",2021-05-30,"16 - 1022",47,50,45,2,3,0.957446808510638
"749",2021-05-30,"24 - 1150",173,173,140,33,0,0.809248554913295
"750",2021-05-30,"24 - 1153",125,125,123,2,0,0.984
"751",2021-05-31,"62 - 1011",60,61,58,2,1,0.966666666666667
"752",2021-05-31,"3 - 1008",171,201,164,7,30,0.95906432748538
"753",2021-05-31,"16 - 1022",47,50,41,6,3,0.872340425531915
"754",2021-05-31,"24 - 1150",173,173,143,30,0,0.826589595375723
"755",2021-05-31,"24 - 1153",125,125,121,4,0,0.968
"756",2021-06-01,"62 - 1011",60,61,58,2,1,0.966666666666667
"757",2021-06-01,"3 - 1008",171,201,165,6,30,0.964912280701754
"758",2021-06-01,"16 - 1022",45,50,35,10,5,0.777777777777778
"759",2021-06-01,"24 - 1150",173,173,142,31,0,0.820809248554913
"760",2021-06-01,"24 - 1153",125,125,123,2,0,0.984
"761",2021-06-02,"62 - 1011",60,61,58,2,1,0.966666666666667
"762",2021-06-02,"3 - 1008",170,201,165,5,31,0.970588235294118
"763",2021-06-02,"16 - 1022",40,50,34,6,10,0.85
"764",2021-06-02,"24 - 1150",173,173,140,33,0,0.809248554913295
"765",2021-06-02,"24 - 1153",125,125,121,4,0,0.968
"766",2021-06-03,"62 - 1011",60,61,57,3,1,0.95
"767",2021-06-03,"3 - 1008",169,201,158,11,32,0.93491124260355
"768",2021-06-03,"16 - 1022",38,50,32,6,12,0.842105263157895
"769",2021-06-03,"24 - 1150",173,173,139,34,0,0.803468208092486
"770",2021-06-03,"24 - 1153",125,125,121,4,0,0.968
"771",2021-06-04,"62 - 1011",60,61,56,4,1,0.933333333333333
"772",2021-06-04,"3 - 1008",171,201,163,8,30,0.953216374269006
"773",2021-06-04,"16 - 1022",39,50,31,8,11,0.794871794871795
"774",2021-06-04,"24 - 1150",173,173,135,38,0,0.780346820809249
"775",2021-06-04,"24 - 1153",125,125,124,1,0,0.992
"776",2021-06-05,"62 - 1011",60,61,55,5,1,0.916666666666667
"777",2021-06-05,"3 - 1008",171,201,166,5,30,0.970760233918129
"778",2021-06-05,"16 - 1022",39,50,28,11,11,0.717948717948718
"779",2021-06-05,"24 - 1150",173,173,140,33,0,0.809248554913295
"780",2021-06-05,"24 - 1153",125,125,118,7,0,0.944
"781",2021-06-06,"62 - 1011",60,61,55,5,1,0.916666666666667
"782",2021-06-06,"3 - 1008",171,201,166,5,30,0.970760233918129
"783",2021-06-06,"16 - 1022",34,50,24,10,16,0.705882352941177
"784",2021-06-06,"24 - 1150",173,173,145,28,0,0.838150289017341
"785",2021-06-06,"24 - 1153",125,125,120,5,0,0.96
"786",2021-06-07,"62 - 1011",60,61,54,6,1,0.9
"787",2021-06-07,"3 - 1008",173,201,167,6,28,0.965317919075145
"788",2021-06-07,"16 - 1022",34,50,23,11,16,0.676470588235294
"789",2021-06-07,"24 - 1150",173,173,148,25,0,0.855491329479769
"790",2021-06-07,"24 - 1153",125,125,120,5,0,0.96
"791",2021-06-08,"62 - 1011",60,61,55,5,1,0.916666666666667
"792",2021-06-08,"3 - 1008",173,201,168,5,28,0.971098265895954
"793",2021-06-08,"16 - 1022",30,50,22,8,20,0.733333333333333
"794",2021-06-08,"24 - 1150",173,173,153,20,0,0.884393063583815
"795",2021-06-08,"24 - 1153",125,135,117,8,10,0.936
"796",2021-06-09,"62 - 1011",60,61,56,4,1,0.933333333333333
"797",2021-06-09,"3 - 1008",168,201,163,5,33,0.970238095238095
"798",2021-06-09,"16 - 1022",31,50,22,9,19,0.709677419354839
"799",2021-06-09,"24 - 1150",173,173,157,16,0,0.907514450867052
"800",2021-06-09,"24 - 1153",125,135,119,6,10,0.952
"801",2021-06-10,"62 - 1011",60,61,55,5,1,0.916666666666667
"802",2021-06-10,"3 - 1008",171,201,162,9,30,0.947368421052632
"803",2021-06-10,"16 - 1022",31,50,22,9,19,0.709677419354839
"804",2021-06-10,"24 - 1150",172,173,156,16,1,0.906976744186046
"805",2021-06-10,"24 - 1153",125,135,123,2,10,0.984
"806",2021-06-11,"62 - 1011",60,61,56,4,1,0.933333333333333
"807",2021-06-11,"3 - 1008",171,201,164,7,30,0.95906432748538
"808",2021-06-11,"16 - 1022",31,50,23,8,19,0.741935483870968
"809",2021-06-11,"24 - 1150",172,173,154,18,1,0.895348837209302
"810",2021-06-11,"24 - 1153",125,135,124,1,10,0.992
"811",2021-06-12,"62 - 1011",60,61,57,3,1,0.95
"812",2021-06-12,"3 - 1008",171,201,161,10,30,0.941520467836257
"813",2021-06-12,"16 - 1022",31,50,23,8,19,0.741935483870968
"814",2021-06-12,"24 - 1150",172,173,159,13,1,0.924418604651163
"815",2021-06-12,"24 - 1153",125,135,123,2,10,0.984
"816",2021-06-13,"62 - 1011",60,61,58,2,1,0.966666666666667
"817",2021-06-13,"3 - 1008",171,201,162,9,30,0.947368421052632
"818",2021-06-13,"16 - 1022",30,50,22,8,20,0.733333333333333
"819",2021-06-13,"24 - 1150",172,173,159,13,1,0.924418604651163
"820",2021-06-13,"24 - 1153",125,135,124,1,10,0.992
"821",2021-06-14,"62 - 1011",60,61,59,1,1,0.983333333333333
"822",2021-06-14,"3 - 1008",171,201,162,9,30,0.947368421052632
"823",2021-06-14,"16 - 1022",41,50,30,11,9,0.731707317073171
"824",2021-06-14,"24 - 1150",169,173,153,16,4,0.905325443786982
"825",2021-06-14,"24 - 1153",125,135,124,1,10,0.992
"826",2021-06-15,"62 - 1011",60,61,60,0,1,1
"827",2021-06-15,"3 - 1008",171,201,161,10,30,0.941520467836257
"828",2021-06-15,"16 - 1022",42,50,37,5,8,0.880952380952381
"829",2021-06-15,"24 - 1150",168,173,154,14,5,0.916666666666667
"830",2021-06-15,"24 - 1153",125,135,123,2,10,0.984
"831",2021-06-16,"62 - 1011",60,61,60,0,1,1
"832",2021-06-16,"3 - 1008",174,201,159,15,27,0.913793103448276
"833",2021-06-16,"16 - 1022",38,50,35,3,12,0.921052631578947
"834",2021-06-16,"24 - 1150",165,173,150,15,8,0.909090909090909
"835",2021-06-16,"24 - 1153",125,135,124,1,10,0.992
"836",2021-06-17,"62 - 1011",60,61,59,1,1,0.983333333333333
"837",2021-06-17,"3 - 1008",175,201,159,16,26,0.908571428571429
"838",2021-06-17,"16 - 1022",46,50,42,4,4,0.91304347826087
"839",2021-06-17,"24 - 1150",170,173,151,19,3,0.888235294117647
"840",2021-06-17,"24 - 1153",125,135,117,8,10,0.936
"841",2021-06-18,"62 - 1011",60,61,60,0,1,1
"842",2021-06-18,"3 - 1008",175,201,163,12,26,0.931428571428571
"843",2021-06-18,"16 - 1022",50,50,47,3,0,0.94
"844",2021-06-18,"24 - 1150",170,173,151,19,3,0.888235294117647
"845",2021-06-18,"24 - 1153",125,135,112,13,10,0.896
"846",2021-06-19,"62 - 1011",60,61,59,1,1,0.983333333333333
"847",2021-06-19,"3 - 1008",175,201,163,12,26,0.931428571428571
"848",2021-06-19,"16 - 1022",50,50,50,0,0,1
"849",2021-06-19,"24 - 1150",170,173,148,22,3,0.870588235294118
"850",2021-06-19,"24 - 1153",125,135,117,8,10,0.936
"851",2021-06-20,"62 - 1011",60,61,59,1,1,0.983333333333333
"852",2021-06-20,"3 - 1008",175,201,166,9,26,0.948571428571429
"853",2021-06-20,"16 - 1022",50,50,50,0,0,1
"854",2021-06-20,"24 - 1150",169,173,145,24,4,0.857988165680473
"855",2021-06-20,"24 - 1153",125,135,115,10,10,0.92
"856",2021-06-21,"62 - 1011",60,61,60,0,1,1
"857",2021-06-21,"3 - 1008",174,201,163,11,27,0.936781609195402
"858",2021-06-21,"16 - 1022",50,50,49,1,0,0.98
"859",2021-06-21,"24 - 1150",170,173,140,30,3,0.823529411764706
"860",2021-06-21,"24 - 1153",125,135,116,9,10,0.928
"861",2021-06-22,"62 - 1011",60,61,60,0,1,1
"862",2021-06-22,"3 - 1008",177,201,164,13,24,0.926553672316384
"863",2021-06-22,"16 - 1022",50,50,49,1,0,0.98
"864",2021-06-22,"24 - 1150",170,173,142,28,3,0.835294117647059
"865",2021-06-22,"24 - 1153",125,135,117,8,10,0.936
"866",2021-06-23,"62 - 1011",60,61,59,1,1,0.983333333333333
"867",2021-06-23,"3 - 1008",177,201,164,13,24,0.926553672316384
"868",2021-06-23,"16 - 1022",50,50,49,1,0,0.98
"869",2021-06-23,"24 - 1150",170,173,146,24,3,0.858823529411765
"870",2021-06-23,"24 - 1153",125,135,114,11,10,0.912
"871",2021-06-24,"62 - 1011",60,61,60,0,1,1
"872",2021-06-24,"3 - 1008",176,201,164,12,25,0.931818181818182
"873",2021-06-24,"16 - 1022",50,50,47,3,0,0.94
"874",2021-06-24,"24 - 1150",170,173,148,22,3,0.870588235294118
"875",2021-06-24,"24 - 1153",125,135,114,11,10,0.912
"876",2021-06-25,"62 - 1011",60,61,60,0,1,1
"877",2021-06-25,"3 - 1008",175,201,164,11,26,0.937142857142857
"878",2021-06-25,"16 - 1022",50,50,49,1,0,0.98
"879",2021-06-25,"24 - 1150",170,173,145,25,3,0.852941176470588
"880",2021-06-25,"24 - 1153",125,135,116,9,10,0.928
"881",2021-06-26,"62 - 1011",60,61,59,1,1,0.983333333333333
"882",2021-06-26,"3 - 1008",175,201,163,12,26,0.931428571428571
"883",2021-06-26,"16 - 1022",50,50,47,3,0,0.94
"884",2021-06-26,"24 - 1150",170,173,149,21,3,0.876470588235294
"885",2021-06-26,"24 - 1153",125,135,115,10,10,0.92
"886",2021-06-27,"62 - 1011",60,61,58,2,1,0.966666666666667
"887",2021-06-27,"3 - 1008",174,201,165,9,27,0.948275862068966
"888",2021-06-27,"16 - 1022",50,50,46,4,0,0.92
"889",2021-06-27,"24 - 1150",170,173,154,16,3,0.905882352941176
"890",2021-06-27,"24 - 1153",125,135,117,8,10,0.936
"891",2021-06-28,"62 - 1011",60,61,58,2,1,0.966666666666667
"892",2021-06-28,"3 - 1008",178,201,162,16,23,0.910112359550562
"893",2021-06-28,"16 - 1022",50,50,48,2,0,0.96
"894",2021-06-28,"24 - 1150",170,173,153,17,3,0.9
"895",2021-06-28,"24 - 1153",125,135,115,10,10,0.92
"896",2021-06-29,"62 - 1011",60,61,53,7,1,0.883333333333333
"897",2021-06-29,"3 - 1008",175,201,161,14,26,0.92
"898",2021-06-29,"16 - 1022",50,50,48,2,0,0.96
"899",2021-06-29,"24 - 1150",170,173,153,17,3,0.9
"900",2021-06-29,"24 - 1153",124,135,112,12,11,0.903225806451613
"901",2021-06-30,"62 - 1011",60,61,53,7,1,0.883333333333333
"902",2021-06-30,"3 - 1008",176,201,163,13,25,0.926136363636364
"903",2021-06-30,"16 - 1022",50,50,45,5,0,0.9
"904",2021-06-30,"24 - 1150",170,173,153,17,3,0.9
"905",2021-06-30,"24 - 1153",124,135,115,9,11,0.92741935483871
"906",2021-07-01,"62 - 1011",60,61,57,3,1,0.95
"907",2021-07-01,"3 - 1008",176,201,165,11,25,0.9375
"908",2021-07-01,"16 - 1022",50,50,44,6,0,0.88
"909",2021-07-01,"24 - 1150",170,173,157,13,3,0.923529411764706
"910",2021-07-01,"24 - 1153",124,135,116,8,11,0.935483870967742
"911",2021-07-02,"62 - 1011",60,61,55,5,1,0.916666666666667
"912",2021-07-02,"3 - 1008",178,201,165,13,23,0.926966292134832
"913",2021-07-02,"16 - 1022",50,50,46,4,0,0.92
"914",2021-07-02,"24 - 1150",170,173,151,19,3,0.888235294117647
"915",2021-07-02,"24 - 1153",124,135,118,6,11,0.951612903225806
"916",2021-07-03,"62 - 1011",60,61,55,5,1,0.916666666666667
"917",2021-07-03,"3 - 1008",180,201,167,13,21,0.927777777777778
"918",2021-07-03,"16 - 1022",50,50,45,5,0,0.9
"919",2021-07-03,"24 - 1150",170,173,163,7,3,0.958823529411765
"920",2021-07-03,"24 - 1153",124,135,118,6,11,0.951612903225806
"921",2021-07-04,"62 - 1011",60,61,55,5,1,0.916666666666667
"922",2021-07-04,"3 - 1008",179,201,168,11,22,0.93854748603352
"923",2021-07-04,"16 - 1022",50,50,44,6,0,0.88
"924",2021-07-04,"24 - 1150",170,173,157,13,3,0.923529411764706
"925",2021-07-04,"24 - 1153",124,135,119,5,11,0.959677419354839
"926",2021-07-05,"62 - 1011",60,61,56,4,1,0.933333333333333
"927",2021-07-05,"3 - 1008",179,201,167,12,22,0.932960893854749
"928",2021-07-05,"16 - 1022",50,50,39,11,0,0.78
"929",2021-07-05,"24 - 1150",170,173,144,26,3,0.847058823529412
"930",2021-07-05,"24 - 1153",124,135,122,2,11,0.983870967741935
"931",2021-07-06,"62 - 1011",60,61,56,4,1,0.933333333333333
"932",2021-07-06,"3 - 1008",182,201,171,11,19,0.93956043956044
"933",2021-07-06,"16 - 1022",50,50,45,5,0,0.9
"934",2021-07-06,"24 - 1150",170,173,140,30,3,0.823529411764706
"935",2021-07-06,"24 - 1153",124,135,122,2,11,0.983870967741935
"936",2021-07-07,"62 - 1011",60,61,55,5,1,0.916666666666667
"937",2021-07-07,"3 - 1008",185,201,171,14,16,0.924324324324324
"938",2021-07-07,"16 - 1022",50,50,46,4,0,0.92
"939",2021-07-07,"24 - 1150",170,173,145,25,3,0.852941176470588
"940",2021-07-07,"24 - 1153",124,135,123,1,11,0.991935483870968
"941",2021-07-08,"62 - 1011",60,61,55,5,1,0.916666666666667
"942",2021-07-08,"3 - 1008",184,201,175,9,17,0.951086956521739
"943",2021-07-08,"16 - 1022",50,50,46,4,0,0.92
"944",2021-07-08,"24 - 1150",170,173,148,22,3,0.870588235294118
"945",2021-07-08,"24 - 1153",125,135,122,3,10,0.976
"946",2021-07-09,"62 - 1011",60,61,56,4,1,0.933333333333333
"947",2021-07-09,"3 - 1008",185,201,176,9,16,0.951351351351351
"948",2021-07-09,"16 - 1022",50,50,45,5,0,0.9
"949",2021-07-09,"24 - 1150",170,173,146,24,3,0.858823529411765
"950",2021-07-09,"24 - 1153",125,135,120,5,10,0.96
"951",2021-07-10,"62 - 1011",60,61,56,4,1,0.933333333333333
"952",2021-07-10,"3 - 1008",185,201,176,9,16,0.951351351351351
"953",2021-07-10,"16 - 1022",50,50,45,5,0,0.9
"954",2021-07-10,"24 - 1150",170,173,145,25,3,0.852941176470588
"955",2021-07-10,"24 - 1153",125,135,122,3,10,0.976
"956",2021-07-11,"62 - 1011",60,61,56,4,1,0.933333333333333
"957",2021-07-11,"3 - 1008",184,201,174,10,17,0.945652173913043
"958",2021-07-11,"16 - 1022",50,50,43,7,0,0.86
"959",2021-07-11,"24 - 1150",170,173,145,25,3,0.852941176470588
"960",2021-07-11,"24 - 1153",125,135,120,5,10,0.96
"961",2021-07-12,"62 - 1011",60,61,56,4,1,0.933333333333333
"962",2021-07-12,"3 - 1008",183,201,175,8,18,0.956284153005464
"963",2021-07-12,"16 - 1022",50,50,45,5,0,0.9
"964",2021-07-12,"24 - 1150",170,173,148,22,3,0.870588235294118
"965",2021-07-12,"24 - 1153",125,135,123,2,10,0.984
"966",2021-07-13,"62 - 1011",60,61,56,4,1,0.933333333333333
"967",2021-07-13,"3 - 1008",190,201,174,16,11,0.91578947368421
"968",2021-07-13,"16 - 1022",50,50,47,3,0,0.94
"969",2021-07-13,"24 - 1150",168,173,146,22,5,0.869047619047619
"970",2021-07-13,"24 - 1153",125,135,124,1,10,0.992
"971",2021-07-14,"62 - 1011",60,61,56,4,1,0.933333333333333
"972",2021-07-14,"3 - 1008",190,201,177,13,11,0.931578947368421
"973",2021-07-14,"16 - 1022",50,50,47,3,0,0.94
"974",2021-07-14,"24 - 1150",163,173,140,23,10,0.858895705521472
"975",2021-07-14,"24 - 1153",125,135,123,2,10,0.984
"976",2021-07-15,"62 - 1011",60,61,57,3,1,0.95
"977",2021-07-15,"3 - 1008",190,201,179,11,11,0.942105263157895
"978",2021-07-15,"16 - 1022",50,50,44,6,0,0.88
"979",2021-07-15,"24 - 1150",164,173,133,31,9,0.810975609756098
"980",2021-07-15,"24 - 1153",125,135,125,0,10,1
"981",2021-07-16,"62 - 1011",60,61,56,4,1,0.933333333333333
"982",2021-07-16,"3 - 1008",190,201,178,12,11,0.936842105263158
"983",2021-07-16,"16 - 1022",50,50,43,7,0,0.86
"984",2021-07-16,"24 - 1150",162,173,132,30,11,0.814814814814815
"985",2021-07-16,"24 - 1153",125,135,123,2,10,0.984
"986",2021-07-17,"62 - 1011",60,61,56,4,1,0.933333333333333
"987",2021-07-17,"3 - 1008",190,201,178,12,11,0.936842105263158
"988",2021-07-17,"16 - 1022",50,50,45,5,0,0.9
"989",2021-07-17,"24 - 1150",160,173,129,31,13,0.80625
"990",2021-07-17,"24 - 1153",125,135,125,0,10,1
"991",2021-07-18,"62 - 1011",60,61,57,3,1,0.95
"992",2021-07-18,"3 - 1008",190,201,179,11,11,0.942105263157895
"993",2021-07-18,"16 - 1022",50,50,42,8,0,0.84
"994",2021-07-18,"24 - 1150",159,173,134,25,14,0.842767295597484
"995",2021-07-18,"24 - 1153",125,135,125,0,10,1
"996",2021-07-19,"62 - 1011",60,61,58,2,1,0.966666666666667
"997",2021-07-19,"3 - 1008",190,201,178,12,11,0.936842105263158
"998",2021-07-19,"16 - 1022",50,50,49,1,0,0.98
"999",2021-07-19,"24 - 1150",156,173,129,27,17,0.826923076923077
"1000",2021-07-19,"24 - 1153",125,135,122,3,10,0.976
"1001",2021-07-20,"62 - 1011",60,61,58,2,1,0.966666666666667
"1002",2021-07-20,"3 - 1008",190,201,170,20,11,0.894736842105263
"1003",2021-07-20,"16 - 1022",50,50,49,1,0,0.98
"1004",2021-07-20,"24 - 1150",153,173,127,26,20,0.830065359477124
"1005",2021-07-20,"24 - 1153",125,135,125,0,10,1
"1006",2021-07-21,"62 - 1011",60,61,59,1,1,0.983333333333333
"1007",2021-07-21,"3 - 1008",190,201,175,15,11,0.921052631578947
"1008",2021-07-21,"16 - 1022",50,50,50,0,0,1
"1009",2021-07-21,"24 - 1150",148,173,121,27,25,0.817567567567568
"1010",2021-07-21,"24 - 1153",125,135,125,0,10,1
"1011",2021-07-22,"62 - 1011",60,61,59,1,1,0.983333333333333
"1012",2021-07-22,"3 - 1008",190,201,176,14,11,0.926315789473684
"1013",2021-07-22,"16 - 1022",50,50,50,0,0,1
"1014",2021-07-22,"24 - 1150",147,173,124,23,26,0.843537414965986
"1015",2021-07-22,"24 - 1153",125,135,124,1,10,0.992
"1016",2021-07-23,"62 - 1011",60,61,59,1,1,0.983333333333333
"1017",2021-07-23,"3 - 1008",195,201,175,20,6,0.897435897435897
"1018",2021-07-23,"16 - 1022",50,50,50,0,0,1
"1019",2021-07-23,"24 - 1150",145,173,121,24,28,0.83448275862069
"1020",2021-07-23,"24 - 1153",125,135,124,1,10,0.992
"1021",2021-07-24,"62 - 1011",60,61,59,1,1,0.983333333333333
"1022",2021-07-24,"3 - 1008",195,201,176,19,6,0.902564102564103
"1023",2021-07-24,"16 - 1022",50,50,50,0,0,1
"1024",2021-07-24,"24 - 1150",145,173,122,23,28,0.841379310344828
"1025",2021-07-24,"24 - 1153",125,135,125,0,10,1
"1026",2021-07-25,"62 - 1011",60,61,57,3,1,0.95
"1027",2021-07-25,"3 - 1008",195,201,174,21,6,0.892307692307692
"1028",2021-07-25,"16 - 1022",50,50,50,0,0,1
"1029",2021-07-25,"24 - 1150",144,173,129,15,29,0.895833333333333
"1030",2021-07-25,"24 - 1153",125,135,125,0,10,1
"1031",2021-07-26,"62 - 1011",60,61,57,3,1,0.95
"1032",2021-07-26,"3 - 1008",195,201,171,24,6,0.876923076923077
"1033",2021-07-26,"16 - 1022",50,50,46,4,0,0.92
"1034",2021-07-26,"24 - 1150",137,173,119,18,36,0.868613138686131
"1035",2021-07-26,"24 - 1153",125,135,123,2,10,0.984
"1036",2021-07-27,"62 - 1011",60,61,58,2,1,0.966666666666667
"1037",2021-07-27,"3 - 1008",195,201,175,20,6,0.897435897435897
"1038",2021-07-27,"16 - 1022",50,50,48,2,0,0.96
"1039",2021-07-27,"24 - 1150",137,173,117,20,36,0.854014598540146
"1040",2021-07-27,"24 - 1153",125,135,121,4,10,0.968
"1041",2021-07-28,"62 - 1011",60,61,59,1,1,0.983333333333333
"1042",2021-07-28,"3 - 1008",195,201,173,22,6,0.887179487179487
"1043",2021-07-28,"16 - 1022",50,50,48,2,0,0.96
"1044",2021-07-28,"24 - 1150",137,173,113,24,36,0.824817518248175
"1045",2021-07-28,"24 - 1153",125,135,121,4,10,0.968
"1046",2021-07-29,"62 - 1011",60,61,59,1,1,0.983333333333333
"1047",2021-07-29,"3 - 1008",194,201,175,19,7,0.902061855670103
"1048",2021-07-29,"16 - 1022",50,50,50,0,0,1
"1049",2021-07-29,"24 - 1150",136,173,126,10,37,0.926470588235294
"1050",2021-07-29,"24 - 1153",125,135,122,3,10,0.976
"1051",2021-07-30,"62 - 1011",61,61,59,2,0,0.967213114754098
"1052",2021-07-30,"3 - 1008",194,201,174,20,7,0.896907216494845
"1053",2021-07-30,"16 - 1022",50,50,48,2,0,0.96
"1054",2021-07-30,"24 - 1150",135,173,127,8,38,0.940740740740741
"1055",2021-07-30,"24 - 1153",125,135,125,0,10,1
"1056",2021-07-31,"62 - 1011",61,61,57,4,0,0.934426229508197
"1057",2021-07-31,"3 - 1008",194,201,174,20,7,0.896907216494845
"1058",2021-07-31,"16 - 1022",50,50,47,3,0,0.94
"1059",2021-07-31,"24 - 1150",135,173,131,4,38,0.97037037037037
"1060",2021-07-31,"24 - 1153",125,135,121,4,10,0.968
"1061",2021-08-01,"62 - 1011",61,61,59,2,0,0.967213114754098
"1062",2021-08-01,"3 - 1008",194,201,171,23,7,0.881443298969072
"1063",2021-08-01,"16 - 1022",50,50,46,4,0,0.92
"1064",2021-08-01,"24 - 1150",134,173,131,3,39,0.977611940298508
"1065",2021-08-01,"24 - 1153",125,135,122,3,10,0.976
"1066",2021-08-02,"62 - 1011",60,61,59,1,1,0.983333333333333
"1067",2021-08-02,"3 - 1008",194,201,172,22,7,0.88659793814433
"1068",2021-08-02,"16 - 1022",50,50,47,3,0,0.94
"1069",2021-08-02,"24 - 1150",134,173,127,7,39,0.947761194029851
"1070",2021-08-02,"24 - 1153",125,135,122,3,10,0.976
"1071",2021-08-03,"62 - 1011",60,61,60,0,1,1
"1072",2021-08-03,"3 - 1008",190,201,171,19,11,0.9
"1073",2021-08-03,"16 - 1022",50,50,48,2,0,0.96
"1074",2021-08-03,"24 - 1150",132,173,123,9,41,0.931818181818182
"1075",2021-08-03,"24 - 1153",125,135,122,3,10,0.976
"1076",2021-08-04,"62 - 1011",60,61,59,1,1,0.983333333333333
"1077",2021-08-04,"3 - 1008",190,201,175,15,11,0.921052631578947
"1078",2021-08-04,"16 - 1022",50,50,48,2,0,0.96
"1079",2021-08-04,"24 - 1150",130,173,123,7,43,0.946153846153846
"1080",2021-08-04,"24 - 1153",125,135,123,2,10,0.984
"1081",2021-08-05,"62 - 1011",60,61,59,1,1,0.983333333333333
"1082",2021-08-05,"3 - 1008",191,201,171,20,10,0.895287958115183
"1083",2021-08-05,"16 - 1022",50,50,46,4,0,0.92
"1084",2021-08-05,"24 - 1150",128,173,112,16,45,0.875
"1085",2021-08-05,"24 - 1153",125,135,124,1,10,0.992
"1086",2021-08-06,"62 - 1011",60,61,59,1,1,0.983333333333333
"1087",2021-08-06,"3 - 1008",190,201,169,21,11,0.889473684210526
"1088",2021-08-06,"16 - 1022",50,50,47,3,0,0.94
"1089",2021-08-06,"24 - 1150",128,173,106,22,45,0.828125
"1090",2021-08-06,"24 - 1153",125,135,124,1,10,0.992
"1091",2021-08-07,"62 - 1011",60,61,60,0,1,1
"1092",2021-08-07,"3 - 1008",190,201,170,20,11,0.894736842105263
"1093",2021-08-07,"16 - 1022",50,50,49,1,0,0.98
"1094",2021-08-07,"24 - 1150",127,173,113,14,46,0.889763779527559
"1095",2021-08-07,"24 - 1153",125,135,124,1,10,0.992
"1096",2021-08-08,"62 - 1011",60,61,59,1,1,0.983333333333333
"1097",2021-08-08,"3 - 1008",190,201,172,18,11,0.905263157894737
"1098",2021-08-08,"16 - 1022",50,50,49,1,0,0.98
"1099",2021-08-08,"24 - 1150",127,173,110,17,46,0.866141732283465
"1100",2021-08-08,"24 - 1153",125,135,125,0,10,1
"1101",2021-08-09,"62 - 1011",60,61,58,2,1,0.966666666666667
"1102",2021-08-09,"3 - 1008",190,201,176,14,11,0.926315789473684
"1103",2021-08-09,"16 - 1022",50,50,50,0,0,1
"1104",2021-08-09,"24 - 1150",125,173,106,19,48,0.848
"1105",2021-08-09,"24 - 1153",125,135,125,0,10,1
"1106",2021-08-10,"62 - 1011",60,61,59,1,1,0.983333333333333
"1107",2021-08-10,"3 - 1008",190,201,174,16,11,0.91578947368421
"1108",2021-08-10,"16 - 1022",50,50,49,1,0,0.98
"1109",2021-08-10,"24 - 1150",124,173,106,18,49,0.854838709677419
"1110",2021-08-10,"24 - 1153",125,135,124,1,10,0.992
"1111",2021-08-11,"62 - 1011",60,61,60,0,1,1
"1112",2021-08-11,"3 - 1008",190,201,177,13,11,0.931578947368421
"1113",2021-08-11,"16 - 1022",50,50,50,0,0,1
"1114",2021-08-11,"24 - 1150",120,120,95,25,0,0.791666666666667
"1115",2021-08-11,"24 - 1153",125,135,125,0,10,1
"1116",2021-08-12,"62 - 1011",60,61,60,0,1,1
"1117",2021-08-12,"3 - 1008",190,201,175,15,11,0.921052631578947
"1118",2021-08-12,"16 - 1022",50,50,49,1,0,0.98
"1119",2021-08-12,"24 - 1150",120,120,94,26,0,0.783333333333333
"1120",2021-08-12,"24 - 1153",125,135,123,2,10,0.984
"1121",2021-08-13,"62 - 1011",60,61,60,0,1,1
"1122",2021-08-13,"3 - 1008",190,201,175,15,11,0.921052631578947
"1123",2021-08-13,"16 - 1022",50,50,50,0,0,1
"1124",2021-08-13,"24 - 1150",120,120,95,25,0,0.791666666666667
"1125",2021-08-13,"24 - 1153",125,135,125,0,10,1
"1126",2021-08-14,"62 - 1011",60,61,60,0,1,1
"1127",2021-08-14,"3 - 1008",190,201,178,12,11,0.936842105263158
"1128",2021-08-14,"16 - 1022",50,50,49,1,0,0.98
"1129",2021-08-14,"24 - 1150",120,120,94,26,0,0.783333333333333
"1130",2021-08-14,"24 - 1153",125,135,124,1,10,0.992
"1131",2021-08-15,"62 - 1011",60,61,60,0,1,1
"1132",2021-08-15,"3 - 1008",190,201,178,12,11,0.936842105263158
"1133",2021-08-15,"16 - 1022",50,50,47,3,0,0.94
"1134",2021-08-15,"24 - 1150",120,120,94,26,0,0.783333333333333
"1135",2021-08-15,"24 - 1153",125,135,123,2,10,0.984
"1136",2021-08-16,"62 - 1011",60,61,60,0,1,1
"1137",2021-08-16,"3 - 1008",190,201,178,12,11,0.936842105263158
"1138",2021-08-16,"16 - 1022",50,50,49,1,0,0.98
"1139",2021-08-16,"24 - 1150",120,120,94,26,0,0.783333333333333
"1140",2021-08-16,"24 - 1153",125,135,121,4,10,0.968
"1141",2021-08-17,"62 - 1011",60,61,59,1,1,0.983333333333333
"1142",2021-08-17,"3 - 1008",190,201,175,15,11,0.921052631578947
"1143",2021-08-17,"16 - 1022",50,50,50,0,0,1
"1144",2021-08-17,"24 - 1150",120,120,99,21,0,0.825
"1145",2021-08-17,"24 - 1153",125,135,124,1,10,0.992
"1146",2021-08-18,"62 - 1011",60,61,58,2,1,0.966666666666667
"1147",2021-08-18,"3 - 1008",190,201,177,13,11,0.931578947368421
"1148",2021-08-18,"16 - 1022",50,50,48,2,0,0.96
"1149",2021-08-18,"24 - 1150",120,120,99,21,0,0.825
"1150",2021-08-18,"24 - 1153",125,135,124,1,10,0.992
"1151",2021-08-19,"62 - 1011",60,61,59,1,1,0.983333333333333
"1152",2021-08-19,"3 - 1008",190,201,174,16,11,0.91578947368421
"1153",2021-08-19,"16 - 1022",50,50,49,1,0,0.98
"1154",2021-08-19,"24 - 1150",120,120,98,22,0,0.816666666666667
"1155",2021-08-19,"24 - 1153",125,135,125,0,10,1
"1156",2021-08-20,"62 - 1011",60,61,58,2,1,0.966666666666667
"1157",2021-08-20,"3 - 1008",190,201,171,19,11,0.9
"1158",2021-08-20,"16 - 1022",50,50,48,2,0,0.96
"1159",2021-08-20,"24 - 1150",120,120,96,24,0,0.8
"1160",2021-08-20,"24 - 1153",125,135,122,3,10,0.976
"1161",2021-08-21,"62 - 1011",60,61,59,1,1,0.983333333333333
"1162",2021-08-21,"3 - 1008",190,201,167,23,11,0.878947368421053
"1163",2021-08-21,"16 - 1022",50,50,49,1,0,0.98
"1164",2021-08-21,"24 - 1150",120,120,96,24,0,0.8
"1165",2021-08-21,"24 - 1153",125,135,125,0,10,1
"1166",2021-08-22,"62 - 1011",60,61,60,0,1,1
"1167",2021-08-22,"3 - 1008",190,201,168,22,11,0.88421052631579
"1168",2021-08-22,"16 - 1022",50,50,48,2,0,0.96
"1169",2021-08-22,"24 - 1150",120,120,105,15,0,0.875
"1170",2021-08-22,"24 - 1153",125,135,125,0,10,1
"1171",2021-08-23,"62 - 1011",60,61,59,1,1,0.983333333333333
"1172",2021-08-23,"3 - 1008",190,201,170,20,11,0.894736842105263
"1173",2021-08-23,"16 - 1022",50,50,49,1,0,0.98
"1174",2021-08-23,"24 - 1150",119,120,100,19,1,0.840336134453782
"1175",2021-08-23,"24 - 1153",125,135,124,1,10,0.992
"1176",2021-08-24,"62 - 1011",60,61,59,1,1,0.983333333333333
"1177",2021-08-24,"3 - 1008",190,201,175,15,11,0.921052631578947
"1178",2021-08-24,"16 - 1022",50,50,49,1,0,0.98
"1179",2021-08-24,"24 - 1150",120,120,102,18,0,0.85
"1180",2021-08-24,"24 - 1153",125,135,125,0,10,1
"1181",2021-08-25,"62 - 1011",60,61,59,1,1,0.983333333333333
"1182",2021-08-25,"3 - 1008",190,201,179,11,11,0.942105263157895
"1183",2021-08-25,"16 - 1022",50,50,50,0,0,1
"1184",2021-08-25,"24 - 1150",120,120,103,17,0,0.858333333333333
"1185",2021-08-25,"24 - 1153",125,135,123,2,10,0.984
"1186",2021-08-26,"62 - 1011",60,61,60,0,1,1
"1187",2021-08-26,"3 - 1008",190,201,178,12,11,0.936842105263158
"1188",2021-08-26,"16 - 1022",50,50,50,0,0,1
"1189",2021-08-26,"24 - 1150",120,120,103,17,0,0.858333333333333
"1190",2021-08-26,"24 - 1153",125,135,124,1,10,0.992
"1191",2021-08-27,"62 - 1011",60,61,60,0,1,1
"1192",2021-08-27,"3 - 1008",188,201,177,11,13,0.941489361702128
"1193",2021-08-27,"16 - 1022",50,50,50,0,0,1
"1194",2021-08-27,"24 - 1150",120,120,103,17,0,0.858333333333333
"1195",2021-08-27,"24 - 1153",125,135,125,0,10,1
"1196",2021-08-28,"62 - 1011",60,61,59,1,1,0.983333333333333
"1197",2021-08-28,"3 - 1008",188,201,178,10,13,0.946808510638298
"1198",2021-08-28,"16 - 1022",50,50,50,0,0,1
"1199",2021-08-28,"24 - 1150",120,120,105,15,0,0.875
"1200",2021-08-28,"24 - 1153",125,135,125,0,10,1
"1201",2021-08-29,"62 - 1011",60,61,60,0,1,1
"1202",2021-08-29,"3 - 1008",188,201,178,10,13,0.946808510638298
"1203",2021-08-29,"16 - 1022",50,50,46,4,0,0.92
"1204",2021-08-29,"24 - 1150",119,120,109,10,1,0.915966386554622
"1205",2021-08-29,"24 - 1153",125,135,125,0,10,1
"1206",2021-08-30,"62 - 1011",60,61,60,0,1,1
"1207",2021-08-30,"3 - 1008",188,201,177,11,13,0.941489361702128
"1208",2021-08-30,"16 - 1022",50,50,49,1,0,0.98
"1209",2021-08-30,"24 - 1150",119,120,105,14,1,0.88235294117647
"1210",2021-08-30,"24 - 1153",125,135,123,2,10,0.984
"1211",2021-08-31,"62 - 1011",60,61,60,0,1,1
"1212",2021-08-31,"3 - 1008",193,201,181,12,8,0.937823834196891
"1213",2021-08-31,"16 - 1022",50,50,48,2,0,0.96
"1214",2021-08-31,"24 - 1150",120,120,105,15,0,0.875
"1215",2021-08-31,"24 - 1153",125,135,124,1,10,0.992
"1216",2021-09-01,"62 - 1011",60,61,60,0,1,1
"1217",2021-09-01,"3 - 1008",192,201,179,13,9,0.932291666666667
"1218",2021-09-01,"16 - 1022",50,50,47,3,0,0.94
"1219",2021-09-01,"24 - 1150",119,120,95,24,1,0.798319327731092
"1220",2021-09-01,"24 - 1153",125,135,125,0,10,1
"1221",2021-09-02,"62 - 1011",60,61,58,2,1,0.966666666666667
"1222",2021-09-02,"3 - 1008",190,201,177,13,11,0.931578947368421
"1223",2021-09-02,"16 - 1022",50,50,47,3,0,0.94
"1224",2021-09-02,"24 - 1150",119,120,90,29,1,0.756302521008403
"1225",2021-09-02,"24 - 1153",125,135,122,3,10,0.976
"1226",2021-09-03,"62 - 1011",60,61,58,2,1,0.966666666666667
"1227",2021-09-03,"3 - 1008",190,201,176,14,11,0.926315789473684
"1228",2021-09-03,"16 - 1022",50,50,46,4,0,0.92
"1229",2021-09-03,"24 - 1150",120,120,86,34,0,0.716666666666667
"1230",2021-09-03,"24 - 1153",125,135,123,2,10,0.984
"1231",2021-09-04,"62 - 1011",60,61,58,2,1,0.966666666666667
"1232",2021-09-04,"3 - 1008",190,201,179,11,11,0.942105263157895
"1233",2021-09-04,"16 - 1022",50,50,46,4,0,0.92
"1234",2021-09-04,"24 - 1150",120,120,87,33,0,0.725
"1235",2021-09-04,"24 - 1153",125,135,125,0,10,1
"1236",2021-09-05,"62 - 1011",60,61,58,2,1,0.966666666666667
"1237",2021-09-05,"3 - 1008",189,201,178,11,12,0.941798941798942
"1238",2021-09-05,"16 - 1022",50,50,43,7,0,0.86
"1239",2021-09-05,"24 - 1150",120,120,84,36,0,0.7
"1240",2021-09-05,"24 - 1153",125,135,125,0,10,1
"1241",2021-09-06,"62 - 1011",60,61,60,0,1,1
"1242",2021-09-06,"3 - 1008",189,201,178,11,12,0.941798941798942
"1243",2021-09-06,"16 - 1022",50,50,44,6,0,0.88
"1244",2021-09-06,"24 - 1150",120,120,85,35,0,0.708333333333333
"1245",2021-09-06,"24 - 1153",125,135,125,0,10,1
"1246",2021-09-07,"62 - 1011",60,61,60,0,1,1
"1247",2021-09-07,"3 - 1008",189,201,176,13,12,0.931216931216931
"1248",2021-09-07,"16 - 1022",50,50,50,0,0,1
"1249",2021-09-07,"24 - 1150",120,120,93,27,0,0.775
"1250",2021-09-07,"24 - 1153",125,135,125,0,10,1
"1251",2021-09-08,"62 - 1011",60,61,60,0,1,1
"1252",2021-09-08,"3 - 1008",188,201,175,13,13,0.930851063829787
"1253",2021-09-08,"16 - 1022",50,50,50,0,0,1
"1254",2021-09-08,"24 - 1150",120,120,85,35,0,0.708333333333333
"1255",2021-09-08,"24 - 1153",125,135,124,1,10,0.992
"1256",2021-09-09,"62 - 1011",60,61,59,1,1,0.983333333333333
"1257",2021-09-09,"3 - 1008",188,201,175,13,13,0.930851063829787
"1258",2021-09-09,"16 - 1022",50,50,50,0,0,1
"1259",2021-09-09,"24 - 1150",81,120,81,0,39,1
"1260",2021-09-09,"24 - 1153",125,135,125,0,10,1
"1261",2021-09-10,"62 - 1011",60,61,60,0,1,1
"1262",2021-09-10,"3 - 1008",186,201,174,12,15,0.935483870967742
"1263",2021-09-10,"16 - 1022",50,50,48,2,0,0.96
"1264",2021-09-10,"24 - 1150",79,120,79,0,41,1
"1265",2021-09-10,"24 - 1153",125,135,125,0,10,1
"1266",2021-09-11,"62 - 1011",60,61,60,0,1,1
"1267",2021-09-11,"3 - 1008",186,201,175,11,15,0.940860215053763
"1268",2021-09-11,"16 - 1022",50,50,49,1,0,0.98
"1269",2021-09-11,"24 - 1150",77,120,77,0,43,1
"1270",2021-09-11,"24 - 1153",125,135,124,1,10,0.992
"1271",2021-09-12,"62 - 1011",60,61,60,0,1,1
"1272",2021-09-12,"3 - 1008",186,201,175,11,15,0.940860215053763
"1273",2021-09-12,"16 - 1022",50,50,50,0,0,1
"1274",2021-09-12,"24 - 1150",79,120,79,0,41,1
"1275",2021-09-12,"24 - 1153",125,135,125,0,10,1
"1276",2021-09-13,"62 - 1011",60,61,60,0,1,1
"1277",2021-09-13,"3 - 1008",184,201,174,10,17,0.945652173913043
"1278",2021-09-13,"16 - 1022",50,50,49,1,0,0.98
"1279",2021-09-13,"24 - 1150",78,120,78,0,42,1
"1280",2021-09-13,"24 - 1153",125,135,125,0,10,1
"1281",2021-09-14,"62 - 1011",60,61,59,1,1,0.983333333333333
"1282",2021-09-14,"3 - 1008",184,201,172,12,17,0.934782608695652
"1283",2021-09-14,"16 - 1022",50,50,50,0,0,1
"1284",2021-09-14,"24 - 1150",76,120,73,3,44,0.960526315789474
"1285",2021-09-14,"24 - 1153",125,135,124,1,10,0.992
"1286",2021-09-15,"62 - 1011",60,61,60,0,1,1
"1287",2021-09-15,"3 - 1008",172,201,171,1,29,0.994186046511628
"1288",2021-09-15,"16 - 1022",50,50,48,2,0,0.96
"1289",2021-09-15,"24 - 1150",69,120,69,0,51,1
"1290",2021-09-15,"24 - 1153",125,135,125,0,10,1
"1291",2021-09-16,"62 - 1011",60,61,60,0,1,1
"1292",2021-09-16,"3 - 1008",172,201,170,2,29,0.988372093023256
"1293",2021-09-16,"16 - 1022",50,50,48,2,0,0.96
"1294",2021-09-16,"24 - 1150",69,120,69,0,51,1
"1295",2021-09-16,"24 - 1153",125,135,123,2,10,0.984
"1296",2021-09-17,"62 - 1011",60,61,60,0,1,1
"1297",2021-09-17,"3 - 1008",172,201,170,2,29,0.988372093023256
"1298",2021-09-17,"16 - 1022",50,50,48,2,0,0.96
"1299",2021-09-17,"24 - 1150",67,120,67,0,53,1
"1300",2021-09-17,"24 - 1153",125,135,124,1,10,0.992
"1301",2021-09-18,"62 - 1011",60,61,60,0,1,1
"1302",2021-09-18,"3 - 1008",172,201,171,1,29,0.994186046511628
"1303",2021-09-18,"16 - 1022",50,50,47,3,0,0.94
"1304",2021-09-18,"24 - 1150",67,120,67,0,53,1
"1305",2021-09-18,"24 - 1153",124,135,123,1,11,0.991935483870968
"1306",2021-09-19,"62 - 1011",60,61,60,0,1,1
"1307",2021-09-19,"3 - 1008",173,201,172,1,28,0.994219653179191
"1308",2021-09-19,"16 - 1022",50,50,47,3,0,0.94
"1309",2021-09-19,"24 - 1150",67,120,67,0,53,1
"1310",2021-09-19,"24 - 1153",125,135,124,1,10,0.992
"1311",2021-09-20,"62 - 1011",60,61,60,0,1,1
"1312",2021-09-20,"3 - 1008",174,201,172,2,27,0.988505747126437
"1313",2021-09-20,"16 - 1022",50,50,48,2,0,0.96
"1314",2021-09-20,"24 - 1150",65,120,65,0,55,1
"1315",2021-09-20,"24 - 1153",125,135,125,0,10,1
"1316",2021-09-21,"62 - 1011",60,61,59,1,1,0.983333333333333
"1317",2021-09-21,"3 - 1008",177,201,173,4,24,0.977401129943503
"1318",2021-09-21,"16 - 1022",50,50,49,1,0,0.98
"1319",2021-09-21,"24 - 1150",119,120,74,45,1,0.621848739495798
"1320",2021-09-21,"24 - 1153",125,135,125,0,10,1
"1321",2021-09-22,"62 - 1011",60,61,60,0,1,1
"1322",2021-09-22,"3 - 1008",176,201,170,6,25,0.965909090909091
"1323",2021-09-22,"16 - 1022",50,50,49,1,0,0.98
"1324",2021-09-22,"24 - 1150",119,120,78,41,1,0.65546218487395
"1325",2021-09-22,"24 - 1153",125,135,125,0,10,1
"1326",2021-09-23,"62 - 1011",60,61,57,3,1,0.95
"1327",2021-09-23,"3 - 1008",177,201,170,7,24,0.96045197740113
"1328",2021-09-23,"16 - 1022",50,50,49,1,0,0.98
"1329",2021-09-23,"24 - 1150",119,120,84,35,1,0.705882352941177
"1330",2021-09-23,"24 - 1153",125,135,124,1,10,0.992
"1331",2021-09-24,"62 - 1011",60,61,58,2,1,0.966666666666667
"1332",2021-09-24,"3 - 1008",177,201,170,7,24,0.96045197740113
"1333",2021-09-24,"16 - 1022",50,50,50,0,0,1
"1334",2021-09-24,"24 - 1150",119,120,87,32,1,0.73109243697479
"1335",2021-09-24,"24 - 1153",125,135,124,1,10,0.992
"1336",2021-09-25,"62 - 1011",60,61,58,2,1,0.966666666666667
"1337",2021-09-25,"3 - 1008",177,201,169,8,24,0.954802259887006
"1338",2021-09-25,"16 - 1022",50,50,50,0,0,1
"1339",2021-09-25,"24 - 1150",119,120,87,32,1,0.73109243697479
"1340",2021-09-25,"24 - 1153",125,135,125,0,10,1
"1341",2021-09-26,"62 - 1011",60,61,58,2,1,0.966666666666667
"1342",2021-09-26,"3 - 1008",178,201,170,8,23,0.955056179775281
"1343",2021-09-26,"16 - 1022",50,50,49,1,0,0.98
"1344",2021-09-26,"24 - 1150",119,120,92,27,1,0.773109243697479
"1345",2021-09-26,"24 - 1153",125,135,125,0,10,1
"1346",2021-09-27,"62 - 1011",60,61,60,0,1,1
"1347",2021-09-27,"3 - 1008",175,201,170,5,26,0.971428571428571
"1348",2021-09-27,"16 - 1022",50,50,45,5,0,0.9
"1349",2021-09-27,"24 - 1150",119,120,95,24,1,0.798319327731092
"1350",2021-09-27,"24 - 1153",125,135,124,1,10,0.992
"1351",2021-09-28,"62 - 1011",60,61,60,0,1,1
"1352",2021-09-28,"3 - 1008",189,201,176,13,12,0.931216931216931
"1353",2021-09-28,"16 - 1022",50,50,47,3,0,0.94
"1354",2021-09-28,"24 - 1150",119,120,93,26,1,0.781512605042017
"1355",2021-09-28,"24 - 1153",125,135,124,1,10,0.992
"1356",2021-09-29,"62 - 1011",60,61,59,1,1,0.983333333333333
"1357",2021-09-29,"3 - 1008",190,201,178,12,11,0.936842105263158
"1358",2021-09-29,"16 - 1022",50,50,48,2,0,0.96
"1359",2021-09-29,"24 - 1150",119,120,96,23,1,0.80672268907563
"1360",2021-09-29,"24 - 1153",125,135,124,1,10,0.992
"1361",2021-09-30,"62 - 1011",60,61,60,0,1,1
"1362",2021-09-30,"3 - 1008",191,201,177,14,10,0.926701570680628
"1363",2021-09-30,"16 - 1022",50,50,47,3,0,0.94
"1364",2021-09-30,"24 - 1150",119,120,92,27,1,0.773109243697479
"1365",2021-09-30,"24 - 1153",125,135,124,1,10,0.992
"1366",2021-10-01,"62 - 1011",60,61,59,1,1,0.983333333333333
"1367",2021-10-01,"3 - 1008",191,201,177,14,10,0.926701570680628
"1368",2021-10-01,"16 - 1022",50,50,48,2,0,0.96
"1369",2021-10-01,"24 - 1150",119,120,95,24,1,0.798319327731092
"1370",2021-10-01,"24 - 1153",125,135,123,2,10,0.984
"1371",2021-10-02,"62 - 1011",60,61,59,1,1,0.983333333333333
"1372",2021-10-02,"3 - 1008",192,201,177,15,9,0.921875
"1373",2021-10-02,"16 - 1022",50,50,48,2,0,0.96
"1374",2021-10-02,"24 - 1150",119,120,93,26,1,0.781512605042017
"1375",2021-10-02,"24 - 1153",125,135,125,0,10,1
"1376",2021-10-03,"62 - 1011",60,61,59,1,1,0.983333333333333
"1377",2021-10-03,"3 - 1008",192,201,180,12,9,0.9375
"1378",2021-10-03,"16 - 1022",50,50,48,2,0,0.96
"1379",2021-10-03,"24 - 1150",119,120,95,24,1,0.798319327731092
"1380",2021-10-03,"24 - 1153",125,135,125,0,10,1
"1381",2021-10-04,"62 - 1011",60,61,59,1,1,0.983333333333333
"1382",2021-10-04,"3 - 1008",193,201,181,12,8,0.937823834196891
"1383",2021-10-04,"16 - 1022",50,50,48,2,0,0.96
"1384",2021-10-04,"24 - 1150",119,120,93,26,1,0.781512605042017
"1385",2021-10-04,"24 - 1153",125,135,125,0,10,1
"1386",2021-10-05,"62 - 1011",60,61,59,1,1,0.983333333333333
"1387",2021-10-05,"3 - 1008",193,201,177,16,8,0.917098445595855
"1388",2021-10-05,"16 - 1022",50,50,46,4,0,0.92
"1389",2021-10-05,"24 - 1150",118,120,99,19,2,0.838983050847458
"1390",2021-10-05,"24 - 1153",125,135,124,1,10,0.992
"1391",2021-10-06,"62 - 1011",60,61,58,2,1,0.966666666666667
"1392",2021-10-06,"3 - 1008",193,201,178,15,8,0.922279792746114
"1393",2021-10-06,"16 - 1022",50,50,47,3,0,0.94
"1394",2021-10-06,"24 - 1150",120,120,103,17,0,0.858333333333333
"1395",2021-10-06,"24 - 1153",125,135,123,2,10,0.984
"1396",2021-10-07,"62 - 1011",60,61,57,3,1,0.95
"1397",2021-10-07,"3 - 1008",193,201,180,13,8,0.932642487046632
"1398",2021-10-07,"16 - 1022",50,50,49,1,0,0.98
"1399",2021-10-07,"24 - 1150",120,120,102,18,0,0.85
"1400",2021-10-07,"24 - 1153",125,135,125,0,10,1
"1401",2021-10-08,"62 - 1011",60,61,57,3,1,0.95
"1402",2021-10-08,"3 - 1008",193,201,182,11,8,0.94300518134715
"1403",2021-10-08,"16 - 1022",50,50,49,1,0,0.98
"1404",2021-10-08,"24 - 1150",120,120,103,17,0,0.858333333333333
"1405",2021-10-08,"24 - 1153",125,135,125,0,10,1
"1406",2021-10-09,"62 - 1011",60,61,57,3,1,0.95
"1407",2021-10-09,"3 - 1008",193,201,180,13,8,0.932642487046632
"1408",2021-10-09,"16 - 1022",50,50,50,0,0,1
"1409",2021-10-09,"24 - 1150",120,120,116,4,0,0.966666666666667
"1410",2021-10-09,"24 - 1153",125,135,124,1,10,0.992
"1411",2021-10-10,"62 - 1011",60,61,58,2,1,0.966666666666667
"1412",2021-10-10,"3 - 1008",192,201,180,12,9,0.9375
"1413",2021-10-10,"16 - 1022",50,50,49,1,0,0.98
"1414",2021-10-10,"24 - 1150",120,120,111,9,0,0.925
"1415",2021-10-10,"24 - 1153",125,135,125,0,10,1
"1416",2021-10-11,"62 - 1011",60,61,58,2,1,0.966666666666667
"1417",2021-10-11,"3 - 1008",192,201,180,12,9,0.9375
"1418",2021-10-11,"16 - 1022",50,50,48,2,0,0.96
"1419",2021-10-11,"24 - 1150",120,120,113,7,0,0.941666666666667
"1420",2021-10-11,"24 - 1153",125,135,125,0,10,1
"1421",2021-10-12,"62 - 1011",60,61,56,4,1,0.933333333333333
"1422",2021-10-12,"3 - 1008",194,201,178,16,7,0.917525773195876
"1423",2021-10-12,"16 - 1022",50,50,49,1,0,0.98
"1424",2021-10-12,"24 - 1150",120,120,109,11,0,0.908333333333333
"1425",2021-10-12,"24 - 1153",125,135,125,0,10,1
"1426",2021-10-13,"62 - 1011",60,61,55,5,1,0.916666666666667
"1427",2021-10-13,"3 - 1008",194,201,178,16,7,0.917525773195876
"1428",2021-10-13,"16 - 1022",50,50,50,0,0,1
"1429",2021-10-13,"24 - 1150",120,120,106,14,0,0.883333333333333
"1430",2021-10-13,"24 - 1153",125,135,125,0,10,1
"1431",2021-10-14,"62 - 1011",60,61,58,2,1,0.966666666666667
"1432",2021-10-14,"3 - 1008",195,201,181,14,6,0.928205128205128
"1433",2021-10-14,"16 - 1022",50,50,47,3,0,0.94
"1434",2021-10-14,"24 - 1150",120,120,104,16,0,0.866666666666667
"1435",2021-10-14,"24 - 1153",125,135,125,0,10,1
"1436",2021-10-15,"62 - 1011",60,61,59,1,1,0.983333333333333
"1437",2021-10-15,"3 - 1008",194,201,182,12,7,0.938144329896907
"1438",2021-10-15,"16 - 1022",50,50,50,0,0,1
"1439",2021-10-15,"24 - 1150",120,120,106,14,0,0.883333333333333
"1440",2021-10-15,"24 - 1153",125,135,125,0,10,1
"1441",2021-10-16,"62 - 1011",60,61,57,3,1,0.95
"1442",2021-10-16,"3 - 1008",193,201,184,9,8,0.953367875647668
"1443",2021-10-16,"16 - 1022",50,50,48,2,0,0.96
"1444",2021-10-16,"24 - 1150",120,120,112,8,0,0.933333333333333
"1445",2021-10-16,"24 - 1153",125,135,125,0,10,1
"1446",2021-10-17,"62 - 1011",60,61,59,1,1,0.983333333333333
"1447",2021-10-17,"3 - 1008",193,201,184,9,8,0.953367875647668
"1448",2021-10-17,"16 - 1022",50,50,47,3,0,0.94
"1449",2021-10-17,"24 - 1150",120,120,100,20,0,0.833333333333333
"1450",2021-10-17,"24 - 1153",125,135,125,0,10,1
"1451",2021-10-18,"62 - 1011",60,61,59,1,1,0.983333333333333
"1452",2021-10-18,"3 - 1008",193,201,185,8,8,0.958549222797927
"1453",2021-10-18,"16 - 1022",50,50,50,0,0,1
"1454",2021-10-18,"24 - 1150",120,120,99,21,0,0.825
"1455",2021-10-18,"24 - 1153",125,135,125,0,10,1
"1456",2021-10-19,"62 - 1011",60,61,59,1,1,0.983333333333333
"1457",2021-10-19,"3 - 1008",193,201,185,8,8,0.958549222797927
"1458",2021-10-19,"16 - 1022",50,50,48,2,0,0.96
"1459",2021-10-19,"24 - 1150",120,120,100,20,0,0.833333333333333
"1460",2021-10-19,"24 - 1153",125,135,124,1,10,0.992
"1461",2021-10-20,"62 - 1011",60,61,60,0,1,1
"1462",2021-10-20,"3 - 1008",193,201,183,10,8,0.948186528497409
"1463",2021-10-20,"16 - 1022",50,50,49,1,0,0.98
"1464",2021-10-20,"24 - 1150",120,120,89,31,0,0.741666666666667
"1465",2021-10-20,"24 - 1153",123,135,123,0,12,1
"1466",2021-10-21,"62 - 1011",60,61,60,0,1,1
"1467",2021-10-21,"3 - 1008",193,201,182,11,8,0.94300518134715
"1468",2021-10-21,"16 - 1022",50,50,50,0,0,1
"1469",2021-10-21,"24 - 1150",118,120,94,24,2,0.796610169491525
"1470",2021-10-21,"24 - 1153",125,135,124,1,10,0.992
"1471",2021-10-22,"62 - 1011",60,61,60,0,1,1
"1472",2021-10-22,"3 - 1008",193,201,183,10,8,0.948186528497409
"1473",2021-10-22,"16 - 1022",50,50,49,1,0,0.98
"1474",2021-10-22,"24 - 1150",120,120,97,23,0,0.808333333333333
"1475",2021-10-22,"24 - 1153",125,135,124,1,10,0.992
"1476",2021-10-23,"62 - 1011",60,61,59,1,1,0.983333333333333
"1477",2021-10-23,"3 - 1008",192,201,185,7,9,0.963541666666667
"1478",2021-10-23,"16 - 1022",50,50,49,1,0,0.98
"1479",2021-10-23,"24 - 1150",120,120,95,25,0,0.791666666666667
"1480",2021-10-23,"24 - 1153",125,135,125,0,10,1
"1481",2021-10-24,"62 - 1011",60,61,58,2,1,0.966666666666667
"1482",2021-10-24,"3 - 1008",192,201,185,7,9,0.963541666666667
"1483",2021-10-24,"16 - 1022",50,50,50,0,0,1
"1484",2021-10-24,"24 - 1150",120,120,100,20,0,0.833333333333333
"1485",2021-10-24,"24 - 1153",125,135,125,0,10,1
"1486",2021-10-25,"62 - 1011",60,61,60,0,1,1
"1487",2021-10-25,"3 - 1008",192,201,187,5,9,0.973958333333333
"1488",2021-10-25,"16 - 1022",50,50,49,1,0,0.98
"1489",2021-10-25,"24 - 1150",120,120,103,17,0,0.858333333333333
"1490",2021-10-25,"24 - 1153",125,135,124,1,10,0.992
"1491",2021-10-26,"62 - 1011",60,61,60,0,1,1
"1492",2021-10-26,"3 - 1008",192,201,187,5,9,0.973958333333333
"1493",2021-10-26,"16 - 1022",50,50,48,2,0,0.96
"1494",2021-10-26,"24 - 1150",120,120,98,22,0,0.816666666666667
"1495",2021-10-26,"24 - 1153",125,135,124,1,10,0.992
"1496",2021-10-27,"62 - 1011",60,61,59,1,1,0.983333333333333
"1497",2021-10-27,"3 - 1008",192,201,186,6,9,0.96875
"1498",2021-10-27,"16 - 1022",50,50,48,2,0,0.96
"1499",2021-10-27,"24 - 1150",120,120,102,18,0,0.85
"1500",2021-10-27,"24 - 1153",125,135,124,1,10,0.992
"1501",2021-10-28,"62 - 1011",60,61,60,0,1,1
"1502",2021-10-28,"3 - 1008",192,201,188,4,9,0.979166666666667
"1503",2021-10-28,"16 - 1022",50,50,48,2,0,0.96
"1504",2021-10-28,"24 - 1150",120,120,95,25,0,0.791666666666667
"1505",2021-10-28,"24 - 1153",125,135,125,0,10,1
"1506",2021-10-29,"62 - 1011",60,61,60,0,1,1
"1507",2021-10-29,"3 - 1008",192,201,190,2,9,0.989583333333333
"1508",2021-10-29,"16 - 1022",50,50,49,1,0,0.98
"1509",2021-10-29,"24 - 1150",120,120,96,24,0,0.8
"1510",2021-10-29,"24 - 1153",125,135,125,0,10,1
"1511",2021-10-30,"62 - 1011",60,61,60,0,1,1
"1512",2021-10-30,"3 - 1008",192,201,190,2,9,0.989583333333333
"1513",2021-10-30,"16 - 1022",50,50,49,1,0,0.98
"1514",2021-10-30,"24 - 1150",120,120,101,19,0,0.841666666666667
"1515",2021-10-30,"24 - 1153",125,135,125,0,10,1
"1516",2021-10-31,"62 - 1011",60,61,60,0,1,1
"1517",2021-10-31,"3 - 1008",192,201,190,2,9,0.989583333333333
"1518",2021-10-31,"16 - 1022",50,50,48,2,0,0.96
"1519",2021-10-31,"24 - 1150",120,120,99,21,0,0.825
"1520",2021-10-31,"24 - 1153",125,135,125,0,10,1
"1521",2021-11-01,"62 - 1011",60,61,60,0,1,1
"1522",2021-11-01,"3 - 1008",192,201,189,3,9,0.984375
"1523",2021-11-01,"16 - 1022",50,50,48,2,0,0.96
"1524",2021-11-01,"24 - 1150",120,120,89,31,0,0.741666666666667
"1525",2021-11-01,"24 - 1153",125,135,125,0,10,1
"1526",2021-11-02,"62 - 1011",60,61,60,0,1,1
"1527",2021-11-02,"3 - 1008",192,201,188,4,9,0.979166666666667
"1528",2021-11-02,"16 - 1022",50,50,47,3,0,0.94
"1529",2021-11-02,"24 - 1150",120,120,91,29,0,0.758333333333333
"1530",2021-11-02,"24 - 1153",125,135,125,0,10,1
"1531",2021-11-03,"62 - 1011",60,61,59,1,1,0.983333333333333
"1532",2021-11-03,"3 - 1008",192,201,189,3,9,0.984375
"1533",2021-11-03,"16 - 1022",50,50,45,5,0,0.9
"1534",2021-11-03,"24 - 1150",120,120,96,24,0,0.8
"1535",2021-11-03,"24 - 1153",125,135,125,0,10,1
"1536",2021-11-04,"62 - 1011",60,61,59,1,1,0.983333333333333
"1537",2021-11-04,"3 - 1008",192,201,190,2,9,0.989583333333333
"1538",2021-11-04,"16 - 1022",50,50,47,3,0,0.94
"1539",2021-11-04,"24 - 1150",119,120,91,28,1,0.764705882352941
"1540",2021-11-04,"24 - 1153",125,135,125,0,10,1
"1541",2021-11-05,"62 - 1011",60,61,59,1,1,0.983333333333333
"1542",2021-11-05,"3 - 1008",192,201,190,2,9,0.989583333333333
"1543",2021-11-05,"16 - 1022",50,50,47,3,0,0.94
"1544",2021-11-05,"24 - 1150",120,120,96,24,0,0.8
"1545",2021-11-05,"24 - 1153",124,135,124,0,11,1
"1546",2021-11-06,"62 - 1011",60,61,59,1,1,0.983333333333333
"1547",2021-11-06,"3 - 1008",192,201,190,2,9,0.989583333333333
"1548",2021-11-06,"16 - 1022",50,50,46,4,0,0.92
"1549",2021-11-06,"24 - 1150",120,120,102,18,0,0.85
"1550",2021-11-06,"24 - 1153",124,135,124,0,11,1
"1551",2021-11-07,"62 - 1011",60,61,59,1,1,0.983333333333333
"1552",2021-11-07,"3 - 1008",192,201,189,3,9,0.984375
"1553",2021-11-07,"16 - 1022",50,50,46,4,0,0.92
"1554",2021-11-07,"24 - 1150",120,120,104,16,0,0.866666666666667
"1555",2021-11-07,"24 - 1153",124,135,124,0,11,1
"1556",2021-11-08,"62 - 1011",60,61,60,0,1,1
"1557",2021-11-08,"3 - 1008",192,201,189,3,9,0.984375
"1558",2021-11-08,"16 - 1022",50,50,48,2,0,0.96
"1559",2021-11-08,"24 - 1150",120,120,106,14,0,0.883333333333333
"1560",2021-11-08,"24 - 1153",124,135,124,0,11,1
"1561",2021-11-09,"62 - 1011",60,61,60,0,1,1
"1562",2021-11-09,"3 - 1008",192,201,189,3,9,0.984375
"1563",2021-11-09,"16 - 1022",50,50,46,4,0,0.92
"1564",2021-11-09,"24 - 1150",120,120,104,16,0,0.866666666666667
"1565",2021-11-09,"24 - 1153",125,135,125,0,10,1
"1566",2021-11-10,"62 - 1011",60,61,60,0,1,1
"1567",2021-11-10,"3 - 1008",192,201,189,3,9,0.984375
"1568",2021-11-10,"16 - 1022",49,50,46,3,1,0.938775510204082
"1569",2021-11-10,"24 - 1150",120,120,103,17,0,0.858333333333333
"1570",2021-11-10,"24 - 1153",125,135,124,1,10,0.992
"1571",2021-11-11,"62 - 1011",60,61,60,0,1,1
"1572",2021-11-11,"3 - 1008",192,201,189,3,9,0.984375
"1573",2021-11-11,"16 - 1022",50,50,44,6,0,0.88
"1574",2021-11-11,"24 - 1150",120,120,104,16,0,0.866666666666667
"1575",2021-11-11,"24 - 1153",125,135,125,0,10,1
"1576",2021-11-12,"62 - 1011",60,61,60,0,1,1
"1577",2021-11-12,"3 - 1008",192,201,189,3,9,0.984375
"1578",2021-11-12,"16 - 1022",50,50,45,5,0,0.9
"1579",2021-11-12,"24 - 1150",120,120,101,19,0,0.841666666666667
"1580",2021-11-12,"24 - 1153",125,135,125,0,10,1
"1581",2021-11-13,"62 - 1011",60,61,60,0,1,1
"1582",2021-11-13,"3 - 1008",192,201,187,5,9,0.973958333333333
"1583",2021-11-13,"16 - 1022",50,50,46,4,0,0.92
"1584",2021-11-13,"24 - 1150",120,120,106,14,0,0.883333333333333
"1585",2021-11-13,"24 - 1153",125,135,125,0,10,1
"1586",2021-11-14,"62 - 1011",60,61,60,0,1,1
"1587",2021-11-14,"3 - 1008",192,201,187,5,9,0.973958333333333
"1588",2021-11-14,"16 - 1022",50,50,46,4,0,0.92
"1589",2021-11-14,"24 - 1150",119,120,105,14,1,0.88235294117647
"1590",2021-11-14,"24 - 1153",125,135,125,0,10,1
"1591",2021-11-15,"62 - 1011",60,61,60,0,1,1
"1592",2021-11-15,"3 - 1008",192,201,185,7,9,0.963541666666667
"1593",2021-11-15,"16 - 1022",50,50,43,7,0,0.86
"1594",2021-11-15,"24 - 1150",119,120,112,7,1,0.941176470588235
"1595",2021-11-15,"24 - 1153",125,135,125,0,10,1
"1596",2021-11-16,"62 - 1011",60,61,60,0,1,1
"1597",2021-11-16,"3 - 1008",192,201,185,7,9,0.963541666666667
"1598",2021-11-16,"16 - 1022",50,50,44,6,0,0.88
"1599",2021-11-16,"24 - 1150",119,120,111,8,1,0.932773109243697
"1600",2021-11-16,"24 - 1153",125,135,125,0,10,1
"1601",2021-11-17,"62 - 1011",60,61,59,1,1,0.983333333333333
"1602",2021-11-17,"3 - 1008",192,201,185,7,9,0.963541666666667
"1603",2021-11-17,"16 - 1022",49,50,45,4,1,0.918367346938776
"1604",2021-11-17,"24 - 1150",119,120,109,10,1,0.915966386554622
"1605",2021-11-17,"24 - 1153",124,135,124,0,11,1
"1606",2021-11-18,"62 - 1011",60,61,58,2,1,0.966666666666667
"1607",2021-11-18,"3 - 1008",192,201,183,9,9,0.953125
"1608",2021-11-18,"16 - 1022",49,50,47,2,1,0.959183673469388
"1609",2021-11-18,"24 - 1150",119,120,107,12,1,0.899159663865546
"1610",2021-11-18,"24 - 1153",124,135,124,0,11,1
"1611",2021-11-19,"62 - 1011",60,61,60,0,1,1
"1612",2021-11-19,"3 - 1008",192,201,184,8,9,0.958333333333333
"1613",2021-11-19,"16 - 1022",50,50,44,6,0,0.88
"1614",2021-11-19,"24 - 1150",119,120,103,16,1,0.865546218487395
"1615",2021-11-19,"24 - 1153",125,135,125,0,10,1
"1616",2021-11-20,"62 - 1011",60,61,59,1,1,0.983333333333333
"1617",2021-11-20,"3 - 1008",192,201,183,9,9,0.953125
"1618",2021-11-20,"16 - 1022",50,50,45,5,0,0.9
"1619",2021-11-20,"24 - 1150",119,120,115,4,1,0.966386554621849
"1620",2021-11-20,"24 - 1153",125,135,125,0,10,1
"1621",2021-11-21,"62 - 1011",60,61,59,1,1,0.983333333333333
"1622",2021-11-21,"3 - 1008",192,201,184,8,9,0.958333333333333
"1623",2021-11-21,"16 - 1022",50,50,46,4,0,0.92
"1624",2021-11-21,"24 - 1150",120,120,113,7,0,0.941666666666667
"1625",2021-11-21,"24 - 1153",125,135,125,0,10,1
"1626",2021-11-22,"62 - 1011",60,61,60,0,1,1
"1627",2021-11-22,"3 - 1008",192,201,185,7,9,0.963541666666667
"1628",2021-11-22,"16 - 1022",50,50,48,2,0,0.96
"1629",2021-11-22,"24 - 1150",120,120,115,5,0,0.958333333333333
"1630",2021-11-22,"24 - 1153",125,135,125,0,10,1
"1631",2021-11-23,"62 - 1011",60,61,59,1,1,0.983333333333333
"1632",2021-11-23,"3 - 1008",192,201,185,7,9,0.963541666666667
"1633",2021-11-23,"16 - 1022",50,50,48,2,0,0.96
"1634",2021-11-23,"24 - 1150",120,120,118,2,0,0.983333333333333
"1635",2021-11-23,"24 - 1153",125,135,125,0,10,1
"1636",2021-11-24,"62 - 1011",60,61,60,0,1,1
"1637",2021-11-24,"3 - 1008",192,201,184,8,9,0.958333333333333
"1638",2021-11-24,"16 - 1022",50,50,48,2,0,0.96
"1639",2021-11-24,"24 - 1150",120,120,102,18,0,0.85
"1640",2021-11-24,"24 - 1153",124,135,124,0,11,1
"1641",2021-11-25,"62 - 1011",60,61,60,0,1,1
"1642",2021-11-25,"3 - 1008",198,204,189,9,6,0.954545454545455
"1643",2021-11-25,"16 - 1022",50,50,47,3,0,0.94
"1644",2021-11-25,"24 - 1150",120,120,110,10,0,0.916666666666667
"1645",2021-11-25,"24 - 1153",124,135,124,0,11,1
"1646",2021-11-26,"62 - 1011",60,61,60,0,1,1
"1647",2021-11-26,"3 - 1008",212,215,196,16,3,0.924528301886792
"1648",2021-11-26,"16 - 1022",50,50,49,1,0,0.98
"1649",2021-11-26,"24 - 1150",120,120,103,17,0,0.858333333333333
"1650",2021-11-26,"24 - 1153",124,135,124,0,11,1
"1651",2021-11-27,"62 - 1011",60,61,60,0,1,1
"1652",2021-11-27,"3 - 1008",212,215,199,13,3,0.938679245283019
"1653",2021-11-27,"16 - 1022",50,50,48,2,0,0.96
"1654",2021-11-27,"24 - 1150",120,120,103,17,0,0.858333333333333
"1655",2021-11-27,"24 - 1153",124,135,124,0,11,1
"1656",2021-11-28,"62 - 1011",60,61,60,0,1,1
"1657",2021-11-28,"3 - 1008",212,215,200,12,3,0.943396226415094
"1658",2021-11-28,"16 - 1022",50,50,47,3,0,0.94
"1659",2021-11-28,"24 - 1150",120,120,112,8,0,0.933333333333333
"1660",2021-11-28,"24 - 1153",125,135,125,0,10,1
"1661",2021-11-29,"62 - 1011",60,61,59,1,1,0.983333333333333
"1662",2021-11-29,"3 - 1008",212,215,201,11,3,0.94811320754717
"1663",2021-11-29,"16 - 1022",50,50,49,1,0,0.98
"1664",2021-11-29,"24 - 1150",120,120,110,10,0,0.916666666666667
"1665",2021-11-29,"24 - 1153",125,135,124,1,10,0.992
"1666",2021-11-30,"62 - 1011",60,61,59,1,1,0.983333333333333
"1667",2021-11-30,"3 - 1008",212,215,203,9,3,0.957547169811321
"1668",2021-11-30,"16 - 1022",50,50,50,0,0,1
"1669",2021-11-30,"24 - 1150",120,120,110,10,0,0.916666666666667
"1670",2021-11-30,"24 - 1153",125,135,125,0,10,1
"1671",2021-12-01,"62 - 1011",60,61,59,1,1,0.983333333333333
"1672",2021-12-01,"3 - 1008",212,215,202,10,3,0.952830188679245
"1673",2021-12-01,"16 - 1022",50,50,48,2,0,0.96
"1674",2021-12-01,"24 - 1150",120,120,108,12,0,0.9
"1675",2021-12-01,"24 - 1153",125,135,125,0,10,1
"1676",2021-12-02,"62 - 1011",60,61,59,1,1,0.983333333333333
"1677",2021-12-02,"3 - 1008",212,215,199,13,3,0.938679245283019
"1678",2021-12-02,"16 - 1022",50,50,48,2,0,0.96
"1679",2021-12-02,"24 - 1150",120,120,104,16,0,0.866666666666667
"1680",2021-12-02,"24 - 1153",125,135,124,1,10,0.992
"1681",2021-12-03,"62 - 1011",60,61,60,0,1,1
"1682",2021-12-03,"3 - 1008",212,215,202,10,3,0.952830188679245
"1683",2021-12-03,"16 - 1022",50,50,47,3,0,0.94
"1684",2021-12-03,"24 - 1150",120,120,103,17,0,0.858333333333333
"1685",2021-12-03,"24 - 1153",125,135,123,2,10,0.984
"1686",2021-12-04,"62 - 1011",60,61,60,0,1,1
"1687",2021-12-04,"3 - 1008",212,215,203,9,3,0.957547169811321
"1688",2021-12-04,"16 - 1022",50,50,46,4,0,0.92
"1689",2021-12-04,"24 - 1150",120,120,100,20,0,0.833333333333333
"1690",2021-12-04,"24 - 1153",125,135,125,0,10,1
"1691",2021-12-05,"62 - 1011",60,61,59,1,1,0.983333333333333
"1692",2021-12-05,"3 - 1008",212,215,203,9,3,0.957547169811321
"1693",2021-12-05,"16 - 1022",50,50,46,4,0,0.92
"1694",2021-12-05,"24 - 1150",120,120,101,19,0,0.841666666666667
"1695",2021-12-05,"24 - 1153",125,135,125,0,10,1
"1696",2021-12-06,"62 - 1011",60,61,58,2,1,0.966666666666667
"1697",2021-12-06,"3 - 1008",212,215,199,13,3,0.938679245283019
"1698",2021-12-06,"16 - 1022",50,50,48,2,0,0.96
"1699",2021-12-06,"24 - 1150",120,120,105,15,0,0.875
"1700",2021-12-06,"24 - 1153",175,185,134,41,10,0.765714285714286
"1701",2021-12-07,"62 - 1011",60,61,58,2,1,0.966666666666667
"1702",2021-12-07,"3 - 1008",211,215,201,10,4,0.95260663507109
"1703",2021-12-07,"16 - 1022",50,50,50,0,0,1
"1704",2021-12-07,"24 - 1150",120,120,105,15,0,0.875
"1705",2021-12-07,"24 - 1153",175,185,156,19,10,0.891428571428571
"1706",2021-12-08,"62 - 1011",60,61,59,1,1,0.983333333333333
"1707",2021-12-08,"3 - 1008",212,215,201,11,3,0.94811320754717
"1708",2021-12-08,"16 - 1022",50,50,49,1,0,0.98
"1709",2021-12-08,"24 - 1150",120,120,106,14,0,0.883333333333333
"1710",2021-12-08,"24 - 1153",175,185,168,7,10,0.96
"1711",2021-12-09,"62 - 1011",60,61,60,0,1,1
"1712",2021-12-09,"3 - 1008",212,215,206,6,3,0.971698113207547
"1713",2021-12-09,"16 - 1022",50,50,48,2,0,0.96
"1714",2021-12-09,"24 - 1150",120,120,111,9,0,0.925
"1715",2021-12-09,"24 - 1153",160,185,158,2,25,0.9875
"1716",2021-12-10,"62 - 1011",60,61,60,0,1,1
"1717",2021-12-10,"3 - 1008",212,215,202,10,3,0.952830188679245
"1718",2021-12-10,"16 - 1022",49,50,47,2,1,0.959183673469388
"1719",2021-12-10,"24 - 1150",120,120,112,8,0,0.933333333333333
"1720",2021-12-10,"24 - 1153",150,185,149,1,35,0.993333333333333
"1721",2021-12-11,"62 - 1011",60,61,59,1,1,0.983333333333333
"1722",2021-12-11,"3 - 1008",212,215,204,8,3,0.962264150943396
"1723",2021-12-11,"16 - 1022",50,50,48,2,0,0.96
"1724",2021-12-11,"24 - 1150",120,120,114,6,0,0.95
"1725",2021-12-11,"24 - 1153",135,185,133,2,50,0.985185185185185
"1726",2021-12-12,"62 - 1011",60,61,60,0,1,1
"1727",2021-12-12,"3 - 1008",212,215,203,9,3,0.957547169811321
"1728",2021-12-12,"16 - 1022",50,50,47,3,0,0.94
"1729",2021-12-12,"24 - 1150",120,120,119,1,0,0.991666666666667
"1730",2021-12-12,"24 - 1153",125,135,123,2,10,0.984
"1731",2021-12-13,"62 - 1011",60,61,58,2,1,0.966666666666667
"1732",2021-12-13,"3 - 1008",212,215,204,8,3,0.962264150943396
"1733",2021-12-13,"16 - 1022",50,50,46,4,0,0.92
"1734",2021-12-13,"24 - 1150",120,120,113,7,0,0.941666666666667
"1735",2021-12-13,"24 - 1153",125,135,125,0,10,1
"1736",2021-12-14,"62 - 1011",59,61,58,1,2,0.983050847457627
"1737",2021-12-14,"3 - 1008",212,215,205,7,3,0.966981132075472
"1738",2021-12-14,"16 - 1022",50,50,47,3,0,0.94
"1739",2021-12-14,"24 - 1150",119,120,111,8,1,0.932773109243697
"1740",2021-12-14,"24 - 1153",125,135,125,0,10,1
"1741",2021-12-15,"62 - 1011",59,61,58,1,2,0.983050847457627
"1742",2021-12-15,"3 - 1008",212,215,207,5,3,0.976415094339623
"1743",2021-12-15,"16 - 1022",50,50,48,2,0,0.96
"1744",2021-12-15,"24 - 1150",119,120,114,5,1,0.957983193277311
"1745",2021-12-15,"24 - 1153",125,135,125,0,10,1
"1746",2021-12-16,"62 - 1011",59,61,58,1,2,0.983050847457627
"1747",2021-12-16,"3 - 1008",222,241,210,12,19,0.945945945945946
"1748",2021-12-16,"16 - 1022",50,50,48,2,0,0.96
"1749",2021-12-16,"24 - 1150",120,120,107,13,0,0.891666666666667
"1750",2021-12-16,"24 - 1153",125,135,124,1,10,0.992
"1751",2021-12-17,"62 - 1011",59,61,59,0,2,1
"1752",2021-12-17,"3 - 1008",222,241,211,11,19,0.95045045045045
"1753",2021-12-17,"16 - 1022",50,50,49,1,0,0.98
"1754",2021-12-17,"24 - 1150",120,120,107,13,0,0.891666666666667
"1755",2021-12-17,"24 - 1153",125,135,125,0,10,1
"1756",2021-12-18,"62 - 1011",59,61,59,0,2,1
"1757",2021-12-18,"3 - 1008",222,241,214,8,19,0.963963963963964
"1758",2021-12-18,"16 - 1022",50,50,47,3,0,0.94
"1759",2021-12-18,"24 - 1150",120,120,112,8,0,0.933333333333333
"1760",2021-12-18,"24 - 1153",125,135,125,0,10,1
"1761",2021-12-19,"62 - 1011",59,61,58,1,2,0.983050847457627
"1762",2021-12-19,"3 - 1008",222,241,215,7,19,0.968468468468468
"1763",2021-12-19,"16 - 1022",50,50,49,1,0,0.98
"1764",2021-12-19,"24 - 1150",120,120,111,9,0,0.925
"1765",2021-12-19,"24 - 1153",125,135,125,0,10,1
"1766",2021-12-20,"62 - 1011",60,61,60,0,1,1
"1767",2021-12-20,"3 - 1008",227,241,214,13,14,0.94273127753304
"1768",2021-12-20,"16 - 1022",50,50,48,2,0,0.96
"1769",2021-12-20,"24 - 1150",120,120,108,12,0,0.9
"1770",2021-12-20,"24 - 1153",125,135,125,0,10,1
"1771",2021-12-21,"62 - 1011",60,61,59,1,1,0.983333333333333
"1772",2021-12-21,"3 - 1008",223,241,214,9,18,0.959641255605381
"1773",2021-12-21,"16 - 1022",50,50,49,1,0,0.98
"1774",2021-12-21,"24 - 1150",120,120,107,13,0,0.891666666666667
"1775",2021-12-21,"24 - 1153",125,135,125,0,10,1
"1776",2021-12-22,"62 - 1011",60,61,60,0,1,1
"1777",2021-12-22,"3 - 1008",222,241,211,11,19,0.95045045045045
"1778",2021-12-22,"16 - 1022",50,50,49,1,0,0.98
"1779",2021-12-22,"24 - 1150",105,120,105,0,15,1
"1780",2021-12-22,"24 - 1153",125,135,124,1,10,0.992
"1781",2021-12-23,"62 - 1011",60,61,60,0,1,1
"1782",2021-12-23,"3 - 1008",218,241,207,11,23,0.94954128440367
"1783",2021-12-23,"16 - 1022",50,50,50,0,0,1
"1784",2021-12-23,"24 - 1150",105,120,102,3,15,0.971428571428571
"1785",2021-12-23,"24 - 1153",125,135,125,0,10,1
"1786",2021-12-24,"62 - 1011",60,61,59,1,1,0.983333333333333
"1787",2021-12-24,"3 - 1008",218,241,210,8,23,0.963302752293578
"1788",2021-12-24,"16 - 1022",49,50,49,0,1,1
"1789",2021-12-24,"24 - 1150",106,120,103,3,14,0.971698113207547
"1790",2021-12-24,"24 - 1153",125,135,125,0,10,1
"1791",2021-12-25,"62 - 1011",60,61,59,1,1,0.983333333333333
"1792",2021-12-25,"3 - 1008",218,241,210,8,23,0.963302752293578
"1793",2021-12-25,"16 - 1022",49,50,49,0,1,1
"1794",2021-12-25,"24 - 1150",106,120,99,7,14,0.933962264150943
"1795",2021-12-25,"24 - 1153",125,135,125,0,10,1
"1796",2021-12-26,"62 - 1011",60,61,58,2,1,0.966666666666667
"1797",2021-12-26,"3 - 1008",218,241,210,8,23,0.963302752293578
"1798",2021-12-26,"16 - 1022",49,50,49,0,1,1
"1799",2021-12-26,"24 - 1150",102,120,96,6,18,0.941176470588235
"1800",2021-12-26,"24 - 1153",125,135,125,0,10,1
"1801",2021-12-27,"62 - 1011",60,61,57,3,1,0.95
"1802",2021-12-27,"3 - 1008",218,241,210,8,23,0.963302752293578
"1803",2021-12-27,"16 - 1022",50,50,50,0,0,1
"1804",2021-12-27,"24 - 1150",96,120,96,0,24,1
"1805",2021-12-27,"24 - 1153",125,135,125,0,10,1
"1806",2021-12-28,"62 - 1011",60,61,58,2,1,0.966666666666667
"1807",2021-12-28,"3 - 1008",217,241,208,9,24,0.95852534562212
"1808",2021-12-28,"16 - 1022",50,50,50,0,0,1
"1809",2021-12-28,"24 - 1150",91,120,91,0,29,1
"1810",2021-12-28,"24 - 1153",125,135,125,0,10,1
"1811",2021-12-29,"62 - 1011",60,61,57,3,1,0.95
"1812",2021-12-29,"3 - 1008",216,241,207,9,25,0.958333333333333
"1813",2021-12-29,"16 - 1022",50,50,50,0,0,1
"1814",2021-12-29,"24 - 1150",98,120,96,2,22,0.979591836734694
"1815",2021-12-29,"24 - 1153",125,135,125,0,10,1
"1816",2021-12-30,"62 - 1011",59,61,58,1,2,0.983050847457627
"1817",2021-12-30,"3 - 1008",224,241,200,24,17,0.892857142857143
"1818",2021-12-30,"16 - 1022",50,50,50,0,0,1
"1819",2021-12-30,"24 - 1150",97,120,95,2,23,0.979381443298969
"1820",2021-12-30,"24 - 1153",125,135,125,0,10,1
"1821",2021-12-31,"62 - 1011",59,61,58,1,2,0.983050847457627
"1822",2021-12-31,"3 - 1008",212,241,195,17,29,0.919811320754717
"1823",2021-12-31,"16 - 1022",50,50,50,0,0,1
"1824",2021-12-31,"24 - 1150",97,120,96,1,23,0.989690721649485
"1825",2021-12-31,"24 - 1153",125,135,125,0,10,1
"1826",2022-01-01,"62 - 1011",59,61,56,3,2,0.949152542372881
"1827",2022-01-01,"3 - 1008",212,241,194,18,29,0.915094339622642
"1828",2022-01-01,"16 - 1022",50,50,50,0,0,1
"1829",2022-01-01,"24 - 1150",97,120,97,0,23,1
"1830",2022-01-01,"24 - 1153",125,135,125,0,10,1
"1831",2022-01-02,"62 - 1011",59,61,58,1,2,0.983050847457627
"1832",2022-01-02,"3 - 1008",212,241,193,19,29,0.910377358490566
"1833",2022-01-02,"16 - 1022",50,50,50,0,0,1
"1834",2022-01-02,"24 - 1150",97,120,96,1,23,0.989690721649485
"1835",2022-01-02,"24 - 1153",125,135,125,0,10,1
"1836",2022-01-03,"62 - 1011",59,61,58,1,2,0.983050847457627
"1837",2022-01-03,"3 - 1008",212,241,194,18,29,0.915094339622642
"1838",2022-01-03,"16 - 1022",50,50,50,0,0,1
"1839",2022-01-03,"24 - 1150",109,120,102,7,11,0.935779816513762
"1840",2022-01-03,"24 - 1153",174,185,150,24,11,0.862068965517241
"1841",2022-01-04,"62 - 1011",59,61,57,2,2,0.966101694915254
"1842",2022-01-04,"3 - 1008",212,241,192,20,29,0.905660377358491
"1843",2022-01-04,"16 - 1022",50,50,49,1,0,0.98
"1844",2022-01-04,"24 - 1150",109,120,104,5,11,0.954128440366973
"1845",2022-01-04,"24 - 1153",124,135,124,0,11,1
"1846",2022-01-05,"62 - 1011",59,61,58,1,2,0.983050847457627
"1847",2022-01-05,"3 - 1008",206,241,189,17,35,0.91747572815534
"1848",2022-01-05,"16 - 1022",50,50,48,2,0,0.96
"1849",2022-01-05,"24 - 1150",109,120,101,8,11,0.926605504587156
"1850",2022-01-05,"24 - 1153",124,135,124,0,11,1
"1851",2022-01-06,"62 - 1011",59,61,58,1,2,0.983050847457627
"1852",2022-01-06,"3 - 1008",207,241,191,16,34,0.922705314009662
"1853",2022-01-06,"16 - 1022",50,50,47,3,0,0.94
"1854",2022-01-06,"24 - 1150",109,120,105,4,11,0.963302752293578
"1855",2022-01-06,"24 - 1153",133,135,133,0,2,1
"1856",2022-01-07,"62 - 1011",59,61,58,1,2,0.983050847457627
"1857",2022-01-07,"3 - 1008",204,241,193,11,37,0.946078431372549
"1858",2022-01-07,"16 - 1022",50,50,48,2,0,0.96
"1859",2022-01-07,"24 - 1150",106,120,106,0,14,1
"1860",2022-01-07,"24 - 1153",182,185,145,37,3,0.796703296703297
"1861",2022-01-08,"62 - 1011",60,61,58,2,1,0.966666666666667
"1862",2022-01-08,"3 - 1008",204,241,191,13,37,0.936274509803922
"1863",2022-01-08,"16 - 1022",50,50,48,2,0,0.96
"1864",2022-01-08,"24 - 1150",106,120,106,0,14,1
"1865",2022-01-08,"24 - 1153",181,185,173,8,4,0.955801104972376
"1866",2022-01-09,"62 - 1011",60,61,60,0,1,1
"1867",2022-01-09,"3 - 1008",204,241,193,11,37,0.946078431372549
"1868",2022-01-09,"16 - 1022",50,50,48,2,0,0.96
"1869",2022-01-09,"24 - 1150",106,120,106,0,14,1
"1870",2022-01-09,"24 - 1153",181,185,181,0,4,1
"1871",2022-01-10,"62 - 1011",60,61,60,0,1,1
"1872",2022-01-10,"3 - 1008",205,241,194,11,36,0.946341463414634
"1873",2022-01-10,"16 - 1022",50,50,47,3,0,0.94
"1874",2022-01-10,"24 - 1150",106,120,105,1,14,0.990566037735849
"1875",2022-01-10,"24 - 1153",207,210,200,7,3,0.966183574879227
"1876",2022-01-11,"62 - 1011",65,76,65,0,11,1
"1877",2022-01-11,"3 - 1008",207,241,191,16,34,0.922705314009662
"1878",2022-01-11,"16 - 1022",50,50,46,4,0,0.92
"1879",2022-01-11,"24 - 1150",106,120,105,1,14,0.990566037735849
"1880",2022-01-11,"24 - 1153",208,210,207,1,2,0.995192307692308
"1881",2022-01-12,"62 - 1011",60,61,59,1,1,0.983333333333333
"1882",2022-01-12,"3 - 1008",210,246,195,15,36,0.928571428571429
"1883",2022-01-12,"16 - 1022",50,50,47,3,0,0.94
"1884",2022-01-12,"24 - 1150",103,120,101,2,17,0.980582524271845
"1885",2022-01-12,"24 - 1153",208,210,207,1,2,0.995192307692308
"1886",2022-01-13,"62 - 1011",60,61,58,2,1,0.966666666666667
"1887",2022-01-13,"3 - 1008",210,246,195,15,36,0.928571428571429
"1888",2022-01-13,"16 - 1022",50,50,44,6,0,0.88
"1889",2022-01-13,"24 - 1150",102,120,102,0,18,1
"1890",2022-01-13,"24 - 1153",207,210,205,2,3,0.990338164251208
"1891",2022-01-14,"62 - 1011",60,61,57,3,1,0.95
"1892",2022-01-14,"3 - 1008",221,246,196,25,25,0.886877828054299
"1893",2022-01-14,"16 - 1022",50,50,44,6,0,0.88
"1894",2022-01-14,"24 - 1150",103,120,102,1,17,0.990291262135922
"1895",2022-01-14,"24 - 1153",207,210,207,0,3,1
"1896",2022-01-15,"62 - 1011",60,61,59,1,1,0.983333333333333
"1897",2022-01-15,"3 - 1008",223,246,194,29,23,0.869955156950673
"1898",2022-01-15,"16 - 1022",50,50,42,8,0,0.84
"1899",2022-01-15,"24 - 1150",103,120,102,1,17,0.990291262135922
"1900",2022-01-15,"24 - 1153",207,210,206,1,3,0.995169082125604
"1901",2022-01-16,"62 - 1011",60,61,60,0,1,1
"1902",2022-01-16,"3 - 1008",223,246,195,28,23,0.874439461883408
"1903",2022-01-16,"16 - 1022",50,50,43,7,0,0.86
"1904",2022-01-16,"24 - 1150",103,120,102,1,17,0.990291262135922
"1905",2022-01-16,"24 - 1153",208,210,202,6,2,0.971153846153846
"1906",2022-01-17,"62 - 1011",60,61,60,0,1,1
"1907",2022-01-17,"3 - 1008",220,246,194,26,26,0.881818181818182
"1908",2022-01-17,"16 - 1022",50,50,42,8,0,0.84
"1909",2022-01-17,"24 - 1150",106,120,106,0,14,1
"1910",2022-01-17,"24 - 1153",208,210,200,8,2,0.961538461538462
"1911",2022-01-18,"62 - 1011",59,61,59,0,2,1
"1912",2022-01-18,"3 - 1008",220,246,194,26,26,0.881818181818182
"1913",2022-01-18,"16 - 1022",50,50,43,7,0,0.86
"1914",2022-01-18,"24 - 1150",109,120,104,5,11,0.954128440366973
"1915",2022-01-18,"24 - 1153",210,210,204,6,0,0.971428571428571
"1916",2022-01-19,"62 - 1011",64,76,64,0,12,1
"1917",2022-01-19,"3 - 1008",220,246,195,25,26,0.886363636363636
"1918",2022-01-19,"16 - 1022",50,50,43,7,0,0.86
"1919",2022-01-19,"24 - 1150",105,120,105,0,15,1
"1920",2022-01-19,"24 - 1153",210,210,209,1,0,0.995238095238095
"1921",2022-01-20,"62 - 1011",64,76,64,0,12,1
"1922",2022-01-20,"3 - 1008",217,246,193,24,29,0.889400921658986
"1923",2022-01-20,"16 - 1022",50,50,44,6,0,0.88
"1924",2022-01-20,"24 - 1150",100,120,97,3,20,0.97
"1925",2022-01-20,"24 - 1153",209,210,209,0,1,1
"1926",2022-01-21,"62 - 1011",64,76,60,4,12,0.9375
"1927",2022-01-21,"3 - 1008",216,246,194,22,30,0.898148148148148
"1928",2022-01-21,"16 - 1022",50,50,44,6,0,0.88
"1929",2022-01-21,"24 - 1150",101,120,99,2,19,0.98019801980198
"1930",2022-01-21,"24 - 1153",210,210,209,1,0,0.995238095238095
"1931",2022-01-22,"62 - 1011",64,76,62,2,12,0.96875
"1932",2022-01-22,"3 - 1008",217,246,194,23,29,0.894009216589862
"1933",2022-01-22,"16 - 1022",50,50,44,6,0,0.88
"1934",2022-01-22,"24 - 1150",102,120,101,1,18,0.990196078431373
"1935",2022-01-22,"24 - 1153",210,210,210,0,0,1
"1936",2022-01-23,"62 - 1011",64,76,62,2,12,0.96875
"1937",2022-01-23,"3 - 1008",210,246,192,18,36,0.914285714285714
"1938",2022-01-23,"16 - 1022",50,50,45,5,0,0.9
"1939",2022-01-23,"24 - 1150",107,120,107,0,13,1
"1940",2022-01-23,"24 - 1153",210,210,208,2,0,0.99047619047619
"1941",2022-01-24,"62 - 1011",64,76,62,2,12,0.96875
"1942",2022-01-24,"3 - 1008",211,246,189,22,35,0.895734597156398
"1943",2022-01-24,"16 - 1022",50,50,44,6,0,0.88
"1944",2022-01-24,"24 - 1150",109,120,108,1,11,0.990825688073395
"1945",2022-01-24,"24 - 1153",210,210,208,2,0,0.99047619047619
"1946",2022-01-25,"62 - 1011",64,76,62,2,12,0.96875
"1947",2022-01-25,"3 - 1008",194,246,188,6,52,0.969072164948454
"1948",2022-01-25,"16 - 1022",50,50,45,5,0,0.9
"1949",2022-01-25,"24 - 1150",108,120,104,4,12,0.962962962962963
"1950",2022-01-25,"24 - 1153",210,210,209,1,0,0.995238095238095
"1951",2022-01-26,"62 - 1011",64,76,63,1,12,0.984375
"1952",2022-01-26,"3 - 1008",194,246,188,6,52,0.969072164948454
"1953",2022-01-26,"16 - 1022",50,50,45,5,0,0.9
"1954",2022-01-26,"24 - 1150",107,120,106,1,13,0.990654205607477
"1955",2022-01-26,"24 - 1153",209,210,208,1,1,0.995215311004785
"1956",2022-01-27,"62 - 1011",64,76,64,0,12,1
"1957",2022-01-27,"3 - 1008",202,246,188,14,44,0.930693069306931
"1958",2022-01-27,"16 - 1022",50,50,45,5,0,0.9
"1959",2022-01-27,"24 - 1150",106,120,105,1,14,0.990566037735849
"1960",2022-01-27,"24 - 1153",209,210,208,1,1,0.995215311004785
"1961",2022-01-28,"62 - 1011",65,76,65,0,11,1
"1962",2022-01-28,"3 - 1008",203,246,187,16,43,0.921182266009852
"1963",2022-01-28,"16 - 1022",50,50,45,5,0,0.9
"1964",2022-01-28,"24 - 1150",107,120,98,9,13,0.91588785046729
"1965",2022-01-28,"24 - 1153",210,210,210,0,0,1
"1966",2022-01-29,"62 - 1011",65,76,65,0,11,1
"1967",2022-01-29,"3 - 1008",212,246,188,24,34,0.886792452830189
"1968",2022-01-29,"16 - 1022",50,50,44,6,0,0.88
"1969",2022-01-29,"24 - 1150",107,120,100,7,13,0.934579439252336
"1970",2022-01-29,"24 - 1153",210,210,210,0,0,1
"1971",2022-01-30,"62 - 1011",65,76,62,3,11,0.953846153846154
"1972",2022-01-30,"3 - 1008",212,246,193,19,34,0.910377358490566
"1973",2022-01-30,"16 - 1022",50,50,45,5,0,0.9
"1974",2022-01-30,"24 - 1150",107,120,102,5,13,0.953271028037383
"1975",2022-01-30,"24 - 1153",210,210,208,2,0,0.99047619047619
"1976",2022-01-31,"62 - 1011",65,76,64,1,11,0.984615384615385
"1977",2022-01-31,"3 - 1008",211,246,199,12,35,0.943127962085308
"1978",2022-01-31,"16 - 1022",50,50,42,8,0,0.84
"1979",2022-01-31,"24 - 1150",107,120,100,7,13,0.934579439252336
"1980",2022-01-31,"24 - 1153",210,210,210,0,0,1
"1981",2022-02-01,"62 - 1011",65,76,64,1,11,0.984615384615385
"1982",2022-02-01,"3 - 1008",209,246,198,11,37,0.947368421052632
"1983",2022-02-01,"16 - 1022",50,50,41,9,0,0.82
"1984",2022-02-01,"24 - 1150",107,120,104,3,13,0.97196261682243
"1985",2022-02-01,"24 - 1153",204,210,194,10,6,0.950980392156863
"1986",2022-02-02,"62 - 1011",65,76,62,3,11,0.953846153846154
"1987",2022-02-02,"3 - 1008",219,230,208,11,11,0.949771689497717
"1988",2022-02-02,"16 - 1022",50,50,42,8,0,0.84
"1989",2022-02-02,"24 - 1150",108,120,95,13,12,0.87962962962963
"1990",2022-02-02,"24 - 1153",210,210,199,11,0,0.947619047619048
"1991",2022-02-03,"62 - 1011",65,76,64,1,11,0.984615384615385
"1992",2022-02-03,"3 - 1008",218,230,212,6,12,0.972477064220184
"1993",2022-02-03,"16 - 1022",50,52,43,7,2,0.86
"1994",2022-02-03,"24 - 1150",108,120,100,8,12,0.925925925925926
"1995",2022-02-03,"24 - 1153",210,210,206,4,0,0.980952380952381
"1996",2022-02-04,"62 - 1011",65,76,63,2,11,0.969230769230769
"1997",2022-02-04,"3 - 1008",217,230,210,7,13,0.967741935483871
"1998",2022-02-04,"16 - 1022",52,52,48,4,0,0.923076923076923
"1999",2022-02-04,"24 - 1150",110,120,92,18,10,0.836363636363636
"2000",2022-02-04,"24 - 1153",225,225,216,9,0,0.96
"2001",2022-02-05,"62 - 1011",65,76,60,5,11,0.923076923076923
"2002",2022-02-05,"3 - 1008",217,230,209,8,13,0.963133640552995
"2003",2022-02-05,"16 - 1022",52,52,47,5,0,0.903846153846154
"2004",2022-02-05,"24 - 1150",112,120,98,14,8,0.875
"2005",2022-02-05,"24 - 1153",225,225,223,2,0,0.991111111111111
"2006",2022-02-06,"62 - 1011",60,61,59,1,1,0.983333333333333
"2007",2022-02-06,"3 - 1008",217,230,211,6,13,0.972350230414747
"2008",2022-02-06,"16 - 1022",52,52,48,4,0,0.923076923076923
"2009",2022-02-06,"24 - 1150",116,120,99,17,4,0.853448275862069
"2010",2022-02-06,"24 - 1153",225,225,224,1,0,0.995555555555556
"2011",2022-02-07,"62 - 1011",61,76,60,1,15,0.983606557377049
"2012",2022-02-07,"3 - 1008",219,230,210,9,11,0.958904109589041
"2013",2022-02-07,"16 - 1022",51,52,47,4,1,0.92156862745098
"2014",2022-02-07,"24 - 1150",116,120,101,15,4,0.870689655172414
"2015",2022-02-07,"24 - 1153",225,225,224,1,0,0.995555555555556
"2016",2022-02-08,"62 - 1011",60,61,60,0,1,1
"2017",2022-02-08,"3 - 1008",218,230,212,6,12,0.972477064220184
"2018",2022-02-08,"16 - 1022",50,52,46,4,2,0.92
"2019",2022-02-08,"24 - 1150",106,120,105,1,14,0.990566037735849
"2020",2022-02-08,"24 - 1153",210,225,209,1,15,0.995238095238095
"2021",2022-02-09,"62 - 1011",60,61,60,0,1,1
"2022",2022-02-09,"3 - 1008",218,230,213,5,12,0.977064220183486
"2023",2022-02-09,"16 - 1022",50,52,49,1,2,0.98
"2024",2022-02-09,"24 - 1150",105,120,105,0,15,1
"2025",2022-02-09,"24 - 1153",210,225,210,0,15,1
"2026",2022-02-10,"62 - 1011",60,61,60,0,1,1
"2027",2022-02-10,"3 - 1008",218,230,209,9,12,0.958715596330275
"2028",2022-02-10,"16 - 1022",50,52,49,1,2,0.98
"2029",2022-02-10,"24 - 1150",106,120,97,9,14,0.915094339622642
"2030",2022-02-10,"24 - 1153",210,225,210,0,15,1
"2031",2022-02-11,"62 - 1011",60,61,60,0,1,1
"2032",2022-02-11,"3 - 1008",218,230,210,8,12,0.963302752293578
"2033",2022-02-11,"16 - 1022",50,52,48,2,2,0.96
"2034",2022-02-11,"24 - 1150",106,120,99,7,14,0.933962264150943
"2035",2022-02-11,"24 - 1153",210,225,210,0,15,1
"2036",2022-02-12,"62 - 1011",65,76,62,3,11,0.953846153846154
"2037",2022-02-12,"3 - 1008",218,230,208,10,12,0.954128440366973
"2038",2022-02-12,"16 - 1022",50,52,48,2,2,0.96
"2039",2022-02-12,"24 - 1150",108,120,107,1,12,0.990740740740741
"2040",2022-02-12,"24 - 1153",210,225,209,1,15,0.995238095238095
"2041",2022-02-13,"62 - 1011",65,76,65,0,11,1
"2042",2022-02-13,"3 - 1008",219,230,211,8,11,0.963470319634703
"2043",2022-02-13,"16 - 1022",50,52,48,2,2,0.96
"2044",2022-02-13,"24 - 1150",110,120,110,0,10,1
"2045",2022-02-13,"24 - 1153",210,225,210,0,15,1
"2046",2022-02-14,"62 - 1011",65,76,64,1,11,0.984615384615385
"2047",2022-02-14,"3 - 1008",219,230,209,10,11,0.954337899543379
"2048",2022-02-14,"16 - 1022",52,52,47,5,0,0.903846153846154
"2049",2022-02-14,"24 - 1150",110,120,110,0,10,1
"2050",2022-02-14,"24 - 1153",210,225,210,0,15,1
"2051",2022-02-15,"62 - 1011",65,76,64,1,11,0.984615384615385
"2052",2022-02-15,"3 - 1008",220,230,214,6,10,0.972727272727273
"2053",2022-02-15,"16 - 1022",50,52,48,2,2,0.96
"2054",2022-02-15,"24 - 1150",108,120,106,2,12,0.981481481481482
"2055",2022-02-15,"24 - 1153",210,225,210,0,15,1
"2056",2022-02-16,"62 - 1011",65,76,64,1,11,0.984615384615385
"2057",2022-02-16,"3 - 1008",230,240,220,10,10,0.956521739130435
"2058",2022-02-16,"16 - 1022",50,52,48,2,2,0.96
"2059",2022-02-16,"24 - 1150",106,120,103,3,14,0.971698113207547
"2060",2022-02-16,"24 - 1153",210,225,209,1,15,0.995238095238095
"2061",2022-02-17,"62 - 1011",65,76,65,0,11,1
"2062",2022-02-17,"3 - 1008",230,240,224,6,10,0.973913043478261
"2063",2022-02-17,"16 - 1022",50,52,50,0,2,1
"2064",2022-02-17,"24 - 1150",104,120,101,3,16,0.971153846153846
"2065",2022-02-17,"24 - 1153",210,225,210,0,15,1
"2066",2022-02-18,"62 - 1011",65,76,65,0,11,1
"2067",2022-02-18,"3 - 1008",230,240,225,5,10,0.978260869565217
"2068",2022-02-18,"16 - 1022",50,52,50,0,2,1
"2069",2022-02-18,"24 - 1150",104,120,104,0,16,1
"2070",2022-02-18,"24 - 1153",210,225,210,0,15,1
"2071",2022-02-19,"62 - 1011",65,76,65,0,11,1
"2072",2022-02-19,"3 - 1008",230,240,225,5,10,0.978260869565217
"2073",2022-02-19,"16 - 1022",50,52,49,1,2,0.98
"2074",2022-02-19,"24 - 1150",106,120,105,1,14,0.990566037735849
"2075",2022-02-19,"24 - 1153",210,225,210,0,15,1
"2076",2022-02-20,"62 - 1011",63,76,63,0,13,1
"2077",2022-02-20,"3 - 1008",230,240,225,5,10,0.978260869565217
"2078",2022-02-20,"16 - 1022",50,52,50,0,2,1
"2079",2022-02-20,"24 - 1150",106,120,104,2,14,0.981132075471698
"2080",2022-02-20,"24 - 1153",210,225,209,1,15,0.995238095238095
"2081",2022-02-21,"62 - 1011",65,76,65,0,11,1
"2082",2022-02-21,"3 - 1008",230,240,223,7,10,0.969565217391304
"2083",2022-02-21,"16 - 1022",50,52,49,1,2,0.98
"2084",2022-02-21,"24 - 1150",110,120,107,3,10,0.972727272727273
"2085",2022-02-21,"24 - 1153",210,225,210,0,15,1
"2086",2022-02-22,"62 - 1011",65,76,63,2,11,0.969230769230769
"2087",2022-02-22,"3 - 1008",230,240,224,6,10,0.973913043478261
"2088",2022-02-22,"16 - 1022",50,52,49,1,2,0.98
"2089",2022-02-22,"24 - 1150",110,120,109,1,10,0.990909090909091
"2090",2022-02-22,"24 - 1153",210,225,207,3,15,0.985714285714286
"2091",2022-02-23,"62 - 1011",65,76,64,1,11,0.984615384615385
"2092",2022-02-23,"3 - 1008",230,240,224,6,10,0.973913043478261
"2093",2022-02-23,"16 - 1022",50,52,47,3,2,0.94
"2094",2022-02-23,"24 - 1150",110,120,109,1,10,0.990909090909091
"2095",2022-02-23,"24 - 1153",210,225,208,2,15,0.99047619047619
"2096",2022-02-24,"62 - 1011",65,76,62,3,11,0.953846153846154
"2097",2022-02-24,"3 - 1008",230,240,221,9,10,0.960869565217391
"2098",2022-02-24,"16 - 1022",50,52,46,4,2,0.92
"2099",2022-02-24,"24 - 1150",110,120,110,0,10,1
"2100",2022-02-24,"24 - 1153",210,225,210,0,15,1
"2101",2022-02-25,"62 - 1011",65,76,63,2,11,0.969230769230769
"2102",2022-02-25,"3 - 1008",230,240,223,7,10,0.969565217391304
"2103",2022-02-25,"16 - 1022",52,52,49,3,0,0.942307692307692
"2104",2022-02-25,"24 - 1150",110,120,109,1,10,0.990909090909091
"2105",2022-02-25,"24 - 1153",210,225,207,3,15,0.985714285714286
"2106",2022-02-26,"62 - 1011",65,76,63,2,11,0.969230769230769
"2107",2022-02-26,"3 - 1008",230,240,223,7,10,0.969565217391304
"2108",2022-02-26,"16 - 1022",52,52,49,3,0,0.942307692307692
"2109",2022-02-26,"24 - 1150",110,120,108,2,10,0.981818181818182
"2110",2022-02-26,"24 - 1153",210,225,207,3,15,0.985714285714286
"2111",2022-02-27,"62 - 1011",65,76,63,2,11,0.969230769230769
"2112",2022-02-27,"3 - 1008",230,240,223,7,10,0.969565217391304
"2113",2022-02-27,"16 - 1022",52,52,48,4,0,0.923076923076923
"2114",2022-02-27,"24 - 1150",110,120,109,1,10,0.990909090909091
"2115",2022-02-27,"24 - 1153",210,225,207,3,15,0.985714285714286
"2116",2022-02-28,"62 - 1011",65,76,65,0,11,1
"2117",2022-02-28,"3 - 1008",229,240,222,7,11,0.96943231441048
"2118",2022-02-28,"16 - 1022",52,52,50,2,0,0.961538461538462
"2119",2022-02-28,"24 - 1150",110,120,109,1,10,0.990909090909091
"2120",2022-02-28,"24 - 1153",210,225,210,0,15,1
"2121",2022-03-01,"62 - 1011",65,76,64,1,11,0.984615384615385
"2122",2022-03-01,"3 - 1008",229,240,223,6,11,0.973799126637555
"2123",2022-03-01,"16 - 1022",50,52,47,3,2,0.94
"2124",2022-03-01,"24 - 1150",110,120,105,5,10,0.954545454545455
"2125",2022-03-01,"24 - 1153",210,225,208,2,15,0.99047619047619
"2126",2022-03-02,"62 - 1011",65,76,65,0,11,1
"2127",2022-03-02,"3 - 1008",229,240,224,5,11,0.978165938864629
"2128",2022-03-02,"16 - 1022",50,52,49,1,2,0.98
"2129",2022-03-02,"24 - 1150",110,120,110,0,10,1
"2130",2022-03-02,"24 - 1153",210,225,209,1,15,0.995238095238095
"2131",2022-03-03,"62 - 1011",65,76,65,0,11,1
"2132",2022-03-03,"3 - 1008",230,240,227,3,10,0.98695652173913
"2133",2022-03-03,"16 - 1022",50,52,49,1,2,0.98
"2134",2022-03-03,"24 - 1150",110,120,108,2,10,0.981818181818182
"2135",2022-03-03,"24 - 1153",210,225,210,0,15,1
"2136",2022-03-04,"62 - 1011",65,76,65,0,11,1
"2137",2022-03-04,"3 - 1008",230,240,226,4,10,0.982608695652174
"2138",2022-03-04,"16 - 1022",50,52,50,0,2,1
"2139",2022-03-04,"24 - 1150",109,120,107,2,11,0.981651376146789
"2140",2022-03-04,"24 - 1153",210,225,209,1,15,0.995238095238095
"2141",2022-03-05,"62 - 1011",65,76,65,0,11,1
"2142",2022-03-05,"3 - 1008",230,240,227,3,10,0.98695652173913
"2143",2022-03-05,"16 - 1022",50,52,49,1,2,0.98
"2144",2022-03-05,"24 - 1150",108,120,107,1,12,0.990740740740741
"2145",2022-03-05,"24 - 1153",210,225,209,1,15,0.995238095238095
"2146",2022-03-06,"62 - 1011",65,76,65,0,11,1
"2147",2022-03-06,"3 - 1008",230,240,226,4,10,0.982608695652174
"2148",2022-03-06,"16 - 1022",50,52,49,1,2,0.98
"2149",2022-03-06,"24 - 1150",108,120,107,1,12,0.990740740740741
"2150",2022-03-06,"24 - 1153",210,225,210,0,15,1
"2151",2022-03-07,"62 - 1011",61,76,61,0,15,1
"2152",2022-03-07,"3 - 1008",220,230,217,3,10,0.986363636363636
"2153",2022-03-07,"16 - 1022",50,52,49,1,2,0.98
"2154",2022-03-07,"24 - 1150",108,120,106,2,12,0.981481481481482
"2155",2022-03-07,"24 - 1153",210,225,186,24,15,0.885714285714286
"2156",2022-03-08,"62 - 1011",61,76,60,1,15,0.983606557377049
"2157",2022-03-08,"3 - 1008",220,230,215,5,10,0.977272727272727
"2158",2022-03-08,"16 - 1022",50,52,48,2,2,0.96
"2159",2022-03-08,"24 - 1150",108,120,106,2,12,0.981481481481482
"2160",2022-03-08,"24 - 1153",150,165,150,0,15,1
"2161",2022-03-09,"62 - 1011",61,76,60,1,15,0.983606557377049
"2162",2022-03-09,"3 - 1008",220,230,217,3,10,0.986363636363636
"2163",2022-03-09,"16 - 1022",50,52,49,1,2,0.98
"2164",2022-03-09,"24 - 1150",108,120,106,2,12,0.981481481481482
"2165",2022-03-09,"24 - 1153",210,225,180,30,15,0.857142857142857
"2166",2022-03-10,"62 - 1011",60,61,60,0,1,1
"2167",2022-03-10,"3 - 1008",222,230,217,5,8,0.977477477477477
"2168",2022-03-10,"16 - 1022",50,52,49,1,2,0.98
"2169",2022-03-10,"24 - 1150",108,120,108,0,12,1
"2170",2022-03-10,"24 - 1153",210,225,208,2,15,0.99047619047619
"2171",2022-03-11,"62 - 1011",60,61,60,0,1,1
"2172",2022-03-11,"3 - 1008",240,240,226,14,0,0.941666666666667
"2173",2022-03-11,"16 - 1022",52,52,51,1,0,0.980769230769231
"2174",2022-03-11,"24 - 1150",108,120,106,2,12,0.981481481481482
"2175",2022-03-11,"24 - 1153",225,225,212,13,0,0.942222222222222
"2176",2022-03-12,"62 - 1011",65,76,65,0,11,1
"2177",2022-03-12,"3 - 1008",240,240,226,14,0,0.941666666666667
"2178",2022-03-12,"16 - 1022",52,52,51,1,0,0.980769230769231
"2179",2022-03-12,"24 - 1150",108,120,106,2,12,0.981481481481482
"2180",2022-03-12,"24 - 1153",225,225,222,3,0,0.986666666666667
"2181",2022-03-13,"62 - 1011",65,76,65,0,11,1
"2182",2022-03-13,"3 - 1008",240,240,233,7,0,0.970833333333333
"2183",2022-03-13,"16 - 1022",52,52,50,2,0,0.961538461538462
"2184",2022-03-13,"24 - 1150",108,120,107,1,12,0.990740740740741
"2185",2022-03-13,"24 - 1153",225,225,225,0,0,1
"2186",2022-03-14,"62 - 1011",65,76,65,0,11,1
"2187",2022-03-14,"3 - 1008",239,240,231,8,1,0.96652719665272
"2188",2022-03-14,"16 - 1022",52,52,51,1,0,0.980769230769231
"2189",2022-03-14,"24 - 1150",108,120,108,0,12,1
"2190",2022-03-14,"24 - 1153",225,225,224,1,0,0.995555555555556
"2191",2022-03-15,"62 - 1011",60,61,60,0,1,1
"2192",2022-03-15,"3 - 1008",237,240,229,8,3,0.966244725738397
"2193",2022-03-15,"16 - 1022",52,52,51,1,0,0.980769230769231
"2194",2022-03-15,"24 - 1150",107,120,107,0,13,1
"2195",2022-03-15,"24 - 1153",225,225,224,1,0,0.995555555555556
"2196",2022-03-16,"62 - 1011",65,76,61,4,11,0.938461538461538
"2197",2022-03-16,"3 - 1008",229,230,223,6,1,0.973799126637555
"2198",2022-03-16,"16 - 1022",52,52,50,2,0,0.961538461538462
"2199",2022-03-16,"24 - 1150",108,120,106,2,12,0.981481481481482
"2200",2022-03-16,"24 - 1153",223,225,222,1,2,0.995515695067265
"2201",2022-03-17,"62 - 1011",60,60,60,0,0,1
"2202",2022-03-17,"3 - 1008",230,230,220,10,0,0.956521739130435
"2203",2022-03-17,"16 - 1022",52,52,50,2,0,0.961538461538462
"2204",2022-03-17,"24 - 1150",108,120,108,0,12,1
"2205",2022-03-17,"24 - 1153",222,225,220,2,3,0.990990990990991
"2206",2022-03-18,"62 - 1011",60,60,60,0,0,1
"2207",2022-03-18,"3 - 1008",230,230,221,9,0,0.960869565217391
"2208",2022-03-18,"16 - 1022",52,52,51,1,0,0.980769230769231
"2209",2022-03-18,"24 - 1150",108,120,106,2,12,0.981481481481482
"2210",2022-03-18,"24 - 1153",225,225,223,2,0,0.991111111111111
"2211",2022-03-19,"62 - 1011",60,60,60,0,0,1
"2212",2022-03-19,"3 - 1008",230,230,221,9,0,0.960869565217391
"2213",2022-03-19,"16 - 1022",52,52,51,1,0,0.980769230769231
"2214",2022-03-19,"24 - 1150",108,120,108,0,12,1
"2215",2022-03-19,"24 - 1153",225,225,224,1,0,0.995555555555556
"2216",2022-03-20,"62 - 1011",60,60,60,0,0,1
"2217",2022-03-20,"3 - 1008",230,230,221,9,0,0.960869565217391
"2218",2022-03-20,"16 - 1022",52,52,50,2,0,0.961538461538462
"2219",2022-03-20,"24 - 1150",108,120,108,0,12,1
"2220",2022-03-20,"24 - 1153",225,225,224,1,0,0.995555555555556
"2221",2022-03-21,"62 - 1011",65,65,61,4,0,0.938461538461538
"2222",2022-03-21,"3 - 1008",230,230,221,9,0,0.960869565217391
"2223",2022-03-21,"16 - 1022",52,52,51,1,0,0.980769230769231
"2224",2022-03-21,"24 - 1150",107,120,106,1,13,0.990654205607477
"2225",2022-03-21,"24 - 1153",224,225,224,0,1,1
"2226",2022-03-22,"62 - 1011",60,60,60,0,0,1
"2227",2022-03-22,"3 - 1008",229,230,219,10,1,0.956331877729258
"2228",2022-03-22,"16 - 1022",52,52,52,0,0,1
"2229",2022-03-22,"24 - 1150",108,120,108,0,12,1
"2230",2022-03-22,"24 - 1153",225,225,221,4,0,0.982222222222222
"2231",2022-03-23,"62 - 1011",60,60,60,0,0,1
"2232",2022-03-23,"3 - 1008",230,230,219,11,0,0.952173913043478
"2233",2022-03-23,"16 - 1022",52,52,51,1,0,0.980769230769231
"2234",2022-03-23,"24 - 1150",106,120,105,1,14,0.990566037735849
"2235",2022-03-23,"24 - 1153",225,225,225,0,0,1
"2236",2022-03-24,"62 - 1011",60,60,60,0,0,1
"2237",2022-03-24,"3 - 1008",230,230,219,11,0,0.952173913043478
"2238",2022-03-24,"16 - 1022",52,52,51,1,0,0.980769230769231
"2239",2022-03-24,"24 - 1150",110,120,110,0,10,1
"2240",2022-03-24,"24 - 1153",224,225,223,1,1,0.995535714285714
"2241",2022-03-25,"62 - 1011",65,65,65,0,0,1
"2242",2022-03-25,"3 - 1008",240,240,229,11,0,0.954166666666667
"2243",2022-03-25,"16 - 1022",50,52,48,2,2,0.96
"2244",2022-03-25,"24 - 1150",109,120,108,1,11,0.990825688073395
"2245",2022-03-25,"24 - 1153",225,225,224,1,0,0.995555555555556
"2246",2022-03-26,"62 - 1011",65,65,62,3,0,0.953846153846154
"2247",2022-03-26,"3 - 1008",240,240,230,10,0,0.958333333333333
"2248",2022-03-26,"16 - 1022",50,52,49,1,2,0.98
"2249",2022-03-26,"24 - 1150",106,120,106,0,14,1
"2250",2022-03-26,"24 - 1153",223,225,223,0,2,1
"2251",2022-03-27,"62 - 1011",65,65,64,1,0,0.984615384615385
"2252",2022-03-27,"3 - 1008",240,240,228,12,0,0.95
"2253",2022-03-27,"16 - 1022",50,52,48,2,2,0.96
"2254",2022-03-27,"24 - 1150",104,120,104,0,16,1
"2255",2022-03-27,"24 - 1153",223,225,223,0,2,1
"2256",2022-03-28,"62 - 1011",65,65,64,1,0,0.984615384615385
"2257",2022-03-28,"3 - 1008",240,240,230,10,0,0.958333333333333
"2258",2022-03-28,"16 - 1022",50,52,48,2,2,0.96
"2259",2022-03-28,"24 - 1150",99,120,99,0,21,1
"2260",2022-03-28,"24 - 1153",225,225,225,0,0,1
"2261",2022-03-29,"62 - 1011",65,65,65,0,0,1
"2262",2022-03-29,"3 - 1008",240,240,228,12,0,0.95
"2263",2022-03-29,"16 - 1022",50,52,50,0,2,1
"2264",2022-03-29,"24 - 1150",94,120,93,1,26,0.98936170212766
"2265",2022-03-29,"24 - 1153",225,225,225,0,0,1
"2266",2022-03-30,"62 - 1011",61,65,61,0,4,1
"2267",2022-03-30,"3 - 1008",230,230,218,12,0,0.947826086956522
"2268",2022-03-30,"16 - 1022",50,52,50,0,2,1
"2269",2022-03-30,"24 - 1150",100,120,95,5,20,0.95
"2270",2022-03-30,"24 - 1153",225,225,225,0,0,1
"2271",2022-03-31,"62 - 1011",60,60,60,0,0,1
"2272",2022-03-31,"3 - 1008",230,230,218,12,0,0.947826086956522
"2273",2022-03-31,"16 - 1022",50,52,50,0,2,1
"2274",2022-03-31,"24 - 1150",100,120,96,4,20,0.96
"2275",2022-03-31,"24 - 1153",224,225,222,2,1,0.991071428571429
"2276",2022-04-01,"62 - 1011",60,60,59,1,0,0.983333333333333
"2277",2022-04-01,"3 - 1008",230,230,218,12,0,0.947826086956522
"2278",2022-04-01,"16 - 1022",50,52,50,0,2,1
"2279",2022-04-01,"24 - 1150",100,120,98,2,20,0.98
"2280",2022-04-01,"24 - 1153",225,225,222,3,0,0.986666666666667
"2281",2022-04-02,"62 - 1011",65,65,61,4,0,0.938461538461538
"2282",2022-04-02,"3 - 1008",239,240,225,14,1,0.941422594142259
"2283",2022-04-02,"16 - 1022",50,52,49,1,2,0.98
"2284",2022-04-02,"24 - 1150",99,120,98,1,21,0.98989898989899
"2285",2022-04-02,"24 - 1153",225,225,223,2,0,0.991111111111111
"2286",2022-04-03,"62 - 1011",65,65,64,1,0,0.984615384615385
"2287",2022-04-03,"3 - 1008",239,240,226,13,1,0.94560669456067
"2288",2022-04-03,"16 - 1022",50,52,49,1,2,0.98
"2289",2022-04-03,"24 - 1150",100,120,96,4,20,0.96
"2290",2022-04-03,"24 - 1153",225,225,222,3,0,0.986666666666667
"2291",2022-04-04,"62 - 1011",60,60,59,1,0,0.983333333333333
"2292",2022-04-04,"3 - 1008",239,240,226,13,1,0.94560669456067
"2293",2022-04-04,"16 - 1022",50,52,49,1,2,0.98
"2294",2022-04-04,"24 - 1150",101,120,99,2,19,0.98019801980198
"2295",2022-04-04,"24 - 1153",229,240,228,1,11,0.995633187772926
"2296",2022-04-05,"62 - 1011",60,60,59,1,0,0.983333333333333
"2297",2022-04-05,"3 - 1008",238,240,213,25,2,0.894957983193277
"2298",2022-04-05,"16 - 1022",50,52,48,2,2,0.96
"2299",2022-04-05,"24 - 1150",97,120,95,2,23,0.979381443298969
"2300",2022-04-05,"24 - 1153",231,240,229,2,9,0.991341991341991
"2301",2022-04-06,"62 - 1011",60,60,59,1,0,0.983333333333333
"2302",2022-04-06,"3 - 1008",238,240,220,18,2,0.92436974789916
"2303",2022-04-06,"16 - 1022",50,52,49,1,2,0.98
"2304",2022-04-06,"24 - 1150",97,120,95,2,23,0.979381443298969
"2305",2022-04-06,"24 - 1153",238,240,233,5,2,0.978991596638655
"2306",2022-04-07,"62 - 1011",60,60,59,1,0,0.983333333333333
"2307",2022-04-07,"3 - 1008",230,230,215,15,0,0.934782608695652
"2308",2022-04-07,"16 - 1022",50,52,48,2,2,0.96
"2309",2022-04-07,"24 - 1150",100,120,100,0,20,1
"2310",2022-04-07,"24 - 1153",240,240,238,2,0,0.991666666666667
"2311",2022-04-08,"62 - 1011",60,60,60,0,0,1
"2312",2022-04-08,"3 - 1008",229,230,214,15,1,0.934497816593886
"2313",2022-04-08,"16 - 1022",50,52,50,0,2,1
"2314",2022-04-08,"24 - 1150",100,120,99,1,20,0.99
"2315",2022-04-08,"24 - 1153",240,240,239,1,0,0.995833333333333
"2316",2022-04-09,"62 - 1011",65,65,65,0,0,1
"2317",2022-04-09,"3 - 1008",239,240,225,14,1,0.941422594142259
"2318",2022-04-09,"16 - 1022",50,52,50,0,2,1
"2319",2022-04-09,"24 - 1150",100,120,100,0,20,1
"2320",2022-04-09,"24 - 1153",240,240,240,0,0,1
"2321",2022-04-10,"62 - 1011",65,65,65,0,0,1
"2322",2022-04-10,"3 - 1008",239,240,224,15,1,0.937238493723849
"2323",2022-04-10,"16 - 1022",50,52,50,0,2,1
"2324",2022-04-10,"24 - 1150",100,120,99,1,20,0.99
"2325",2022-04-10,"24 - 1153",240,240,240,0,0,1
"2326",2022-04-11,"62 - 1011",60,60,60,0,0,1
"2327",2022-04-11,"3 - 1008",229,230,213,16,1,0.930131004366812
"2328",2022-04-11,"16 - 1022",50,52,49,1,2,0.98
"2329",2022-04-11,"24 - 1150",100,120,98,2,20,0.98
"2330",2022-04-11,"24 - 1153",240,240,239,1,0,0.995833333333333
"2331",2022-04-12,"62 - 1011",60,60,60,0,0,1
"2332",2022-04-12,"3 - 1008",229,230,213,16,1,0.930131004366812
"2333",2022-04-12,"16 - 1022",50,52,50,0,2,1
"2334",2022-04-12,"24 - 1150",100,120,98,2,20,0.98
"2335",2022-04-12,"24 - 1153",240,240,240,0,0,1
"2336",2022-04-13,"62 - 1011",60,60,60,0,0,1
"2337",2022-04-13,"3 - 1008",229,230,213,16,1,0.930131004366812
"2338",2022-04-13,"16 - 1022",50,52,48,2,2,0.96
"2339",2022-04-13,"24 - 1150",100,120,98,2,20,0.98
"2340",2022-04-13,"24 - 1153",240,240,239,1,0,0.995833333333333
"2341",2022-04-14,"62 - 1011",60,60,59,1,0,0.983333333333333
"2342",2022-04-14,"3 - 1008",229,230,213,16,1,0.930131004366812
"2343",2022-04-14,"16 - 1022",50,52,48,2,2,0.96
"2344",2022-04-14,"24 - 1150",100,120,98,2,20,0.98
"2345",2022-04-14,"24 - 1153",240,240,240,0,0,1
"2346",2022-04-15,"62 - 1011",60,60,59,1,0,0.983333333333333
"2347",2022-04-15,"3 - 1008",240,240,222,18,0,0.925
"2348",2022-04-15,"16 - 1022",50,52,49,1,2,0.98
"2349",2022-04-15,"24 - 1150",100,120,100,0,20,1
"2350",2022-04-15,"24 - 1153",240,240,238,2,0,0.991666666666667
"2351",2022-04-16,"62 - 1011",65,65,63,2,0,0.969230769230769
"2352",2022-04-16,"3 - 1008",240,240,224,16,0,0.933333333333333
"2353",2022-04-16,"16 - 1022",50,52,49,1,2,0.98
"2354",2022-04-16,"24 - 1150",99,120,98,1,21,0.98989898989899
"2355",2022-04-16,"24 - 1153",240,240,240,0,0,1
"2356",2022-04-17,"62 - 1011",65,65,64,1,0,0.984615384615385
"2357",2022-04-17,"3 - 1008",240,240,224,16,0,0.933333333333333
"2358",2022-04-17,"16 - 1022",50,52,49,1,2,0.98
"2359",2022-04-17,"24 - 1150",98,120,97,1,22,0.989795918367347
"2360",2022-04-17,"24 - 1153",240,240,239,1,0,0.995833333333333
"2361",2022-04-18,"62 - 1011",65,65,65,0,0,1
"2362",2022-04-18,"3 - 1008",240,240,225,15,0,0.9375
"2363",2022-04-18,"16 - 1022",50,52,50,0,2,1
"2364",2022-04-18,"24 - 1150",98,120,96,2,22,0.979591836734694
"2365",2022-04-18,"24 - 1153",240,240,239,1,0,0.995833333333333
"2366",2022-04-19,"62 - 1011",65,65,65,0,0,1
"2367",2022-04-19,"3 - 1008",240,240,227,13,0,0.945833333333333
"2368",2022-04-19,"16 - 1022",50,52,49,1,2,0.98
"2369",2022-04-19,"24 - 1150",100,120,97,3,20,0.97
"2370",2022-04-19,"24 - 1153",240,240,240,0,0,1
"2371",2022-04-20,"62 - 1011",60,60,60,0,0,1
"2372",2022-04-20,"3 - 1008",230,230,220,10,0,0.956521739130435
"2373",2022-04-20,"16 - 1022",50,52,48,2,2,0.96
"2374",2022-04-20,"24 - 1150",98,120,98,0,22,1
"2375",2022-04-20,"24 - 1153",240,240,240,0,0,1
"2376",2022-04-21,"62 - 1011",60,60,60,0,0,1
"2377",2022-04-21,"3 - 1008",230,230,221,9,0,0.960869565217391
"2378",2022-04-21,"16 - 1022",50,52,49,1,2,0.98
"2379",2022-04-21,"24 - 1150",100,120,96,4,20,0.96
"2380",2022-04-21,"24 - 1153",240,240,240,0,0,1
"2381",2022-04-22,"62 - 1011",60,60,60,0,0,1
"2382",2022-04-22,"3 - 1008",230,230,222,8,0,0.965217391304348
"2383",2022-04-22,"16 - 1022",49,52,49,0,3,1
"2384",2022-04-22,"24 - 1150",97,120,96,1,23,0.989690721649485
"2385",2022-04-22,"24 - 1153",239,240,239,0,1,1
"2386",2022-04-23,"62 - 1011",60,60,60,0,0,1
"2387",2022-04-23,"3 - 1008",230,230,221,9,0,0.960869565217391
"2388",2022-04-23,"16 - 1022",49,52,48,1,3,0.979591836734694
"2389",2022-04-23,"24 - 1150",97,120,95,2,23,0.979381443298969
"2390",2022-04-23,"24 - 1153",239,240,239,0,1,1
"2391",2022-04-24,"62 - 1011",60,60,60,0,0,1
"2392",2022-04-24,"3 - 1008",230,230,222,8,0,0.965217391304348
"2393",2022-04-24,"16 - 1022",49,52,47,2,3,0.959183673469388
"2394",2022-04-24,"24 - 1150",98,120,93,5,22,0.948979591836735
"2395",2022-04-24,"24 - 1153",238,240,238,0,2,1
"2396",2022-04-25,"62 - 1011",60,60,60,0,0,1
"2397",2022-04-25,"3 - 1008",230,230,222,8,0,0.965217391304348
"2398",2022-04-25,"16 - 1022",49,50,47,2,1,0.959183673469388
"2399",2022-04-25,"24 - 1150",100,120,98,2,20,0.98
"2400",2022-04-25,"24 - 1153",240,240,238,2,0,0.991666666666667
"2401",2022-04-26,"62 - 1011",60,60,60,0,0,1
"2402",2022-04-26,"3 - 1008",229,230,222,7,1,0.96943231441048
"2403",2022-04-26,"16 - 1022",49,50,48,1,1,0.979591836734694
"2404",2022-04-26,"24 - 1150",100,120,94,6,20,0.94
"2405",2022-04-26,"24 - 1153",240,240,239,1,0,0.995833333333333
"2406",2022-04-27,"62 - 1011",65,65,65,0,0,1
"2407",2022-04-27,"3 - 1008",239,240,231,8,1,0.96652719665272
"2408",2022-04-27,"16 - 1022",49,50,48,1,1,0.979591836734694
"2409",2022-04-27,"24 - 1150",100,120,96,4,20,0.96
"2410",2022-04-27,"24 - 1153",240,240,240,0,0,1
"2411",2022-04-28,"62 - 1011",65,65,63,2,0,0.969230769230769
"2412",2022-04-28,"3 - 1008",238,240,230,8,2,0.966386554621849
"2413",2022-04-28,"16 - 1022",49,50,45,4,1,0.918367346938776
"2414",2022-04-28,"24 - 1150",100,120,96,4,20,0.96
"2415",2022-04-28,"24 - 1153",240,240,239,1,0,0.995833333333333
"2416",2022-04-29,"62 - 1011",60,60,60,0,0,1
"2417",2022-04-29,"3 - 1008",228,230,219,9,2,0.960526315789474
"2418",2022-04-29,"16 - 1022",49,50,47,2,1,0.959183673469388
"2419",2022-04-29,"24 - 1150",100,120,98,2,20,0.98
"2420",2022-04-29,"24 - 1153",240,240,239,1,0,0.995833333333333
"2421",2022-04-30,"62 - 1011",60,60,59,1,0,0.983333333333333
"2422",2022-04-30,"3 - 1008",223,230,213,10,7,0.955156950672646
"2423",2022-04-30,"16 - 1022",49,50,45,4,1,0.918367346938776
"2424",2022-04-30,"24 - 1150",100,120,99,1,20,0.99
"2425",2022-04-30,"24 - 1153",240,240,240,0,0,1
"2426",2022-05-01,"62 - 1011",60,60,55,5,0,0.916666666666667
"2427",2022-05-01,"3 - 1008",223,230,211,12,7,0.946188340807175
"2428",2022-05-01,"16 - 1022",49,50,45,4,1,0.918367346938776
"2429",2022-05-01,"24 - 1150",100,120,95,5,20,0.95
"2430",2022-05-01,"24 - 1153",240,240,239,1,0,0.995833333333333
"2431",2022-05-02,"62 - 1011",60,60,54,6,0,0.9
"2432",2022-05-02,"3 - 1008",220,230,211,9,10,0.959090909090909
"2433",2022-05-02,"16 - 1022",50,50,46,4,0,0.92
"2434",2022-05-02,"24 - 1150",100,120,100,0,20,1
"2435",2022-05-02,"24 - 1153",240,240,240,0,0,1
"2436",2022-05-03,"62 - 1011",60,60,56,4,0,0.933333333333333
"2437",2022-05-03,"3 - 1008",208,230,205,3,22,0.985576923076923
"2438",2022-05-03,"16 - 1022",50,50,48,2,0,0.96
"2439",2022-05-03,"24 - 1150",100,120,96,4,20,0.96
"2440",2022-05-03,"24 - 1153",240,240,240,0,0,1
"2441",2022-05-04,"62 - 1011",60,60,57,3,0,0.95
"2442",2022-05-04,"3 - 1008",203,230,200,3,27,0.985221674876847
"2443",2022-05-04,"16 - 1022",50,50,47,3,0,0.94
"2444",2022-05-04,"24 - 1150",100,120,99,1,20,0.99
"2445",2022-05-04,"24 - 1153",240,240,240,0,0,1
"2446",2022-05-05,"62 - 1011",60,60,58,2,0,0.966666666666667
"2447",2022-05-05,"3 - 1008",200,230,199,1,30,0.995
"2448",2022-05-05,"16 - 1022",50,50,45,5,0,0.9
"2449",2022-05-05,"24 - 1150",100,120,100,0,20,1
"2450",2022-05-05,"24 - 1153",240,240,239,1,0,0.995833333333333
"2451",2022-05-06,"62 - 1011",60,60,57,3,0,0.95
"2452",2022-05-06,"3 - 1008",201,230,201,0,29,1
"2453",2022-05-06,"16 - 1022",50,50,47,3,0,0.94
"2454",2022-05-06,"24 - 1150",100,120,98,2,20,0.98
"2455",2022-05-06,"24 - 1153",240,240,240,0,0,1
"2456",2022-05-07,"62 - 1011",60,60,57,3,0,0.95
"2457",2022-05-07,"3 - 1008",200,230,200,0,30,1
"2458",2022-05-07,"16 - 1022",50,50,47,3,0,0.94
"2459",2022-05-07,"24 - 1150",100,120,100,0,20,1
"2460",2022-05-07,"24 - 1153",240,240,239,1,0,0.995833333333333
"2461",2022-05-08,"62 - 1011",60,60,58,2,0,0.966666666666667
"2462",2022-05-08,"3 - 1008",198,230,198,0,32,1
"2463",2022-05-08,"16 - 1022",50,50,46,4,0,0.92
"2464",2022-05-08,"24 - 1150",100,120,98,2,20,0.98
"2465",2022-05-08,"24 - 1153",240,240,238,2,0,0.991666666666667
"2466",2022-05-09,"62 - 1011",60,60,58,2,0,0.966666666666667
"2467",2022-05-09,"3 - 1008",198,230,196,2,32,0.98989898989899
"2468",2022-05-09,"16 - 1022",50,50,46,4,0,0.92
"2469",2022-05-09,"24 - 1150",100,120,100,0,20,1
"2470",2022-05-09,"24 - 1153",240,240,240,0,0,1
"2471",2022-05-10,"62 - 1011",60,60,58,2,0,0.966666666666667
"2472",2022-05-10,"3 - 1008",195,230,194,1,35,0.994871794871795
"2473",2022-05-10,"16 - 1022",50,50,45,5,0,0.9
"2474",2022-05-10,"24 - 1150",100,120,100,0,20,1
"2475",2022-05-10,"24 - 1153",240,240,240,0,0,1
"2476",2022-05-11,"62 - 1011",60,60,59,1,0,0.983333333333333
"2477",2022-05-11,"3 - 1008",196,230,195,1,34,0.994897959183674
"2478",2022-05-11,"16 - 1022",50,50,48,2,0,0.96
"2479",2022-05-11,"24 - 1150",100,120,100,0,20,1
"2480",2022-05-11,"24 - 1153",240,240,240,0,0,1
"2481",2022-05-12,"62 - 1011",60,60,60,0,0,1
"2482",2022-05-12,"3 - 1008",196,230,195,1,34,0.994897959183674
"2483",2022-05-12,"16 - 1022",50,50,49,1,0,0.98
"2484",2022-05-12,"24 - 1150",100,120,93,7,20,0.93
"2485",2022-05-12,"24 - 1153",240,240,239,1,0,0.995833333333333
"2486",2022-05-13,"62 - 1011",60,60,60,0,0,1
"2487",2022-05-13,"3 - 1008",195,230,192,3,35,0.984615384615385
"2488",2022-05-13,"16 - 1022",50,50,49,1,0,0.98
"2489",2022-05-13,"24 - 1150",95,120,95,0,25,1
"2490",2022-05-13,"24 - 1153",237,240,237,0,3,1
"2491",2022-05-14,"62 - 1011",60,60,60,0,0,1
"2492",2022-05-14,"3 - 1008",193,230,189,4,37,0.979274611398964
"2493",2022-05-14,"16 - 1022",50,50,47,3,0,0.94
"2494",2022-05-14,"24 - 1150",96,120,94,2,24,0.979166666666667
"2495",2022-05-14,"24 - 1153",236,240,235,1,4,0.995762711864407
"2496",2022-05-15,"62 - 1011",60,60,60,0,0,1
"2497",2022-05-15,"3 - 1008",197,230,192,5,33,0.974619289340102
"2498",2022-05-15,"16 - 1022",50,50,48,2,0,0.96
"2499",2022-05-15,"24 - 1150",96,120,96,0,24,1
"2500",2022-05-15,"24 - 1153",232,240,232,0,8,1
"2501",2022-05-16,"62 - 1011",60,60,60,0,0,1
"2502",2022-05-16,"3 - 1008",191,230,190,1,39,0.994764397905759
"2503",2022-05-16,"16 - 1022",50,50,49,1,0,0.98
"2504",2022-05-16,"24 - 1150",97,120,95,2,23,0.979381443298969
"2505",2022-05-16,"24 - 1153",235,240,233,2,5,0.991489361702128
"2506",2022-05-17,"62 - 1011",60,60,59,1,0,0.983333333333333
"2507",2022-05-17,"3 - 1008",192,230,192,0,38,1
"2508",2022-05-17,"16 - 1022",50,50,48,2,0,0.96
"2509",2022-05-17,"24 - 1150",94,120,92,2,26,0.978723404255319
"2510",2022-05-17,"24 - 1153",234,240,234,0,6,1
"2511",2022-05-18,"62 - 1011",60,60,60,0,0,1
"2512",2022-05-18,"3 - 1008",169,220,169,0,51,1
"2513",2022-05-18,"16 - 1022",50,50,48,2,0,0.96
"2514",2022-05-18,"24 - 1150",95,120,91,4,25,0.957894736842105
"2515",2022-05-18,"24 - 1153",235,240,235,0,5,1
"2516",2022-05-19,"62 - 1011",60,60,60,0,0,1
"2517",2022-05-19,"3 - 1008",159,220,159,0,61,1
"2518",2022-05-19,"16 - 1022",50,50,48,2,0,0.96
"2519",2022-05-19,"24 - 1150",96,120,95,1,24,0.989583333333333
"2520",2022-05-19,"24 - 1153",236,240,236,0,4,1
"2521",2022-05-20,"62 - 1011",60,60,60,0,0,1
"2522",2022-05-20,"3 - 1008",154,154,141,13,0,0.915584415584416
"2523",2022-05-20,"16 - 1022",50,50,48,2,0,0.96
"2524",2022-05-20,"24 - 1150",106,120,100,6,14,0.943396226415094
"2525",2022-05-20,"24 - 1153",234,310,234,0,76,1
"2526",2022-05-21,"62 - 1011",60,60,60,0,0,1
"2527",2022-05-21,"3 - 1008",154,154,142,12,0,0.922077922077922
"2528",2022-05-21,"16 - 1022",50,50,47,3,0,0.94
"2529",2022-05-21,"24 - 1150",108,120,105,3,12,0.972222222222222
"2530",2022-05-21,"24 - 1153",234,310,234,0,76,1
"2531",2022-05-22,"62 - 1011",60,60,60,0,0,1
"2532",2022-05-22,"3 - 1008",154,154,142,12,0,0.922077922077922
"2533",2022-05-22,"16 - 1022",50,50,47,3,0,0.94
"2534",2022-05-22,"24 - 1150",108,120,104,4,12,0.962962962962963
"2535",2022-05-22,"24 - 1153",234,310,234,0,76,1
"2536",2022-05-23,"62 - 1011",60,60,59,1,0,0.983333333333333
"2537",2022-05-23,"3 - 1008",154,154,141,13,0,0.915584415584416
"2538",2022-05-23,"16 - 1022",50,50,47,3,0,0.94
"2539",2022-05-23,"24 - 1150",108,120,104,4,12,0.962962962962963
"2540",2022-05-23,"24 - 1153",235,310,235,0,75,1
"2541",2022-05-24,"62 - 1011",60,60,59,1,0,0.983333333333333
"2542",2022-05-24,"3 - 1008",154,154,140,14,0,0.909090909090909
"2543",2022-05-24,"16 - 1022",50,50,48,2,0,0.96
"2544",2022-05-24,"24 - 1150",104,120,101,3,16,0.971153846153846
"2545",2022-05-24,"24 - 1153",235,240,235,0,5,1
"2546",2022-05-25,"62 - 1011",60,60,60,0,0,1
"2547",2022-05-25,"3 - 1008",154,154,142,12,0,0.922077922077922
"2548",2022-05-25,"16 - 1022",50,50,48,2,0,0.96
"2549",2022-05-25,"24 - 1150",104,120,102,2,16,0.980769230769231
"2550",2022-05-25,"24 - 1153",240,240,237,3,0,0.9875
"2551",2022-05-26,"62 - 1011",60,60,60,0,0,1
"2552",2022-05-26,"3 - 1008",154,154,142,12,0,0.922077922077922
"2553",2022-05-26,"16 - 1022",50,50,45,5,0,0.9
"2554",2022-05-26,"24 - 1150",103,120,101,2,17,0.980582524271845
"2555",2022-05-26,"24 - 1153",240,240,240,0,0,1
"2556",2022-05-27,"62 - 1011",60,60,60,0,0,1
"2557",2022-05-27,"3 - 1008",154,154,143,11,0,0.928571428571429
"2558",2022-05-27,"16 - 1022",50,50,47,3,0,0.94
"2559",2022-05-27,"24 - 1150",103,120,101,2,17,0.980582524271845
"2560",2022-05-27,"24 - 1153",237,240,237,0,3,1
"2561",2022-05-28,"62 - 1011",60,60,59,1,0,0.983333333333333
"2562",2022-05-28,"3 - 1008",154,154,143,11,0,0.928571428571429
"2563",2022-05-28,"16 - 1022",50,50,47,3,0,0.94
"2564",2022-05-28,"24 - 1150",105,120,105,0,15,1
"2565",2022-05-28,"24 - 1153",237,240,237,0,3,1
"2566",2022-05-29,"62 - 1011",60,60,60,0,0,1
"2567",2022-05-29,"3 - 1008",154,154,143,11,0,0.928571428571429
"2568",2022-05-29,"16 - 1022",50,50,47,3,0,0.94
"2569",2022-05-29,"24 - 1150",106,120,105,1,14,0.990566037735849
"2570",2022-05-29,"24 - 1153",238,240,234,4,2,0.983193277310924
"2571",2022-05-30,"62 - 1011",60,60,60,0,0,1
"2572",2022-05-30,"3 - 1008",154,154,142,12,0,0.922077922077922
"2573",2022-05-30,"16 - 1022",50,50,48,2,0,0.96
"2574",2022-05-30,"24 - 1150",106,120,101,5,14,0.952830188679245
"2575",2022-05-30,"24 - 1153",238,240,238,0,2,1
"2576",2022-05-31,"62 - 1011",60,60,60,0,0,1
"2577",2022-05-31,"3 - 1008",154,154,142,12,0,0.922077922077922
"2578",2022-05-31,"16 - 1022",50,50,49,1,0,0.98
"2579",2022-05-31,"24 - 1150",106,120,101,5,14,0.952830188679245
"2580",2022-05-31,"24 - 1153",238,240,238,0,2,1
"2581",2022-06-01,"62 - 1011",60,60,60,0,0,1
"2582",2022-06-01,"3 - 1008",154,154,140,14,0,0.909090909090909
"2583",2022-06-01,"16 - 1022",50,50,48,2,0,0.96
"2584",2022-06-01,"24 - 1150",106,120,103,3,14,0.971698113207547
"2585",2022-06-01,"24 - 1153",238,240,238,0,2,1
"2586",2022-06-02,"62 - 1011",60,60,60,0,0,1
"2587",2022-06-02,"3 - 1008",154,154,144,10,0,0.935064935064935
"2588",2022-06-02,"16 - 1022",50,50,47,3,0,0.94
"2589",2022-06-02,"24 - 1150",106,120,103,3,14,0.971698113207547
"2590",2022-06-02,"24 - 1153",238,240,238,0,2,1
"2591",2022-06-03,"62 - 1011",60,60,60,0,0,1
"2592",2022-06-03,"3 - 1008",154,154,144,10,0,0.935064935064935
"2593",2022-06-03,"16 - 1022",50,50,46,4,0,0.92
"2594",2022-06-03,"24 - 1150",106,120,106,0,14,1
"2595",2022-06-03,"24 - 1153",238,240,238,0,2,1
"2596",2022-06-04,"62 - 1011",60,60,60,0,0,1
"2597",2022-06-04,"3 - 1008",154,154,144,10,0,0.935064935064935
"2598",2022-06-04,"16 - 1022",50,50,46,4,0,0.92
"2599",2022-06-04,"24 - 1150",105,120,105,0,15,1
"2600",2022-06-04,"24 - 1153",238,240,238,0,2,1
"2601",2022-06-05,"62 - 1011",60,60,60,0,0,1
"2602",2022-06-05,"3 - 1008",154,154,144,10,0,0.935064935064935
"2603",2022-06-05,"16 - 1022",50,50,45,5,0,0.9
"2604",2022-06-05,"24 - 1150",105,120,105,0,15,1
"2605",2022-06-05,"24 - 1153",238,240,238,0,2,1
"2606",2022-06-06,"62 - 1011",60,60,60,0,0,1
"2607",2022-06-06,"3 - 1008",154,154,144,10,0,0.935064935064935
"2608",2022-06-06,"16 - 1022",50,50,47,3,0,0.94
"2609",2022-06-06,"24 - 1150",107,120,107,0,13,1
"2610",2022-06-06,"24 - 1153",238,240,238,0,2,1
"2611",2022-06-07,"62 - 1011",60,60,59,1,0,0.983333333333333
"2612",2022-06-07,"3 - 1008",154,154,145,9,0,0.941558441558442
"2613",2022-06-07,"16 - 1022",50,50,49,1,0,0.98
"2614",2022-06-07,"24 - 1150",107,120,106,1,13,0.990654205607477
"2615",2022-06-07,"24 - 1153",238,240,238,0,2,1
"2616",2022-06-08,"62 - 1011",60,60,59,1,0,0.983333333333333
"2617",2022-06-08,"3 - 1008",154,154,143,11,0,0.928571428571429
"2618",2022-06-08,"16 - 1022",50,50,50,0,0,1
"2619",2022-06-08,"24 - 1150",108,120,106,2,12,0.981481481481482
"2620",2022-06-08,"24 - 1153",238,240,237,1,2,0.995798319327731
"2621",2022-06-09,"62 - 1011",60,60,60,0,0,1
"2622",2022-06-09,"3 - 1008",154,154,143,11,0,0.928571428571429
"2623",2022-06-09,"16 - 1022",50,50,50,0,0,1
"2624",2022-06-09,"24 - 1150",108,120,108,0,12,1
"2625",2022-06-09,"24 - 1153",239,240,239,0,1,1
"2626",2022-06-10,"62 - 1011",60,60,60,0,0,1
"2627",2022-06-10,"3 - 1008",154,154,144,10,0,0.935064935064935
"2628",2022-06-10,"16 - 1022",49,50,49,0,1,1
"2629",2022-06-10,"24 - 1150",108,120,108,0,12,1
"2630",2022-06-10,"24 - 1153",239,240,239,0,1,1
"2631",2022-06-11,"62 - 1011",60,60,60,0,0,1
"2632",2022-06-11,"3 - 1008",154,154,144,10,0,0.935064935064935
"2633",2022-06-11,"16 - 1022",50,50,50,0,0,1
"2634",2022-06-11,"24 - 1150",108,120,108,0,12,1
"2635",2022-06-11,"24 - 1153",239,240,238,1,1,0.99581589958159
"2636",2022-06-12,"62 - 1011",60,60,60,0,0,1
"2637",2022-06-12,"3 - 1008",154,154,143,11,0,0.928571428571429
"2638",2022-06-12,"16 - 1022",50,50,48,2,0,0.96
"2639",2022-06-12,"24 - 1150",108,120,107,1,12,0.990740740740741
"2640",2022-06-12,"24 - 1153",239,240,239,0,1,1
"2641",2022-06-13,"62 - 1011",60,60,60,0,0,1
"2642",2022-06-13,"3 - 1008",154,154,144,10,0,0.935064935064935
"2643",2022-06-13,"16 - 1022",50,50,49,1,0,0.98
"2644",2022-06-13,"24 - 1150",108,120,108,0,12,1
"2645",2022-06-13,"24 - 1153",239,240,239,0,1,1
"2646",2022-06-14,"62 - 1011",60,60,60,0,0,1
"2647",2022-06-14,"3 - 1008",154,154,144,10,0,0.935064935064935
"2648",2022-06-14,"16 - 1022",50,50,49,1,0,0.98
"2649",2022-06-14,"24 - 1150",108,120,107,1,12,0.990740740740741
"2650",2022-06-14,"24 - 1153",239,240,239,0,1,1
"2651",2022-06-15,"62 - 1011",60,60,60,0,0,1
"2652",2022-06-15,"3 - 1008",154,154,142,12,0,0.922077922077922
"2653",2022-06-15,"16 - 1022",50,50,49,1,0,0.98
"2654",2022-06-15,"24 - 1150",108,120,106,2,12,0.981481481481482
"2655",2022-06-15,"24 - 1153",239,240,239,0,1,1
"2656",2022-06-16,"62 - 1011",60,60,59,1,0,0.983333333333333
"2657",2022-06-16,"3 - 1008",154,154,142,12,0,0.922077922077922
"2658",2022-06-16,"16 - 1022",50,50,49,1,0,0.98
"2659",2022-06-16,"24 - 1150",106,120,104,2,14,0.981132075471698
"2660",2022-06-16,"24 - 1153",240,240,240,0,0,1
"2661",2022-06-17,"62 - 1011",60,60,59,1,0,0.983333333333333
"2662",2022-06-17,"3 - 1008",154,154,142,12,0,0.922077922077922
"2663",2022-06-17,"16 - 1022",50,50,50,0,0,1
"2664",2022-06-17,"24 - 1150",105,120,105,0,15,1
"2665",2022-06-17,"24 - 1153",240,240,240,0,0,1
"2666",2022-06-18,"62 - 1011",60,60,60,0,0,1
"2667",2022-06-18,"3 - 1008",154,154,142,12,0,0.922077922077922
"2668",2022-06-18,"16 - 1022",50,50,50,0,0,1
"2669",2022-06-18,"24 - 1150",105,120,105,0,15,1
"2670",2022-06-18,"24 - 1153",240,240,240,0,0,1
"2671",2022-06-19,"62 - 1011",60,60,59,1,0,0.983333333333333
"2672",2022-06-19,"3 - 1008",154,154,142,12,0,0.922077922077922
"2673",2022-06-19,"16 - 1022",50,50,50,0,0,1
"2674",2022-06-19,"24 - 1150",105,120,105,0,15,1
"2675",2022-06-19,"24 - 1153",240,240,240,0,0,1
"2676",2022-06-20,"62 - 1011",60,60,60,0,0,1
"2677",2022-06-20,"3 - 1008",154,154,142,12,0,0.922077922077922
"2678",2022-06-20,"16 - 1022",50,50,49,1,0,0.98
"2679",2022-06-20,"24 - 1150",105,120,101,4,15,0.961904761904762
"2680",2022-06-20,"24 - 1153",240,240,240,0,0,1
"2681",2022-06-21,"62 - 1011",60,60,60,0,0,1
"2682",2022-06-21,"3 - 1008",154,154,140,14,0,0.909090909090909
"2683",2022-06-21,"16 - 1022",50,50,50,0,0,1
"2684",2022-06-21,"24 - 1150",105,120,105,0,15,1
"2685",2022-06-21,"24 - 1153",240,240,239,1,0,0.995833333333333
"2686",2022-06-22,"62 - 1011",60,60,60,0,0,1
"2687",2022-06-22,"3 - 1008",154,154,140,14,0,0.909090909090909
"2688",2022-06-22,"16 - 1022",50,50,50,0,0,1
"2689",2022-06-22,"24 - 1150",105,120,105,0,15,1
"2690",2022-06-22,"24 - 1153",240,240,239,1,0,0.995833333333333
"2691",2022-06-23,"62 - 1011",60,60,59,1,0,0.983333333333333
"2692",2022-06-23,"3 - 1008",154,154,139,15,0,0.902597402597403
"2693",2022-06-23,"16 - 1022",49,50,48,1,1,0.979591836734694
"2694",2022-06-23,"24 - 1150",105,120,105,0,15,1
"2695",2022-06-23,"24 - 1153",240,240,240,0,0,1
"2696",2022-06-24,"62 - 1011",60,60,60,0,0,1
"2697",2022-06-24,"3 - 1008",154,154,140,14,0,0.909090909090909
"2698",2022-06-24,"16 - 1022",50,50,48,2,0,0.96
"2699",2022-06-24,"24 - 1150",105,120,105,0,15,1
"2700",2022-06-24,"24 - 1153",240,240,240,0,0,1
"2701",2022-06-25,"62 - 1011",60,60,60,0,0,1
"2702",2022-06-25,"3 - 1008",154,154,140,14,0,0.909090909090909
"2703",2022-06-25,"16 - 1022",50,50,46,4,0,0.92
"2704",2022-06-25,"24 - 1150",105,120,105,0,15,1
"2705",2022-06-25,"24 - 1153",240,240,240,0,0,1
"2706",2022-06-26,"62 - 1011",60,60,60,0,0,1
"2707",2022-06-26,"3 - 1008",154,154,139,15,0,0.902597402597403
"2708",2022-06-26,"16 - 1022",50,50,47,3,0,0.94
"2709",2022-06-26,"24 - 1150",105,120,105,0,15,1
"2710",2022-06-26,"24 - 1153",240,240,238,2,0,0.991666666666667
"2711",2022-06-27,"62 - 1011",60,60,59,1,0,0.983333333333333
"2712",2022-06-27,"3 - 1008",154,154,139,15,0,0.902597402597403
"2713",2022-06-27,"16 - 1022",50,50,48,2,0,0.96
"2714",2022-06-27,"24 - 1150",105,120,105,0,15,1
"2715",2022-06-27,"24 - 1153",240,240,240,0,0,1
"2716",2022-06-28,"62 - 1011",60,60,60,0,0,1
"2717",2022-06-28,"3 - 1008",154,154,139,15,0,0.902597402597403
"2718",2022-06-28,"16 - 1022",50,50,49,1,0,0.98
"2719",2022-06-28,"24 - 1150",104,120,104,0,16,1
"2720",2022-06-28,"24 - 1153",240,240,240,0,0,1
"2721",2022-06-29,"62 - 1011",60,60,60,0,0,1
"2722",2022-06-29,"3 - 1008",154,154,140,14,0,0.909090909090909
"2723",2022-06-29,"16 - 1022",50,50,49,1,0,0.98
"2724",2022-06-29,"24 - 1150",104,120,104,0,16,1
"2725",2022-06-29,"24 - 1153",240,240,240,0,0,1
"2726",2022-06-30,"62 - 1011",60,60,60,0,0,1
"2727",2022-06-30,"3 - 1008",154,154,141,13,0,0.915584415584416
"2728",2022-06-30,"16 - 1022",50,50,49,1,0,0.98
"2729",2022-06-30,"24 - 1150",103,120,102,1,17,0.990291262135922
"2730",2022-06-30,"24 - 1153",239,240,238,1,1,0.99581589958159
"2731",2022-07-01,"62 - 1011",60,60,57,3,0,0.95
"2732",2022-07-01,"3 - 1008",154,154,140,14,0,0.909090909090909
"2733",2022-07-01,"16 - 1022",50,50,49,1,0,0.98
"2734",2022-07-01,"24 - 1150",103,120,102,1,17,0.990291262135922
"2735",2022-07-01,"24 - 1153",240,240,240,0,0,1
"2736",2022-07-02,"62 - 1011",60,60,57,3,0,0.95
"2737",2022-07-02,"3 - 1008",154,154,140,14,0,0.909090909090909
"2738",2022-07-02,"16 - 1022",50,50,47,3,0,0.94
"2739",2022-07-02,"24 - 1150",103,120,102,1,17,0.990291262135922
"2740",2022-07-02,"24 - 1153",240,240,240,0,0,1
"2741",2022-07-03,"62 - 1011",57,60,57,0,3,1
"2742",2022-07-03,"3 - 1008",154,154,141,13,0,0.915584415584416
"2743",2022-07-03,"16 - 1022",50,50,47,3,0,0.94
"2744",2022-07-03,"24 - 1150",103,120,103,0,17,1
"2745",2022-07-03,"24 - 1153",239,240,238,1,1,0.99581589958159
"2746",2022-07-04,"62 - 1011",56,60,56,0,4,1
"2747",2022-07-04,"3 - 1008",154,154,140,14,0,0.909090909090909
"2748",2022-07-04,"16 - 1022",50,50,47,3,0,0.94
"2749",2022-07-04,"24 - 1150",103,120,103,0,17,1
"2750",2022-07-04,"24 - 1153",237,240,236,1,3,0.9957805907173
"2751",2022-07-05,"62 - 1011",56,56,56,0,0,1
"2752",2022-07-05,"3 - 1008",154,154,139,15,0,0.902597402597403
"2753",2022-07-05,"16 - 1022",50,50,48,2,0,0.96
"2754",2022-07-05,"24 - 1150",103,120,102,1,17,0.990291262135922
"2755",2022-07-05,"24 - 1153",239,240,239,0,1,1
"2756",2022-07-06,"62 - 1011",56,56,56,0,0,1
"2757",2022-07-06,"3 - 1008",154,154,136,18,0,0.883116883116883
"2758",2022-07-06,"16 - 1022",50,50,48,2,0,0.96
"2759",2022-07-06,"24 - 1150",106,120,99,7,14,0.933962264150943
"2760",2022-07-06,"24 - 1153",239,240,239,0,1,1
"2761",2022-07-07,"62 - 1011",56,56,55,1,0,0.982142857142857
"2762",2022-07-07,"3 - 1008",154,154,137,17,0,0.88961038961039
"2763",2022-07-07,"16 - 1022",50,50,48,2,0,0.96
"2764",2022-07-07,"24 - 1150",106,120,102,4,14,0.962264150943396
"2765",2022-07-07,"24 - 1153",239,240,239,0,1,1
"2766",2022-07-08,"62 - 1011",56,56,54,2,0,0.964285714285714
"2767",2022-07-08,"3 - 1008",154,154,138,16,0,0.896103896103896
"2768",2022-07-08,"16 - 1022",50,50,49,1,0,0.98
"2769",2022-07-08,"24 - 1150",106,120,102,4,14,0.962264150943396
"2770",2022-07-08,"24 - 1153",239,240,239,0,1,1
"2771",2022-07-09,"62 - 1011",56,56,54,2,0,0.964285714285714
"2772",2022-07-09,"3 - 1008",154,154,138,16,0,0.896103896103896
"2773",2022-07-09,"16 - 1022",50,50,49,1,0,0.98
"2774",2022-07-09,"24 - 1150",106,120,105,1,14,0.990566037735849
"2775",2022-07-09,"24 - 1153",239,240,239,0,1,1
"2776",2022-07-10,"62 - 1011",56,56,53,3,0,0.946428571428571
"2777",2022-07-10,"3 - 1008",154,154,137,17,0,0.88961038961039
"2778",2022-07-10,"16 - 1022",50,50,48,2,0,0.96
"2779",2022-07-10,"24 - 1150",106,120,106,0,14,1
"2780",2022-07-10,"24 - 1153",237,240,236,1,3,0.9957805907173
"2781",2022-07-11,"62 - 1011",56,56,54,2,0,0.964285714285714
"2782",2022-07-11,"3 - 1008",154,154,137,17,0,0.88961038961039
"2783",2022-07-11,"16 - 1022",50,50,48,2,0,0.96
"2784",2022-07-11,"24 - 1150",106,120,106,0,14,1
"2785",2022-07-11,"24 - 1153",237,240,237,0,3,1
"2786",2022-07-12,"62 - 1011",56,56,53,3,0,0.946428571428571
"2787",2022-07-12,"3 - 1008",154,154,137,17,0,0.88961038961039
"2788",2022-07-12,"16 - 1022",50,50,47,3,0,0.94
"2789",2022-07-12,"24 - 1150",107,120,106,1,13,0.990654205607477
"2790",2022-07-12,"24 - 1153",237,240,237,0,3,1
"2791",2022-07-13,"62 - 1011",56,56,54,2,0,0.964285714285714
"2792",2022-07-13,"3 - 1008",154,154,137,17,0,0.88961038961039
"2793",2022-07-13,"16 - 1022",50,50,46,4,0,0.92
"2794",2022-07-13,"24 - 1150",107,120,105,2,13,0.981308411214953
"2795",2022-07-13,"24 - 1153",238,240,238,0,2,1
"2796",2022-07-14,"62 - 1011",56,56,53,3,0,0.946428571428571
"2797",2022-07-14,"3 - 1008",154,154,135,19,0,0.876623376623377
"2798",2022-07-14,"16 - 1022",50,50,47,3,0,0.94
"2799",2022-07-14,"24 - 1150",108,120,104,4,12,0.962962962962963
"2800",2022-07-14,"24 - 1153",238,240,238,0,2,1
"2801",2022-07-15,"62 - 1011",56,56,54,2,0,0.964285714285714
"2802",2022-07-15,"3 - 1008",154,154,136,18,0,0.883116883116883
"2803",2022-07-15,"16 - 1022",50,50,47,3,0,0.94
"2804",2022-07-15,"24 - 1150",106,120,104,2,14,0.981132075471698
"2805",2022-07-15,"24 - 1153",238,240,238,0,2,1
"2806",2022-07-16,"62 - 1011",56,56,54,2,0,0.964285714285714
"2807",2022-07-16,"3 - 1008",154,154,135,19,0,0.876623376623377
"2808",2022-07-16,"16 - 1022",50,50,46,4,0,0.92
"2809",2022-07-16,"24 - 1150",106,120,106,0,14,1
"2810",2022-07-16,"24 - 1153",238,240,237,1,2,0.995798319327731
"2811",2022-07-17,"62 - 1011",56,56,55,1,0,0.982142857142857
"2812",2022-07-17,"3 - 1008",154,154,135,19,0,0.876623376623377
"2813",2022-07-17,"16 - 1022",50,50,44,6,0,0.88
"2814",2022-07-17,"24 - 1150",105,120,101,4,15,0.961904761904762
"2815",2022-07-17,"24 - 1153",238,240,238,0,2,1
"2816",2022-07-18,"62 - 1011",56,56,55,1,0,0.982142857142857
"2817",2022-07-18,"3 - 1008",154,154,135,19,0,0.876623376623377
"2818",2022-07-18,"16 - 1022",50,50,44,6,0,0.88
"2819",2022-07-18,"24 - 1150",107,120,107,0,13,1
"2820",2022-07-18,"24 - 1153",238,240,237,1,2,0.995798319327731
"2821",2022-07-19,"62 - 1011",56,56,56,0,0,1
"2822",2022-07-19,"3 - 1008",154,154,137,17,0,0.88961038961039
"2823",2022-07-19,"16 - 1022",50,50,46,4,0,0.92
"2824",2022-07-19,"24 - 1150",107,120,105,2,13,0.981308411214953
"2825",2022-07-19,"24 - 1153",238,240,238,0,2,1
"2826",2022-07-20,"62 - 1011",56,56,56,0,0,1
"2827",2022-07-20,"3 - 1008",154,154,137,17,0,0.88961038961039
"2828",2022-07-20,"16 - 1022",50,50,47,3,0,0.94
"2829",2022-07-20,"24 - 1150",109,120,103,6,11,0.944954128440367
"2830",2022-07-20,"24 - 1153",240,240,239,1,0,0.995833333333333
"2831",2022-07-21,"62 - 1011",56,56,56,0,0,1
"2832",2022-07-21,"3 - 1008",153,154,136,17,1,0.888888888888889
"2833",2022-07-21,"16 - 1022",49,50,45,4,1,0.918367346938776
"2834",2022-07-21,"24 - 1150",109,120,107,2,11,0.981651376146789
"2835",2022-07-21,"24 - 1153",240,240,240,0,0,1
"2836",2022-07-22,"62 - 1011",56,56,56,0,0,1
"2837",2022-07-22,"3 - 1008",153,154,137,16,1,0.895424836601307
"2838",2022-07-22,"16 - 1022",49,50,48,1,1,0.979591836734694
"2839",2022-07-22,"24 - 1150",109,120,107,2,11,0.981651376146789
"2840",2022-07-22,"24 - 1153",240,240,240,0,0,1
"2841",2022-07-23,"62 - 1011",56,56,56,0,0,1
"2842",2022-07-23,"3 - 1008",153,154,137,16,1,0.895424836601307
"2843",2022-07-23,"16 - 1022",49,50,47,2,1,0.959183673469388
"2844",2022-07-23,"24 - 1150",110,120,107,3,10,0.972727272727273
"2845",2022-07-23,"24 - 1153",240,240,240,0,0,1
"2846",2022-07-24,"62 - 1011",56,56,56,0,0,1
"2847",2022-07-24,"3 - 1008",153,154,137,16,1,0.895424836601307
"2848",2022-07-24,"16 - 1022",49,50,47,2,1,0.959183673469388
"2849",2022-07-24,"24 - 1150",110,120,110,0,10,1
"2850",2022-07-24,"24 - 1153",240,240,240,0,0,1
"2851",2022-07-25,"62 - 1011",56,56,56,0,0,1
"2852",2022-07-25,"3 - 1008",153,154,139,14,1,0.908496732026144
"2853",2022-07-25,"16 - 1022",49,50,45,4,1,0.918367346938776
"2854",2022-07-25,"24 - 1150",110,120,110,0,10,1
"2855",2022-07-25,"24 - 1153",240,240,240,0,0,1
"2856",2022-07-26,"62 - 1011",56,56,56,0,0,1
"2857",2022-07-26,"3 - 1008",153,154,140,13,1,0.915032679738562
"2858",2022-07-26,"16 - 1022",49,50,46,3,1,0.938775510204082
"2859",2022-07-26,"24 - 1150",110,120,110,0,10,1
"2860",2022-07-26,"24 - 1153",240,240,240,0,0,1
"2861",2022-07-27,"62 - 1011",56,56,56,0,0,1
"2862",2022-07-27,"3 - 1008",151,154,139,12,3,0.920529801324503
"2863",2022-07-27,"16 - 1022",49,50,46,3,1,0.938775510204082
"2864",2022-07-27,"24 - 1150",113,120,101,12,7,0.893805309734513
"2865",2022-07-27,"24 - 1153",240,240,240,0,0,1
"2866",2022-07-28,"62 - 1011",56,56,56,0,0,1
"2867",2022-07-28,"3 - 1008",151,154,140,11,3,0.927152317880795
"2868",2022-07-28,"16 - 1022",49,50,47,2,1,0.959183673469388
"2869",2022-07-28,"24 - 1150",114,120,108,6,6,0.947368421052632
"2870",2022-07-28,"24 - 1153",237,240,237,0,3,1
"2871",2022-07-29,"62 - 1011",56,56,56,0,0,1
"2872",2022-07-29,"3 - 1008",151,154,142,9,3,0.940397350993378
"2873",2022-07-29,"16 - 1022",49,50,47,2,1,0.959183673469388
"2874",2022-07-29,"24 - 1150",115,120,113,2,5,0.982608695652174
"2875",2022-07-29,"24 - 1153",231,240,231,0,9,1
"2876",2022-07-30,"62 - 1011",56,56,56,0,0,1
"2877",2022-07-30,"3 - 1008",151,154,142,9,3,0.940397350993378
"2878",2022-07-30,"16 - 1022",49,50,46,3,1,0.938775510204082
"2879",2022-07-30,"24 - 1150",115,120,114,1,5,0.991304347826087
"2880",2022-07-30,"24 - 1153",220,240,220,0,20,1
"2881",2022-07-31,"62 - 1011",56,56,56,0,0,1
"2882",2022-07-31,"3 - 1008",152,154,143,9,2,0.94078947368421
"2883",2022-07-31,"16 - 1022",49,50,46,3,1,0.938775510204082
"2884",2022-07-31,"24 - 1150",114,120,114,0,6,1
"2885",2022-07-31,"24 - 1153",218,240,218,0,22,1
"2886",2022-08-01,"62 - 1011",56,56,56,0,0,1
"2887",2022-08-01,"3 - 1008",150,154,141,9,4,0.94
"2888",2022-08-01,"16 - 1022",49,50,44,5,1,0.897959183673469
"2889",2022-08-01,"24 - 1150",114,120,114,0,6,1
"2890",2022-08-01,"24 - 1153",214,240,214,0,26,1
"2891",2022-08-02,"62 - 1011",56,56,56,0,0,1
"2892",2022-08-02,"3 - 1008",149,154,141,8,5,0.946308724832215
"2893",2022-08-02,"16 - 1022",50,50,47,3,0,0.94
"2894",2022-08-02,"24 - 1150",115,120,115,0,5,1
"2895",2022-08-02,"24 - 1153",236,240,235,1,4,0.995762711864407
"2896",2022-08-03,"62 - 1011",61,61,60,1,0,0.983606557377049
"2897",2022-08-03,"3 - 1008",148,154,140,8,6,0.945945945945946
"2898",2022-08-03,"16 - 1022",50,50,47,3,0,0.94
"2899",2022-08-03,"24 - 1150",117,120,117,0,3,1
"2900",2022-08-03,"24 - 1153",237,240,237,0,3,1
"2901",2022-08-04,"62 - 1011",61,61,59,2,0,0.967213114754098
"2902",2022-08-04,"3 - 1008",157,164,150,7,7,0.955414012738854
"2903",2022-08-04,"16 - 1022",50,50,47,3,0,0.94
"2904",2022-08-04,"24 - 1150",119,120,117,2,1,0.983193277310924
"2905",2022-08-04,"24 - 1153",237,240,237,0,3,1
"2906",2022-08-05,"62 - 1011",61,61,61,0,0,1
"2907",2022-08-05,"3 - 1008",157,164,149,8,7,0.949044585987261
"2908",2022-08-05,"16 - 1022",50,50,47,3,0,0.94
"2909",2022-08-05,"24 - 1150",119,120,119,0,1,1
"2910",2022-08-05,"24 - 1153",238,240,235,3,2,0.987394957983193
"2911",2022-08-06,"62 - 1011",61,61,61,0,0,1
"2912",2022-08-06,"3 - 1008",159,164,151,8,5,0.949685534591195
"2913",2022-08-06,"16 - 1022",50,50,47,3,0,0.94
"2914",2022-08-06,"24 - 1150",119,120,119,0,1,1
"2915",2022-08-06,"24 - 1153",239,240,239,0,1,1
"2916",2022-08-07,"62 - 1011",61,61,60,1,0,0.983606557377049
"2917",2022-08-07,"3 - 1008",149,154,141,8,5,0.946308724832215
"2918",2022-08-07,"16 - 1022",50,50,47,3,0,0.94
"2919",2022-08-07,"24 - 1150",119,120,119,0,1,1
"2920",2022-08-07,"24 - 1153",239,240,239,0,1,1
"2921",2022-08-08,"62 - 1011",61,61,60,1,0,0.983606557377049
"2922",2022-08-08,"3 - 1008",159,164,147,12,5,0.924528301886792
"2923",2022-08-08,"16 - 1022",50,50,46,4,0,0.92
"2924",2022-08-08,"24 - 1150",119,120,119,0,1,1
"2925",2022-08-08,"24 - 1153",239,240,237,2,1,0.99163179916318
"2926",2022-08-09,"62 - 1011",61,61,61,0,0,1
"2927",2022-08-09,"3 - 1008",159,164,148,11,5,0.930817610062893
"2928",2022-08-09,"16 - 1022",50,50,47,3,0,0.94
"2929",2022-08-09,"24 - 1150",119,120,119,0,1,1
"2930",2022-08-09,"24 - 1153",239,240,239,0,1,1
"2931",2022-08-10,"62 - 1011",61,61,60,1,0,0.983606557377049
"2932",2022-08-10,"3 - 1008",159,164,151,8,5,0.949685534591195
"2933",2022-08-10,"16 - 1022",50,50,48,2,0,0.96
"2934",2022-08-10,"24 - 1150",117,120,117,0,3,1
"2935",2022-08-10,"24 - 1153",239,240,238,1,1,0.99581589958159
"2936",2022-08-11,"62 - 1011",58,61,58,0,3,1
"2937",2022-08-11,"3 - 1008",159,164,149,10,5,0.937106918238994
"2938",2022-08-11,"16 - 1022",50,50,49,1,0,0.98
"2939",2022-08-11,"24 - 1150",117,120,117,0,3,1
"2940",2022-08-11,"24 - 1153",239,240,239,0,1,1
"2941",2022-08-12,"62 - 1011",61,61,60,1,0,0.983606557377049
"2942",2022-08-12,"3 - 1008",160,164,154,6,4,0.9625
"2943",2022-08-12,"16 - 1022",50,50,49,1,0,0.98
"2944",2022-08-12,"24 - 1150",117,120,116,1,3,0.991452991452991
"2945",2022-08-12,"24 - 1153",239,240,238,1,1,0.99581589958159
"2946",2022-08-13,"62 - 1011",61,61,58,3,0,0.950819672131147
"2947",2022-08-13,"3 - 1008",161,164,155,6,3,0.962732919254658
"2948",2022-08-13,"16 - 1022",50,50,48,2,0,0.96
"2949",2022-08-13,"24 - 1150",117,120,117,0,3,1
"2950",2022-08-13,"24 - 1153",237,240,237,0,3,1
"2951",2022-08-14,"62 - 1011",61,61,58,3,0,0.950819672131147
"2952",2022-08-14,"3 - 1008",158,164,155,3,6,0.981012658227848
"2953",2022-08-14,"16 - 1022",50,50,46,4,0,0.92
"2954",2022-08-14,"24 - 1150",117,120,117,0,3,1
"2955",2022-08-14,"24 - 1153",238,240,237,1,2,0.995798319327731
"2956",2022-08-15,"62 - 1011",61,61,59,2,0,0.967213114754098
"2957",2022-08-15,"3 - 1008",162,164,157,5,2,0.969135802469136
"2958",2022-08-15,"16 - 1022",50,50,48,2,0,0.96
"2959",2022-08-15,"24 - 1150",117,120,117,0,3,1
"2960",2022-08-15,"24 - 1153",239,240,239,0,1,1
"2961",2022-08-16,"62 - 1011",61,61,58,3,0,0.950819672131147
"2962",2022-08-16,"3 - 1008",161,164,158,3,3,0.981366459627329
"2963",2022-08-16,"16 - 1022",50,50,49,1,0,0.98
"2964",2022-08-16,"24 - 1150",117,120,117,0,3,1
"2965",2022-08-16,"24 - 1153",239,240,239,0,1,1
"2966",2022-08-17,"62 - 1011",61,61,58,3,0,0.950819672131147
"2967",2022-08-17,"3 - 1008",161,164,158,3,3,0.981366459627329
"2968",2022-08-17,"16 - 1022",50,50,50,0,0,1
"2969",2022-08-17,"24 - 1150",116,120,114,2,4,0.982758620689655
"2970",2022-08-17,"24 - 1153",239,240,239,0,1,1
"2971",2022-08-18,"62 - 1011",61,61,60,1,0,0.983606557377049
"2972",2022-08-18,"3 - 1008",161,164,157,4,3,0.975155279503106
"2973",2022-08-18,"16 - 1022",50,50,50,0,0,1
"2974",2022-08-18,"24 - 1150",116,120,116,0,4,1
"2975",2022-08-18,"24 - 1153",238,240,238,0,2,1
"2976",2022-08-19,"62 - 1011",61,61,61,0,0,1
"2977",2022-08-19,"3 - 1008",161,164,157,4,3,0.975155279503106
"2978",2022-08-19,"16 - 1022",50,50,50,0,0,1
"2979",2022-08-19,"24 - 1150",113,120,113,0,7,1
"2980",2022-08-19,"24 - 1153",238,240,238,0,2,1
"2981",2022-08-20,"62 - 1011",61,61,60,1,0,0.983606557377049
"2982",2022-08-20,"3 - 1008",162,164,158,4,2,0.975308641975309
"2983",2022-08-20,"16 - 1022",50,50,49,1,0,0.98
"2984",2022-08-20,"24 - 1150",113,120,113,0,7,1
"2985",2022-08-20,"24 - 1153",238,240,238,0,2,1
"2986",2022-08-21,"62 - 1011",61,61,60,1,0,0.983606557377049
"2987",2022-08-21,"3 - 1008",162,164,157,5,2,0.969135802469136
"2988",2022-08-21,"16 - 1022",50,50,45,5,0,0.9
"2989",2022-08-21,"24 - 1150",114,120,112,2,6,0.982456140350877
"2990",2022-08-21,"24 - 1153",238,240,238,0,2,1
"2991",2022-08-22,"62 - 1011",61,61,61,0,0,1
"2992",2022-08-22,"3 - 1008",162,164,156,6,2,0.962962962962963
"2993",2022-08-22,"16 - 1022",50,50,46,4,0,0.92
"2994",2022-08-22,"24 - 1150",113,120,111,2,7,0.982300884955752
"2995",2022-08-22,"24 - 1153",238,240,237,1,2,0.995798319327731
"2996",2022-08-23,"62 - 1011",61,61,60,1,0,0.983606557377049
"2997",2022-08-23,"3 - 1008",162,164,156,6,2,0.962962962962963
"2998",2022-08-23,"16 - 1022",50,50,45,5,0,0.9
"2999",2022-08-23,"24 - 1150",113,120,111,2,7,0.982300884955752
"3000",2022-08-23,"24 - 1153",236,240,235,1,4,0.995762711864407
"3001",2022-08-24,"62 - 1011",61,61,60,1,0,0.983606557377049
"3002",2022-08-24,"3 - 1008",163,164,156,7,1,0.957055214723926
"3003",2022-08-24,"16 - 1022",50,50,47,3,0,0.94
"3004",2022-08-24,"24 - 1150",114,120,114,0,6,1
"3005",2022-08-24,"24 - 1153",236,240,236,0,4,1
"3006",2022-08-25,"62 - 1011",62,64,59,3,2,0.951612903225806
"3007",2022-08-25,"3 - 1008",153,154,147,6,1,0.96078431372549
"3008",2022-08-25,"16 - 1022",50,50,47,3,0,0.94
"3009",2022-08-25,"24 - 1150",113,120,113,0,7,1
"3010",2022-08-25,"24 - 1153",235,240,235,0,5,1
"3011",2022-08-26,"62 - 1011",57,57,56,1,0,0.982456140350877
"3012",2022-08-26,"3 - 1008",153,154,146,7,1,0.954248366013072
"3013",2022-08-26,"16 - 1022",50,50,48,2,0,0.96
"3014",2022-08-26,"24 - 1150",114,120,110,4,6,0.964912280701754
"3015",2022-08-26,"24 - 1153",235,240,235,0,5,1
"3016",2022-08-27,"62 - 1011",57,57,56,1,0,0.982456140350877
"3017",2022-08-27,"3 - 1008",153,154,148,5,1,0.967320261437909
"3018",2022-08-27,"16 - 1022",50,50,47,3,0,0.94
"3019",2022-08-27,"24 - 1150",114,120,114,0,6,1
"3020",2022-08-27,"24 - 1153",235,240,234,1,5,0.995744680851064
"3021",2022-08-28,"62 - 1011",57,57,56,1,0,0.982456140350877
"3022",2022-08-28,"3 - 1008",153,154,148,5,1,0.967320261437909
"3023",2022-08-28,"16 - 1022",50,50,47,3,0,0.94
"3024",2022-08-28,"24 - 1150",115,120,114,1,5,0.991304347826087
"3025",2022-08-28,"24 - 1153",235,240,234,1,5,0.995744680851064
"3026",2022-08-29,"62 - 1011",57,57,56,1,0,0.982456140350877
"3027",2022-08-29,"3 - 1008",154,154,146,8,0,0.948051948051948
"3028",2022-08-29,"16 - 1022",50,50,49,1,0,0.98
"3029",2022-08-29,"24 - 1150",115,120,114,1,5,0.991304347826087
"3030",2022-08-29,"24 - 1153",234,240,234,0,6,1
"3031",2022-08-30,"62 - 1011",57,57,57,0,0,1
"3032",2022-08-30,"3 - 1008",154,154,149,5,0,0.967532467532468
"3033",2022-08-30,"16 - 1022",50,50,50,0,0,1
"3034",2022-08-30,"24 - 1150",115,120,114,1,5,0.991304347826087
"3035",2022-08-30,"24 - 1153",237,240,237,0,3,1
"3036",2022-08-31,"62 - 1011",57,57,56,1,0,0.982456140350877
"3037",2022-08-31,"3 - 1008",154,154,149,5,0,0.967532467532468
"3038",2022-08-31,"16 - 1022",50,50,49,1,0,0.98
"3039",2022-08-31,"24 - 1150",114,120,114,0,6,1
"3040",2022-08-31,"24 - 1153",233,240,233,0,7,1
"3041",2022-09-01,"62 - 1011",57,57,56,1,0,0.982456140350877
"3042",2022-09-01,"3 - 1008",154,154,148,6,0,0.961038961038961
"3043",2022-09-01,"16 - 1022",50,50,48,2,0,0.96
"3044",2022-09-01,"24 - 1150",114,120,114,0,6,1
"3045",2022-09-01,"24 - 1153",231,240,231,0,9,1
"3046",2022-09-02,"62 - 1011",57,57,55,2,0,0.964912280701754
"3047",2022-09-02,"3 - 1008",154,154,148,6,0,0.961038961038961
"3048",2022-09-02,"16 - 1022",50,50,46,4,0,0.92
"3049",2022-09-02,"24 - 1150",114,120,113,1,6,0.991228070175439
"3050",2022-09-02,"24 - 1153",230,240,230,0,10,1
"3051",2022-09-03,"62 - 1011",57,57,56,1,0,0.982456140350877
"3052",2022-09-03,"3 - 1008",154,154,149,5,0,0.967532467532468
"3053",2022-09-03,"16 - 1022",50,50,46,4,0,0.92
"3054",2022-09-03,"24 - 1150",112,120,112,0,8,1
"3055",2022-09-03,"24 - 1153",230,240,230,0,10,1
"3056",2022-09-04,"62 - 1011",57,57,56,1,0,0.982456140350877
"3057",2022-09-04,"3 - 1008",154,154,149,5,0,0.967532467532468
"3058",2022-09-04,"16 - 1022",50,50,45,5,0,0.9
"3059",2022-09-04,"24 - 1150",112,120,111,1,8,0.991071428571429
"3060",2022-09-04,"24 - 1153",230,240,230,0,10,1
"3061",2022-09-05,"62 - 1011",57,57,57,0,0,1
"3062",2022-09-05,"3 - 1008",154,154,148,6,0,0.961038961038961
"3063",2022-09-05,"16 - 1022",50,50,44,6,0,0.88
"3064",2022-09-05,"24 - 1150",111,120,111,0,9,1
"3065",2022-09-05,"24 - 1153",230,240,230,0,10,1
"3066",2022-09-06,"62 - 1011",57,57,57,0,0,1
"3067",2022-09-06,"3 - 1008",154,154,149,5,0,0.967532467532468
"3068",2022-09-06,"16 - 1022",50,50,47,3,0,0.94
"3069",2022-09-06,"24 - 1150",114,120,113,1,6,0.991228070175439
"3070",2022-09-06,"24 - 1153",228,240,228,0,12,1
"3071",2022-09-07,"62 - 1011",57,57,56,1,0,0.982456140350877
"3072",2022-09-07,"3 - 1008",154,154,149,5,0,0.967532467532468
"3073",2022-09-07,"16 - 1022",50,50,47,3,0,0.94
"3074",2022-09-07,"24 - 1150",114,120,113,1,6,0.991228070175439
"3075",2022-09-07,"24 - 1153",225,240,224,1,15,0.995555555555556
"3076",2022-09-08,"62 - 1011",57,57,55,2,0,0.964912280701754
"3077",2022-09-08,"3 - 1008",153,154,149,4,1,0.973856209150327
"3078",2022-09-08,"16 - 1022",50,50,48,2,0,0.96
"3079",2022-09-08,"24 - 1150",114,120,114,0,6,1
"3080",2022-09-08,"24 - 1153",227,240,226,1,13,0.995594713656388
"3081",2022-09-09,"62 - 1011",57,57,53,4,0,0.929824561403509
"3082",2022-09-09,"3 - 1008",154,154,150,4,0,0.974025974025974
"3083",2022-09-09,"16 - 1022",50,50,49,1,0,0.98
"3084",2022-09-09,"24 - 1150",114,120,114,0,6,1
"3085",2022-09-09,"24 - 1153",239,240,239,0,1,1
"3086",2022-09-10,"62 - 1011",57,57,52,5,0,0.912280701754386
"3087",2022-09-10,"3 - 1008",154,154,151,3,0,0.980519480519481
"3088",2022-09-10,"16 - 1022",50,50,49,1,0,0.98
"3089",2022-09-10,"24 - 1150",114,120,114,0,6,1
"3090",2022-09-10,"24 - 1153",238,240,238,0,2,1
"3091",2022-09-11,"62 - 1011",57,57,51,6,0,0.894736842105263
"3092",2022-09-11,"3 - 1008",154,154,151,3,0,0.980519480519481
"3093",2022-09-11,"16 - 1022",50,50,49,1,0,0.98
"3094",2022-09-11,"24 - 1150",113,120,112,1,7,0.991150442477876
"3095",2022-09-11,"24 - 1153",238,240,238,0,2,1
"3096",2022-09-12,"62 - 1011",56,57,54,2,1,0.964285714285714
"3097",2022-09-12,"3 - 1008",154,154,148,6,0,0.961038961038961
"3098",2022-09-12,"16 - 1022",50,50,49,1,0,0.98
"3099",2022-09-12,"24 - 1150",106,120,105,1,14,0.990566037735849
"3100",2022-09-12,"24 - 1153",236,240,236,0,4,1
"3101",2022-09-13,"62 - 1011",56,57,53,3,1,0.946428571428571
"3102",2022-09-13,"3 - 1008",154,154,147,7,0,0.954545454545455
"3103",2022-09-13,"16 - 1022",50,50,49,1,0,0.98
"3104",2022-09-13,"24 - 1150",106,120,103,3,14,0.971698113207547
"3105",2022-09-13,"24 - 1153",236,240,236,0,4,1
"3106",2022-09-14,"62 - 1011",56,57,53,3,1,0.946428571428571
"3107",2022-09-14,"3 - 1008",154,154,148,6,0,0.961038961038961
"3108",2022-09-14,"16 - 1022",50,50,50,0,0,1
"3109",2022-09-14,"24 - 1150",102,120,98,4,18,0.96078431372549
"3110",2022-09-14,"24 - 1153",236,240,236,0,4,1
"3111",2022-09-15,"62 - 1011",56,57,53,3,1,0.946428571428571
"3112",2022-09-15,"3 - 1008",154,154,148,6,0,0.961038961038961
"3113",2022-09-15,"16 - 1022",50,50,50,0,0,1
"3114",2022-09-15,"24 - 1150",112,120,103,9,8,0.919642857142857
"3115",2022-09-15,"24 - 1153",235,240,235,0,5,1
"3116",2022-09-16,"62 - 1011",56,57,53,3,1,0.946428571428571
"3117",2022-09-16,"3 - 1008",154,154,148,6,0,0.961038961038961
"3118",2022-09-16,"16 - 1022",50,50,50,0,0,1
"3119",2022-09-16,"24 - 1150",109,120,109,0,11,1
"3120",2022-09-16,"24 - 1153",235,240,235,0,5,1
"3121",2022-09-17,"62 - 1011",56,57,53,3,1,0.946428571428571
"3122",2022-09-17,"3 - 1008",154,154,148,6,0,0.961038961038961
"3123",2022-09-17,"16 - 1022",50,50,50,0,0,1
"3124",2022-09-17,"24 - 1150",113,120,113,0,7,1
"3125",2022-09-17,"24 - 1153",235,240,235,0,5,1
"3126",2022-09-18,"62 - 1011",56,57,56,0,1,1
"3127",2022-09-18,"3 - 1008",154,154,149,5,0,0.967532467532468
"3128",2022-09-18,"16 - 1022",50,50,50,0,0,1
"3129",2022-09-18,"24 - 1150",113,120,113,0,7,1
"3130",2022-09-18,"24 - 1153",235,240,235,0,5,1
"3131",2022-09-19,"62 - 1011",56,57,55,1,1,0.982142857142857
"3132",2022-09-19,"3 - 1008",154,154,149,5,0,0.967532467532468
"3133",2022-09-19,"16 - 1022",50,50,50,0,0,1
"3134",2022-09-19,"24 - 1150",104,120,102,2,16,0.980769230769231
"3135",2022-09-19,"24 - 1153",236,240,236,0,4,1
"3136",2022-09-20,"62 - 1011",56,57,55,1,1,0.982142857142857
"3137",2022-09-20,"3 - 1008",154,154,148,6,0,0.961038961038961
"3138",2022-09-20,"16 - 1022",50,50,49,1,0,0.98
"3139",2022-09-20,"24 - 1150",108,120,104,4,12,0.962962962962963
"3140",2022-09-20,"24 - 1153",236,240,236,0,4,1
"3141",2022-09-21,"62 - 1011",56,57,56,0,1,1
"3142",2022-09-21,"3 - 1008",154,154,147,7,0,0.954545454545455
"3143",2022-09-21,"16 - 1022",50,50,49,1,0,0.98
"3144",2022-09-21,"24 - 1150",103,120,103,0,17,1
"3145",2022-09-21,"24 - 1153",238,240,238,0,2,1
"3146",2022-09-22,"62 - 1011",56,57,56,0,1,1
"3147",2022-09-22,"3 - 1008",154,154,148,6,0,0.961038961038961
"3148",2022-09-22,"16 - 1022",50,50,48,2,0,0.96
"3149",2022-09-22,"24 - 1150",103,120,103,0,17,1
"3150",2022-09-22,"24 - 1153",238,240,238,0,2,1
"3151",2022-09-23,"62 - 1011",56,57,56,0,1,1
"3152",2022-09-23,"3 - 1008",154,154,150,4,0,0.974025974025974
"3153",2022-09-23,"16 - 1022",50,50,50,0,0,1
"3154",2022-09-23,"24 - 1150",105,120,100,5,15,0.952380952380952
"3155",2022-09-23,"24 - 1153",239,240,239,0,1,1
"3156",2022-09-24,"62 - 1011",56,57,56,0,1,1
"3157",2022-09-24,"3 - 1008",154,154,150,4,0,0.974025974025974
"3158",2022-09-24,"16 - 1022",50,50,50,0,0,1
"3159",2022-09-24,"24 - 1150",105,120,105,0,15,1
"3160",2022-09-24,"24 - 1153",239,240,239,0,1,1
"3161",2022-09-25,"62 - 1011",56,57,56,0,1,1
"3162",2022-09-25,"3 - 1008",154,154,150,4,0,0.974025974025974
"3163",2022-09-25,"16 - 1022",50,50,50,0,0,1
"3164",2022-09-25,"24 - 1150",104,120,99,5,16,0.951923076923077
"3165",2022-09-25,"24 - 1153",239,240,239,0,1,1
"3166",2022-09-26,"62 - 1011",56,57,56,0,1,1
"3167",2022-09-26,"3 - 1008",154,154,149,5,0,0.967532467532468
"3168",2022-09-26,"16 - 1022",50,50,49,1,0,0.98
"3169",2022-09-26,"24 - 1150",109,120,107,2,11,0.981651376146789
"3170",2022-09-26,"24 - 1153",240,240,240,0,0,1
"3171",2022-09-27,"62 - 1011",56,57,56,0,1,1
"3172",2022-09-27,"3 - 1008",154,154,150,4,0,0.974025974025974
"3173",2022-09-27,"16 - 1022",50,50,50,0,0,1
"3174",2022-09-27,"24 - 1150",113,120,111,2,7,0.982300884955752
"3175",2022-09-27,"24 - 1153",240,240,240,0,0,1
"3176",2022-09-28,"62 - 1011",61,62,61,0,1,1
"3177",2022-09-28,"3 - 1008",164,164,158,6,0,0.963414634146341
"3178",2022-09-28,"16 - 1022",50,50,50,0,0,1
"3179",2022-09-28,"24 - 1150",113,120,113,0,7,1
"3180",2022-09-28,"24 - 1153",240,240,240,0,0,1
"3181",2022-09-29,"62 - 1011",61,62,61,0,1,1
"3182",2022-09-29,"3 - 1008",154,154,150,4,0,0.974025974025974
"3183",2022-09-29,"16 - 1022",50,50,50,0,0,1
"3184",2022-09-29,"24 - 1150",112,120,110,2,8,0.982142857142857
"3185",2022-09-29,"24 - 1153",240,240,240,0,0,1
"3186",2022-09-30,"62 - 1011",61,62,60,1,1,0.983606557377049
"3187",2022-09-30,"3 - 1008",163,164,156,7,1,0.957055214723926
"3188",2022-09-30,"16 - 1022",50,50,50,0,0,1
"3189",2022-09-30,"24 - 1150",112,120,112,0,8,1
"3190",2022-09-30,"24 - 1153",240,240,240,0,0,1
"3191",2022-10-01,"62 - 1011",61,62,60,1,1,0.983606557377049
"3192",2022-10-01,"3 - 1008",163,164,155,8,1,0.950920245398773
"3193",2022-10-01,"16 - 1022",50,50,50,0,0,1
"3194",2022-10-01,"24 - 1150",112,120,112,0,8,1
"3195",2022-10-01,"24 - 1153",240,240,240,0,0,1
"3196",2022-10-02,"62 - 1011",61,62,61,0,1,1
"3197",2022-10-02,"3 - 1008",162,164,156,6,2,0.962962962962963
"3198",2022-10-02,"16 - 1022",50,50,50,0,0,1
"3199",2022-10-02,"24 - 1150",111,120,111,0,9,1
"3200",2022-10-02,"24 - 1153",240,240,239,1,0,0.995833333333333
"3201",2022-10-03,"62 - 1011",56,57,56,0,1,1
"3202",2022-10-03,"3 - 1008",152,154,146,6,2,0.960526315789474
"3203",2022-10-03,"16 - 1022",50,50,49,1,0,0.98
"3204",2022-10-03,"24 - 1150",113,120,111,2,7,0.982300884955752
"3205",2022-10-03,"24 - 1153",240,240,240,0,0,1
"3206",2022-10-04,"62 - 1011",56,57,56,0,1,1
"3207",2022-10-04,"3 - 1008",152,154,144,8,2,0.947368421052632
"3208",2022-10-04,"16 - 1022",50,50,49,1,0,0.98
"3209",2022-10-04,"24 - 1150",117,120,114,3,3,0.974358974358974
"3210",2022-10-04,"24 - 1153",240,240,240,0,0,1
"3211",2022-10-05,"62 - 1011",56,57,56,0,1,1
"3212",2022-10-05,"3 - 1008",152,154,142,10,2,0.93421052631579
"3213",2022-10-05,"16 - 1022",50,50,50,0,0,1
"3214",2022-10-05,"24 - 1150",118,120,116,2,2,0.983050847457627
"3215",2022-10-05,"24 - 1153",240,240,239,1,0,0.995833333333333
"3216",2022-10-06,"62 - 1011",56,57,55,1,1,0.982142857142857
"3217",2022-10-06,"3 - 1008",152,154,139,13,2,0.914473684210526
"3218",2022-10-06,"16 - 1022",50,50,50,0,0,1
"3219",2022-10-06,"24 - 1150",118,120,116,2,2,0.983050847457627
"3220",2022-10-06,"24 - 1153",239,240,238,1,1,0.99581589958159
"3221",2022-10-07,"62 - 1011",56,57,56,0,1,1
"3222",2022-10-07,"3 - 1008",152,154,142,10,2,0.93421052631579
"3223",2022-10-07,"16 - 1022",50,50,50,0,0,1
"3224",2022-10-07,"24 - 1150",118,120,118,0,2,1
"3225",2022-10-07,"24 - 1153",240,240,240,0,0,1
"3226",2022-10-08,"62 - 1011",56,57,56,0,1,1
"3227",2022-10-08,"3 - 1008",152,154,142,10,2,0.93421052631579
"3228",2022-10-08,"16 - 1022",50,50,50,0,0,1
"3229",2022-10-08,"24 - 1150",116,120,116,0,4,1
"3230",2022-10-08,"24 - 1153",240,240,240,0,0,1
"3231",2022-10-09,"62 - 1011",56,57,56,0,1,1
"3232",2022-10-09,"3 - 1008",152,154,143,9,2,0.94078947368421
"3233",2022-10-09,"16 - 1022",50,50,50,0,0,1
"3234",2022-10-09,"24 - 1150",114,120,114,0,6,1
"3235",2022-10-09,"24 - 1153",240,240,240,0,0,1
"3236",2022-10-10,"62 - 1011",56,57,56,0,1,1
"3237",2022-10-10,"3 - 1008",152,154,146,6,2,0.960526315789474
"3238",2022-10-10,"16 - 1022",50,50,50,0,0,1
"3239",2022-10-10,"24 - 1150",113,120,113,0,7,1
"3240",2022-10-10,"24 - 1153",240,240,240,0,0,1
"3241",2022-10-11,"62 - 1011",56,57,56,0,1,1
"3242",2022-10-11,"3 - 1008",154,154,147,7,0,0.954545454545455
"3243",2022-10-11,"16 - 1022",50,50,50,0,0,1
"3244",2022-10-11,"24 - 1150",115,120,113,2,5,0.982608695652174
"3245",2022-10-11,"24 - 1153",239,240,239,0,1,1
"3246",2022-10-12,"62 - 1011",56,57,56,0,1,1
"3247",2022-10-12,"3 - 1008",154,154,149,5,0,0.967532467532468
"3248",2022-10-12,"16 - 1022",50,50,50,0,0,1
"3249",2022-10-12,"24 - 1150",116,120,110,6,4,0.948275862068966
"3250",2022-10-12,"24 - 1153",240,240,240,0,0,1
"3251",2022-10-13,"62 - 1011",56,57,54,2,1,0.964285714285714
"3252",2022-10-13,"3 - 1008",153,154,148,5,1,0.967320261437909
"3253",2022-10-13,"16 - 1022",50,50,49,1,0,0.98
"3254",2022-10-13,"24 - 1150",118,120,116,2,2,0.983050847457627
"3255",2022-10-13,"24 - 1153",238,240,238,0,2,1
"3256",2022-10-14,"62 - 1011",61,62,60,1,1,0.983606557377049
"3257",2022-10-14,"3 - 1008",163,164,152,11,1,0.932515337423313
"3258",2022-10-14,"16 - 1022",50,50,50,0,0,1
"3259",2022-10-14,"24 - 1150",115,120,115,0,5,1
"3260",2022-10-14,"24 - 1153",240,240,240,0,0,1
"3261",2022-10-15,"62 - 1011",61,62,61,0,1,1
"3262",2022-10-15,"3 - 1008",153,154,148,5,1,0.967320261437909
"3263",2022-10-15,"16 - 1022",50,50,50,0,0,1
"3264",2022-10-15,"24 - 1150",115,120,115,0,5,1
"3265",2022-10-15,"24 - 1153",240,240,240,0,0,1
"3266",2022-10-16,"62 - 1011",61,62,60,1,1,0.983606557377049
"3267",2022-10-16,"3 - 1008",163,164,152,11,1,0.932515337423313
"3268",2022-10-16,"16 - 1022",50,50,50,0,0,1
"3269",2022-10-16,"24 - 1150",115,120,115,0,5,1
"3270",2022-10-16,"24 - 1153",240,240,240,0,0,1
"3271",2022-10-17,"62 - 1011",62,63,61,1,1,0.983870967741935
"3272",2022-10-17,"3 - 1008",163,164,154,9,1,0.94478527607362
"3273",2022-10-17,"16 - 1022",50,50,48,2,0,0.96
"3274",2022-10-17,"24 - 1150",118,120,118,0,2,1
"3275",2022-10-17,"24 - 1153",240,240,240,0,0,1
"3276",2022-10-18,"62 - 1011",62,63,62,0,1,1
"3277",2022-10-18,"3 - 1008",164,164,159,5,0,0.969512195121951
"3278",2022-10-18,"16 - 1022",50,50,48,2,0,0.96
"3279",2022-10-18,"24 - 1150",120,120,120,0,0,1
"3280",2022-10-18,"24 - 1153",240,240,239,1,0,0.995833333333333
"3281",2022-10-19,"62 - 1011",62,63,61,1,1,0.983870967741935
"3282",2022-10-19,"3 - 1008",164,164,159,5,0,0.969512195121951
"3283",2022-10-19,"16 - 1022",50,50,48,2,0,0.96
"3284",2022-10-19,"24 - 1150",120,120,120,0,0,1
"3285",2022-10-19,"24 - 1153",240,240,240,0,0,1
"3286",2022-10-20,"62 - 1011",62,63,61,1,1,0.983870967741935
"3287",2022-10-20,"3 - 1008",164,164,160,4,0,0.975609756097561
"3288",2022-10-20,"16 - 1022",50,50,46,4,0,0.92
"3289",2022-10-20,"24 - 1150",117,120,117,0,3,1
"3290",2022-10-20,"24 - 1153",240,240,240,0,0,1
"3291",2022-10-21,"62 - 1011",59,60,55,4,1,0.932203389830508
"3292",2022-10-21,"3 - 1008",154,154,151,3,0,0.980519480519481
"3293",2022-10-21,"16 - 1022",50,50,46,4,0,0.92
"3294",2022-10-21,"24 - 1150",117,120,117,0,3,1
"3295",2022-10-21,"24 - 1153",240,240,240,0,0,1
"3296",2022-10-22,"62 - 1011",59,60,56,3,1,0.949152542372881
"3297",2022-10-22,"3 - 1008",154,154,151,3,0,0.980519480519481
"3298",2022-10-22,"16 - 1022",50,50,46,4,0,0.92
"3299",2022-10-22,"24 - 1150",117,120,117,0,3,1
"3300",2022-10-22,"24 - 1153",240,240,240,0,0,1
"3301",2022-10-23,"62 - 1011",59,60,57,2,1,0.966101694915254
"3302",2022-10-23,"3 - 1008",154,154,151,3,0,0.980519480519481
"3303",2022-10-23,"16 - 1022",50,50,48,2,0,0.96
"3304",2022-10-23,"24 - 1150",119,120,116,3,1,0.974789915966387
"3305",2022-10-23,"24 - 1153",240,240,240,0,0,1
"3306",2022-10-24,"62 - 1011",59,60,57,2,1,0.966101694915254
"3307",2022-10-24,"3 - 1008",154,154,149,5,0,0.967532467532468
"3308",2022-10-24,"16 - 1022",50,50,49,1,0,0.98
"3309",2022-10-24,"24 - 1150",119,120,118,1,1,0.991596638655462
"3310",2022-10-24,"24 - 1153",238,240,238,0,2,1
"3311",2022-10-25,"62 - 1011",59,60,56,3,1,0.949152542372881
"3312",2022-10-25,"3 - 1008",154,154,152,2,0,0.987012987012987
"3313",2022-10-25,"16 - 1022",50,50,49,1,0,0.98
"3314",2022-10-25,"24 - 1150",118,120,116,2,2,0.983050847457627
"3315",2022-10-25,"24 - 1153",237,240,237,0,3,1
"3316",2022-10-26,"62 - 1011",59,60,55,4,1,0.932203389830508
"3317",2022-10-26,"3 - 1008",154,154,149,5,0,0.967532467532468
"3318",2022-10-26,"16 - 1022",50,50,50,0,0,1
"3319",2022-10-26,"24 - 1150",113,120,113,0,7,1
"3320",2022-10-26,"24 - 1153",237,240,237,0,3,1
"3321",2022-10-27,"62 - 1011",59,60,54,5,1,0.915254237288136
"3322",2022-10-27,"3 - 1008",154,154,151,3,0,0.980519480519481
"3323",2022-10-27,"16 - 1022",50,50,50,0,0,1
"3324",2022-10-27,"24 - 1150",112,120,112,0,8,1
"3325",2022-10-27,"24 - 1153",237,240,237,0,3,1
"3326",2022-10-28,"62 - 1011",59,60,55,4,1,0.932203389830508
"3327",2022-10-28,"3 - 1008",154,154,152,2,0,0.987012987012987
"3328",2022-10-28,"16 - 1022",50,50,48,2,0,0.96
"3329",2022-10-28,"24 - 1150",114,120,114,0,6,1
"3330",2022-10-28,"24 - 1153",236,240,236,0,4,1
"3331",2022-10-29,"62 - 1011",59,60,56,3,1,0.949152542372881
"3332",2022-10-29,"3 - 1008",154,154,152,2,0,0.987012987012987
"3333",2022-10-29,"16 - 1022",50,50,48,2,0,0.96
"3334",2022-10-29,"24 - 1150",114,120,114,0,6,1
"3335",2022-10-29,"24 - 1153",235,240,235,0,5,1
"3336",2022-10-30,"62 - 1011",59,60,53,6,1,0.898305084745763
"3337",2022-10-30,"3 - 1008",154,154,152,2,0,0.987012987012987
"3338",2022-10-30,"16 - 1022",50,50,47,3,0,0.94
"3339",2022-10-30,"24 - 1150",112,120,109,3,8,0.973214285714286
"3340",2022-10-30,"24 - 1153",235,240,235,0,5,1
"3341",2022-10-31,"62 - 1011",59,60,56,3,1,0.949152542372881
"3342",2022-10-31,"3 - 1008",164,164,155,9,0,0.945121951219512
"3343",2022-10-31,"16 - 1022",50,50,48,2,0,0.96
"3344",2022-10-31,"24 - 1150",108,120,108,0,12,1
"3345",2022-10-31,"24 - 1153",232,240,232,0,8,1
"3346",2022-11-01,"62 - 1011",64,65,62,2,1,0.96875
"3347",2022-11-01,"3 - 1008",163,164,156,7,1,0.957055214723926
"3348",2022-11-01,"16 - 1022",50,50,49,1,0,0.98
"3349",2022-11-01,"24 - 1150",106,120,106,0,14,1
"3350",2022-11-01,"24 - 1153",231,240,231,0,9,1
"3351",2022-11-02,"62 - 1011",59,60,56,3,1,0.949152542372881
"3352",2022-11-02,"3 - 1008",154,154,150,4,0,0.974025974025974
"3353",2022-11-02,"16 - 1022",50,50,46,4,0,0.92
"3354",2022-11-02,"24 - 1150",100,120,100,0,20,1
"3355",2022-11-02,"24 - 1153",226,240,226,0,14,1
"3356",2022-11-03,"62 - 1011",59,60,55,4,1,0.932203389830508
"3357",2022-11-03,"3 - 1008",154,154,149,5,0,0.967532467532468
"3358",2022-11-03,"16 - 1022",50,50,43,7,0,0.86
"3359",2022-11-03,"24 - 1150",103,120,103,0,17,1
"3360",2022-11-03,"24 - 1153",223,240,223,0,17,1
"3361",2022-11-04,"62 - 1011",79,84,54,25,5,0.683544303797468
"3362",2022-11-04,"3 - 1008",154,154,149,5,0,0.967532467532468
"3363",2022-11-04,"16 - 1022",50,50,42,8,0,0.84
"3364",2022-11-04,"24 - 1150",96,120,96,0,24,1
"3365",2022-11-04,"24 - 1153",222,240,222,0,18,1
"3366",2022-11-05,"62 - 1011",79,84,55,24,5,0.69620253164557
"3367",2022-11-05,"3 - 1008",154,154,151,3,0,0.980519480519481
"3368",2022-11-05,"16 - 1022",49,50,39,10,1,0.795918367346939
"3369",2022-11-05,"24 - 1150",96,120,96,0,24,1
"3370",2022-11-05,"24 - 1153",220,240,220,0,20,1
"3371",2022-11-06,"62 - 1011",79,84,54,25,5,0.683544303797468
"3372",2022-11-06,"3 - 1008",154,154,152,2,0,0.987012987012987
"3373",2022-11-06,"16 - 1022",50,50,41,9,0,0.82
"3374",2022-11-06,"24 - 1150",91,120,91,0,29,1
"3375",2022-11-06,"24 - 1153",220,240,220,0,20,1
"3376",2022-11-07,"62 - 1011",79,84,57,22,5,0.721518987341772
"3377",2022-11-07,"3 - 1008",154,154,152,2,0,0.987012987012987
"3378",2022-11-07,"16 - 1022",50,50,40,10,0,0.8
"3379",2022-11-07,"24 - 1150",95,120,95,0,25,1
"3380",2022-11-07,"24 - 1153",230,240,230,0,10,1
"3381",2022-11-08,"62 - 1011",79,84,57,22,5,0.721518987341772
"3382",2022-11-08,"3 - 1008",154,154,153,1,0,0.993506493506494
"3383",2022-11-08,"16 - 1022",50,50,40,10,0,0.8
"3384",2022-11-08,"24 - 1150",97,120,97,0,23,1
"3385",2022-11-08,"24 - 1153",230,240,230,0,10,1
"3386",2022-11-09,"62 - 1011",79,84,57,22,5,0.721518987341772
"3387",2022-11-09,"3 - 1008",154,154,152,2,0,0.987012987012987
"3388",2022-11-09,"16 - 1022",50,50,40,10,0,0.8
"3389",2022-11-09,"24 - 1150",95,120,95,0,25,1
"3390",2022-11-09,"24 - 1153",230,240,230,0,10,1
"3391",2022-11-10,"62 - 1011",79,84,57,22,5,0.721518987341772
"3392",2022-11-10,"3 - 1008",154,154,152,2,0,0.987012987012987
"3393",2022-11-10,"16 - 1022",50,50,39,11,0,0.78
"3394",2022-11-10,"24 - 1150",96,120,96,0,24,1
"3395",2022-11-10,"24 - 1153",226,240,226,0,14,1
"3396",2022-11-11,"62 - 1011",79,84,57,22,5,0.721518987341772
"3397",2022-11-11,"3 - 1008",154,154,151,3,0,0.980519480519481
"3398",2022-11-11,"16 - 1022",50,50,38,12,0,0.76
"3399",2022-11-11,"24 - 1150",95,120,95,0,25,1
"3400",2022-11-11,"24 - 1153",222,240,222,0,18,1
"3401",2022-11-12,"62 - 1011",79,84,58,21,5,0.734177215189873
"3402",2022-11-12,"3 - 1008",154,154,151,3,0,0.980519480519481
"3403",2022-11-12,"16 - 1022",50,50,38,12,0,0.76
"3404",2022-11-12,"24 - 1150",95,120,95,0,25,1
"3405",2022-11-12,"24 - 1153",219,240,219,0,21,1
"3406",2022-11-13,"62 - 1011",79,84,59,20,5,0.746835443037975
"3407",2022-11-13,"3 - 1008",154,154,152,2,0,0.987012987012987
"3408",2022-11-13,"16 - 1022",50,50,38,12,0,0.76
"3409",2022-11-13,"24 - 1150",92,120,92,0,28,1
"3410",2022-11-13,"24 - 1153",216,240,216,0,24,1
"3411",2022-11-14,"62 - 1011",79,84,60,19,5,0.759493670886076
"3412",2022-11-14,"3 - 1008",154,154,152,2,0,0.987012987012987
"3413",2022-11-14,"16 - 1022",50,50,42,8,0,0.84
"3414",2022-11-14,"24 - 1150",94,120,94,0,26,1
"3415",2022-11-14,"24 - 1153",232,240,227,5,8,0.978448275862069
"3416",2022-11-15,"62 - 1011",84,89,69,15,5,0.821428571428571
"3417",2022-11-15,"3 - 1008",154,154,151,3,0,0.980519480519481
"3418",2022-11-15,"16 - 1022",50,50,42,8,0,0.84
"3419",2022-11-15,"24 - 1150",98,140,98,0,42,1
"3420",2022-11-15,"24 - 1153",240,240,237,3,0,0.9875
"3421",2022-11-16,"62 - 1011",84,89,65,19,5,0.773809523809524
"3422",2022-11-16,"3 - 1008",164,174,161,3,10,0.981707317073171
"3423",2022-11-16,"16 - 1022",53,53,45,8,0,0.849056603773585
"3424",2022-11-16,"24 - 1150",104,140,104,0,36,1
"3425",2022-11-16,"24 - 1153",240,240,240,0,0,1
"3426",2022-11-17,"62 - 1011",84,89,65,19,5,0.773809523809524
"3427",2022-11-17,"3 - 1008",174,174,169,5,0,0.971264367816092
"3428",2022-11-17,"16 - 1022",53,53,46,7,0,0.867924528301887
"3429",2022-11-17,"24 - 1150",103,140,101,2,37,0.980582524271845
"3430",2022-11-17,"24 - 1153",240,240,240,0,0,1
"3431",2022-11-18,"62 - 1011",84,89,73,11,5,0.869047619047619
"3432",2022-11-18,"3 - 1008",194,194,183,11,0,0.943298969072165
"3433",2022-11-18,"16 - 1022",53,53,46,7,0,0.867924528301887
"3434",2022-11-18,"24 - 1150",103,140,103,0,37,1
"3435",2022-11-18,"24 - 1153",240,240,240,0,0,1
"3436",2022-11-19,"62 - 1011",84,89,71,13,5,0.845238095238095
"3437",2022-11-19,"3 - 1008",194,194,191,3,0,0.984536082474227
"3438",2022-11-19,"16 - 1022",53,53,46,7,0,0.867924528301887
"3439",2022-11-19,"24 - 1150",102,140,102,0,38,1
"3440",2022-11-19,"24 - 1153",240,240,240,0,0,1
"3441",2022-11-20,"62 - 1011",84,89,72,12,5,0.857142857142857
"3442",2022-11-20,"3 - 1008",214,214,210,4,0,0.981308411214953
"3443",2022-11-20,"16 - 1022",53,53,47,6,0,0.886792452830189
"3444",2022-11-20,"24 - 1150",104,140,104,0,36,1
"3445",2022-11-20,"24 - 1153",240,240,239,1,0,0.995833333333333
"3446",2022-11-21,"62 - 1011",84,89,72,12,5,0.857142857142857
"3447",2022-11-21,"3 - 1008",214,214,212,2,0,0.990654205607477
"3448",2022-11-21,"16 - 1022",53,53,49,4,0,0.924528301886792
"3449",2022-11-21,"24 - 1150",105,150,103,2,45,0.980952380952381
"3450",2022-11-21,"24 - 1153",240,240,239,1,0,0.995833333333333
"3451",2022-11-22,"62 - 1011",83,89,70,13,6,0.843373493975904
"3452",2022-11-22,"3 - 1008",224,226,222,2,2,0.991071428571429
"3453",2022-11-22,"16 - 1022",53,53,50,3,0,0.943396226415094
"3454",2022-11-22,"24 - 1150",111,150,109,2,39,0.981981981981982
"3455",2022-11-22,"24 - 1153",240,240,240,0,0,1
"3456",2022-11-23,"62 - 1011",82,89,74,8,7,0.902439024390244
"3457",2022-11-23,"3 - 1008",224,226,219,5,2,0.977678571428571
"3458",2022-11-23,"16 - 1022",53,53,52,1,0,0.981132075471698
"3459",2022-11-23,"24 - 1150",122,150,116,6,28,0.950819672131147
"3460",2022-11-23,"24 - 1153",237,240,237,0,3,1
"3461",2022-11-24,"62 - 1011",81,89,70,11,8,0.864197530864197
"3462",2022-11-24,"3 - 1008",223,226,221,2,3,0.991031390134529
"3463",2022-11-24,"16 - 1022",53,53,51,2,0,0.962264150943396
"3464",2022-11-24,"24 - 1150",131,150,127,4,19,0.969465648854962
"3465",2022-11-24,"24 - 1153",237,240,237,0,3,1
"3466",2022-11-25,"62 - 1011",80,89,70,10,9,0.875
"3467",2022-11-25,"3 - 1008",224,226,221,3,2,0.986607142857143
"3468",2022-11-25,"16 - 1022",53,53,52,1,0,0.981132075471698
"3469",2022-11-25,"24 - 1150",130,170,129,1,40,0.992307692307692
"3470",2022-11-25,"24 - 1153",237,240,237,0,3,1
"3471",2022-11-26,"62 - 1011",79,84,69,10,5,0.873417721518987
"3472",2022-11-26,"3 - 1008",224,226,220,4,2,0.982142857142857
"3473",2022-11-26,"16 - 1022",53,53,51,2,0,0.962264150943396
"3474",2022-11-26,"24 - 1150",128,170,128,0,42,1
"3475",2022-11-26,"24 - 1153",237,240,236,1,3,0.9957805907173
"3476",2022-11-27,"62 - 1011",79,84,69,10,5,0.873417721518987
"3477",2022-11-27,"3 - 1008",225,226,221,4,1,0.982222222222222
"3478",2022-11-27,"16 - 1022",53,53,50,3,0,0.943396226415094
"3479",2022-11-27,"24 - 1150",124,170,124,0,46,1
"3480",2022-11-27,"24 - 1153",236,240,236,0,4,1
"3481",2022-11-28,"62 - 1011",79,84,69,10,5,0.873417721518987
"3482",2022-11-28,"3 - 1008",230,236,225,5,6,0.978260869565217
"3483",2022-11-28,"16 - 1022",53,53,51,2,0,0.962264150943396
"3484",2022-11-28,"24 - 1150",124,180,124,0,56,1
"3485",2022-11-28,"24 - 1153",234,240,234,0,6,1
"3486",2022-11-29,"62 - 1011",79,84,69,10,5,0.873417721518987
"3487",2022-11-29,"3 - 1008",231,236,228,3,5,0.987012987012987
"3488",2022-11-29,"16 - 1022",53,53,51,2,0,0.962264150943396
"3489",2022-11-29,"24 - 1150",165,217,160,5,52,0.96969696969697
"3490",2022-11-29,"24 - 1153",235,254,235,0,19,1
"3491",2022-11-30,"62 - 1011",79,84,67,12,5,0.848101265822785
"3492",2022-11-30,"3 - 1008",231,236,229,2,5,0.991341991341991
"3493",2022-11-30,"16 - 1022",53,53,49,4,0,0.924528301886792
"3494",2022-11-30,"24 - 1150",174,217,174,0,43,1
"3495",2022-11-30,"24 - 1153",241,254,240,1,13,0.995850622406639
"3496",2022-12-01,"62 - 1011",79,84,68,11,5,0.860759493670886
"3497",2022-12-01,"3 - 1008",231,236,228,3,5,0.987012987012987
"3498",2022-12-01,"16 - 1022",53,53,48,5,0,0.905660377358491
"3499",2022-12-01,"24 - 1150",165,266,165,0,101,1
"3500",2022-12-01,"24 - 1153",244,254,243,1,10,0.995901639344262
"3501",2022-12-02,"62 - 1011",79,84,69,10,5,0.873417721518987
"3502",2022-12-02,"3 - 1008",230,236,224,6,6,0.973913043478261
"3503",2022-12-02,"16 - 1022",53,53,52,1,0,0.981132075471698
"3504",2022-12-02,"24 - 1150",181,266,181,0,85,1
"3505",2022-12-02,"24 - 1153",247,254,246,1,7,0.995951417004049
"3506",2022-12-03,"62 - 1011",79,84,69,10,5,0.873417721518987
"3507",2022-12-03,"3 - 1008",230,236,226,4,6,0.982608695652174
"3508",2022-12-03,"16 - 1022",53,53,50,3,0,0.943396226415094
"3509",2022-12-03,"24 - 1150",179,266,179,0,87,1
"3510",2022-12-03,"24 - 1153",247,254,244,3,7,0.987854251012146
"3511",2022-12-04,"62 - 1011",79,84,69,10,5,0.873417721518987
"3512",2022-12-04,"3 - 1008",230,236,228,2,6,0.991304347826087
"3513",2022-12-04,"16 - 1022",53,53,50,3,0,0.943396226415094
"3514",2022-12-04,"24 - 1150",179,266,178,1,87,0.994413407821229
"3515",2022-12-04,"24 - 1153",246,254,244,2,8,0.991869918699187
"3516",2022-12-05,"62 - 1011",79,84,72,7,5,0.911392405063291
"3517",2022-12-05,"3 - 1008",230,236,227,3,6,0.98695652173913
"3518",2022-12-05,"16 - 1022",53,53,49,4,0,0.924528301886792
"3519",2022-12-05,"24 - 1150",201,266,195,6,65,0.970149253731343
"3520",2022-12-05,"24 - 1153",247,254,247,0,7,1
"3521",2022-12-06,"62 - 1011",79,84,71,8,5,0.89873417721519
"3522",2022-12-06,"3 - 1008",230,236,228,2,6,0.991304347826087
"3523",2022-12-06,"16 - 1022",53,53,49,4,0,0.924528301886792
"3524",2022-12-06,"24 - 1150",233,266,215,18,33,0.92274678111588
"3525",2022-12-06,"24 - 1153",247,254,247,0,7,1
"3526",2022-12-07,"62 - 1011",79,84,71,8,5,0.89873417721519
"3527",2022-12-07,"3 - 1008",230,236,227,3,6,0.98695652173913
"3528",2022-12-07,"16 - 1022",53,53,50,3,0,0.943396226415094
"3529",2022-12-07,"24 - 1150",241,266,238,3,25,0.987551867219917
"3530",2022-12-07,"24 - 1153",247,254,242,5,7,0.979757085020243
"3531",2022-12-08,"62 - 1011",79,84,71,8,5,0.89873417721519
"3532",2022-12-08,"3 - 1008",230,236,228,2,6,0.991304347826087
"3533",2022-12-08,"16 - 1022",53,53,52,1,0,0.981132075471698
"3534",2022-12-08,"24 - 1150",245,266,238,7,21,0.971428571428571
"3535",2022-12-08,"24 - 1153",252,254,247,5,2,0.98015873015873
"3536",2022-12-09,"62 - 1011",79,84,70,9,5,0.886075949367089
"3537",2022-12-09,"3 - 1008",229,236,228,1,7,0.995633187772926
"3538",2022-12-09,"16 - 1022",53,53,51,2,0,0.962264150943396
"3539",2022-12-09,"24 - 1150",241,266,235,6,25,0.975103734439834
"3540",2022-12-09,"24 - 1153",252,254,243,9,2,0.964285714285714
"3541",2022-12-10,"62 - 1011",79,84,70,9,5,0.886075949367089
"3542",2022-12-10,"3 - 1008",229,236,227,2,7,0.991266375545852
"3543",2022-12-10,"16 - 1022",53,53,51,2,0,0.962264150943396
"3544",2022-12-10,"24 - 1150",241,266,240,1,25,0.995850622406639
"3545",2022-12-10,"24 - 1153",249,254,248,1,5,0.995983935742972
"3546",2022-12-11,"62 - 1011",79,84,70,9,5,0.886075949367089
"3547",2022-12-11,"3 - 1008",229,236,226,3,7,0.986899563318777
"3548",2022-12-11,"16 - 1022",53,53,51,2,0,0.962264150943396
"3549",2022-12-11,"24 - 1150",244,266,242,2,22,0.991803278688525
"3550",2022-12-11,"24 - 1153",249,254,248,1,5,0.995983935742972
"3551",2022-12-12,"62 - 1011",79,84,70,9,5,0.886075949367089
"3552",2022-12-12,"3 - 1008",228,236,227,1,8,0.995614035087719
"3553",2022-12-12,"16 - 1022",53,53,52,1,0,0.981132075471698
"3554",2022-12-12,"24 - 1150",245,266,240,5,21,0.979591836734694
"3555",2022-12-12,"24 - 1153",249,254,247,2,5,0.991967871485944
"3556",2022-12-13,"62 - 1011",79,84,70,9,5,0.886075949367089
"3557",2022-12-13,"3 - 1008",229,236,229,0,7,1
"3558",2022-12-13,"16 - 1022",53,53,52,1,0,0.981132075471698
"3559",2022-12-13,"24 - 1150",244,266,239,5,22,0.979508196721312
"3560",2022-12-13,"24 - 1153",248,254,248,0,6,1
"3561",2022-12-14,"62 - 1011",79,84,70,9,5,0.886075949367089
"3562",2022-12-14,"3 - 1008",229,236,229,0,7,1
"3563",2022-12-14,"16 - 1022",53,53,51,2,0,0.962264150943396
"3564",2022-12-14,"24 - 1150",243,266,240,3,23,0.987654320987654
"3565",2022-12-14,"24 - 1153",248,254,247,1,6,0.995967741935484
"3566",2022-12-15,"62 - 1011",79,84,70,9,5,0.886075949367089
"3567",2022-12-15,"3 - 1008",230,236,230,0,6,1
"3568",2022-12-15,"16 - 1022",53,53,51,2,0,0.962264150943396
"3569",2022-12-15,"24 - 1150",243,266,241,2,23,0.991769547325103
"3570",2022-12-15,"24 - 1153",248,254,248,0,6,1
"3571",2022-12-16,"62 - 1011",79,84,70,9,5,0.886075949367089
"3572",2022-12-16,"3 - 1008",230,236,230,0,6,1
"3573",2022-12-16,"16 - 1022",53,53,50,3,0,0.943396226415094
"3574",2022-12-16,"24 - 1150",244,266,243,1,22,0.995901639344262
"3575",2022-12-16,"24 - 1153",252,279,251,1,27,0.996031746031746
"3576",2022-12-17,"62 - 1011",79,84,70,9,5,0.886075949367089
"3577",2022-12-17,"3 - 1008",230,236,230,0,6,1
"3578",2022-12-17,"16 - 1022",53,53,50,3,0,0.943396226415094
"3579",2022-12-17,"24 - 1150",240,266,239,1,26,0.995833333333333
"3580",2022-12-17,"24 - 1153",252,279,252,0,27,1
"3581",2022-12-18,"62 - 1011",79,84,70,9,5,0.886075949367089
"3582",2022-12-18,"3 - 1008",230,236,230,0,6,1
"3583",2022-12-18,"16 - 1022",53,53,50,3,0,0.943396226415094
"3584",2022-12-18,"24 - 1150",241,266,241,0,25,1
"3585",2022-12-18,"24 - 1153",252,279,251,1,27,0.996031746031746
"3586",2022-12-19,"62 - 1011",79,84,69,10,5,0.873417721518987
"3587",2022-12-19,"3 - 1008",230,236,230,0,6,1
"3588",2022-12-19,"16 - 1022",53,53,51,2,0,0.962264150943396
"3589",2022-12-19,"24 - 1150",243,266,239,4,23,0.983539094650206
"3590",2022-12-19,"24 - 1153",261,304,260,1,43,0.996168582375479
"3591",2022-12-20,"62 - 1011",76,82,68,8,6,0.894736842105263
"3592",2022-12-20,"3 - 1008",229,236,227,2,7,0.991266375545852
"3593",2022-12-20,"16 - 1022",53,53,52,1,0,0.981132075471698
"3594",2022-12-20,"24 - 1150",241,266,239,2,25,0.991701244813278
"3595",2022-12-20,"24 - 1153",267,304,267,0,37,1
"3596",2022-12-21,"62 - 1011",76,82,68,8,6,0.894736842105263
"3597",2022-12-21,"3 - 1008",228,236,228,0,8,1
"3598",2022-12-21,"16 - 1022",53,53,49,4,0,0.924528301886792
"3599",2022-12-21,"24 - 1150",242,266,241,1,24,0.995867768595041
"3600",2022-12-21,"24 - 1153",267,304,266,1,37,0.99625468164794
"3601",2022-12-22,"62 - 1011",76,82,68,8,6,0.894736842105263
"3602",2022-12-22,"3 - 1008",229,236,228,1,7,0.995633187772926
"3603",2022-12-22,"16 - 1022",53,53,48,5,0,0.905660377358491
"3604",2022-12-22,"24 - 1150",239,266,235,4,27,0.98326359832636
"3605",2022-12-22,"24 - 1153",267,314,266,1,47,0.99625468164794
"3606",2022-12-23,"62 - 1011",76,82,67,9,6,0.881578947368421
"3607",2022-12-23,"3 - 1008",230,236,228,2,6,0.991304347826087
"3608",2022-12-23,"16 - 1022",53,53,44,9,0,0.830188679245283
"3609",2022-12-23,"24 - 1150",247,266,245,2,19,0.991902834008097
"3610",2022-12-23,"24 - 1153",278,399,270,8,121,0.971223021582734
"3611",2022-12-24,"62 - 1011",76,82,69,7,6,0.907894736842105
"3612",2022-12-24,"3 - 1008",230,236,228,2,6,0.991304347826087
"3613",2022-12-24,"16 - 1022",53,53,47,6,0,0.886792452830189
"3614",2022-12-24,"24 - 1150",248,266,244,4,18,0.983870967741935
"3615",2022-12-24,"24 - 1153",278,399,277,1,121,0.996402877697842
"3616",2022-12-25,"62 - 1011",76,82,69,7,6,0.907894736842105
"3617",2022-12-25,"3 - 1008",230,236,228,2,6,0.991304347826087
"3618",2022-12-25,"16 - 1022",53,53,47,6,0,0.886792452830189
"3619",2022-12-25,"24 - 1150",248,266,246,2,18,0.991935483870968
"3620",2022-12-25,"24 - 1153",278,399,278,0,121,1
"3621",2022-12-26,"62 - 1011",76,82,68,8,6,0.894736842105263
"3622",2022-12-26,"3 - 1008",230,236,226,4,6,0.982608695652174
"3623",2022-12-26,"16 - 1022",53,53,47,6,0,0.886792452830189
"3624",2022-12-26,"24 - 1150",248,266,247,1,18,0.995967741935484
"3625",2022-12-26,"24 - 1153",278,399,276,2,121,0.992805755395683
"3626",2022-12-27,"62 - 1011",76,82,68,8,6,0.894736842105263
"3627",2022-12-27,"3 - 1008",230,236,225,5,6,0.978260869565217
"3628",2022-12-27,"16 - 1022",53,53,47,6,0,0.886792452830189
"3629",2022-12-27,"24 - 1150",249,266,248,1,17,0.995983935742972
"3630",2022-12-27,"24 - 1153",278,399,278,0,121,1
"3631",2022-12-28,"62 - 1011",76,82,68,8,6,0.894736842105263
"3632",2022-12-28,"3 - 1008",229,236,226,3,7,0.986899563318777
"3633",2022-12-28,"16 - 1022",53,53,47,6,0,0.886792452830189
"3634",2022-12-28,"24 - 1150",248,266,247,1,18,0.995967741935484
"3635",2022-12-28,"24 - 1153",284,399,282,2,115,0.992957746478873
"3636",2022-12-29,"62 - 1011",76,82,69,7,6,0.907894736842105
"3637",2022-12-29,"3 - 1008",226,236,219,7,10,0.969026548672566
"3638",2022-12-29,"16 - 1022",53,53,47,6,0,0.886792452830189
"3639",2022-12-29,"24 - 1150",248,266,246,2,18,0.991935483870968
"3640",2022-12-29,"24 - 1153",284,399,281,3,115,0.98943661971831
"3641",2022-12-30,"62 - 1011",78,82,75,3,4,0.961538461538462
"3642",2022-12-30,"3 - 1008",221,236,219,2,15,0.990950226244344
"3643",2022-12-30,"16 - 1022",53,53,49,4,0,0.924528301886792
"3644",2022-12-30,"24 - 1150",250,266,248,2,16,0.992
"3645",2022-12-30,"24 - 1153",284,399,284,0,115,1
"3646",2022-12-31,"62 - 1011",79,82,76,3,3,0.962025316455696
"3647",2022-12-31,"3 - 1008",225,236,224,1,11,0.995555555555556
"3648",2022-12-31,"16 - 1022",53,53,49,4,0,0.924528301886792
"3649",2022-12-31,"24 - 1150",249,266,248,1,17,0.995983935742972
"3650",2022-12-31,"24 - 1153",284,399,284,0,115,1
"3651",2023-01-01,"62 - 1011",79,82,76,3,3,0.962025316455696
"3652",2023-01-01,"3 - 1008",225,236,224,1,11,0.995555555555556
"3653",2023-01-01,"16 - 1022",53,53,47,6,0,0.886792452830189
"3654",2023-01-01,"24 - 1150",249,266,247,2,17,0.991967871485944
"3655",2023-01-01,"24 - 1153",284,399,284,0,115,1
"3656",2023-01-02,"62 - 1011",79,82,78,1,3,0.987341772151899
"3657",2023-01-02,"3 - 1008",225,236,221,4,11,0.982222222222222
"3658",2023-01-02,"16 - 1022",53,53,46,7,0,0.867924528301887
"3659",2023-01-02,"24 - 1150",248,266,247,1,18,0.995967741935484
"3660",2023-01-02,"24 - 1153",283,399,283,0,116,1
"3661",2023-01-03,"62 - 1011",79,82,78,1,3,0.987341772151899
"3662",2023-01-03,"3 - 1008",222,236,222,0,14,1
"3663",2023-01-03,"16 - 1022",53,53,48,5,0,0.905660377358491
"3664",2023-01-03,"24 - 1150",249,266,247,2,17,0.991967871485944
"3665",2023-01-03,"24 - 1153",286,399,284,2,113,0.993006993006993
"3666",2023-01-04,"62 - 1011",79,82,75,4,3,0.949367088607595
"3667",2023-01-04,"3 - 1008",220,236,219,1,16,0.995454545454545
"3668",2023-01-04,"16 - 1022",53,53,50,3,0,0.943396226415094
"3669",2023-01-04,"24 - 1150",249,266,249,0,17,1
"3670",2023-01-04,"24 - 1153",291,399,291,0,108,1
"3671",2023-01-05,"62 - 1011",79,82,75,4,3,0.949367088607595
"3672",2023-01-05,"3 - 1008",220,236,220,0,16,1
"3673",2023-01-05,"16 - 1022",53,53,49,4,0,0.924528301886792
"3674",2023-01-05,"24 - 1150",249,266,249,0,17,1
"3675",2023-01-05,"24 - 1153",293,399,292,1,106,0.996587030716723
"3676",2023-01-06,"62 - 1011",79,82,75,4,3,0.949367088607595
"3677",2023-01-06,"3 - 1008",222,236,221,1,14,0.995495495495496
"3678",2023-01-06,"16 - 1022",53,53,49,4,0,0.924528301886792
"3679",2023-01-06,"24 - 1150",252,266,251,1,14,0.996031746031746
"3680",2023-01-06,"24 - 1153",293,399,293,0,106,1
"3681",2023-01-07,"62 - 1011",79,82,76,3,3,0.962025316455696
"3682",2023-01-07,"3 - 1008",222,236,218,4,14,0.981981981981982
"3683",2023-01-07,"16 - 1022",53,53,46,7,0,0.867924528301887
"3684",2023-01-07,"24 - 1150",251,266,250,1,15,0.99601593625498
"3685",2023-01-07,"24 - 1153",293,399,293,0,106,1
"3686",2023-01-08,"62 - 1011",79,82,75,4,3,0.949367088607595
"3687",2023-01-08,"3 - 1008",225,236,224,1,11,0.995555555555556
"3688",2023-01-08,"16 - 1022",53,53,46,7,0,0.867924528301887
"3689",2023-01-08,"24 - 1150",251,266,251,0,15,1
"3690",2023-01-08,"24 - 1153",294,399,294,0,105,1
"3691",2023-01-09,"62 - 1011",79,82,76,3,3,0.962025316455696
"3692",2023-01-09,"3 - 1008",222,236,220,2,14,0.990990990990991
"3693",2023-01-09,"16 - 1022",53,53,46,7,0,0.867924528301887
"3694",2023-01-09,"24 - 1150",251,266,250,1,15,0.99601593625498
"3695",2023-01-09,"24 - 1153",299,399,299,0,100,1
"3696",2023-01-10,"62 - 1011",79,82,75,4,3,0.949367088607595
"3697",2023-01-10,"3 - 1008",225,236,222,3,11,0.986666666666667
"3698",2023-01-10,"16 - 1022",53,53,46,7,0,0.867924528301887
"3699",2023-01-10,"24 - 1150",253,266,250,3,13,0.988142292490119
"3700",2023-01-10,"24 - 1153",299,399,299,0,100,1
"3701",2023-01-11,"62 - 1011",79,88,76,3,9,0.962025316455696
"3702",2023-01-11,"3 - 1008",227,236,223,4,9,0.982378854625551
"3703",2023-01-11,"16 - 1022",53,53,46,7,0,0.867924528301887
"3704",2023-01-11,"24 - 1150",259,266,256,3,7,0.988416988416988
"3705",2023-01-11,"24 - 1153",305,399,305,0,94,1
"3706",2023-01-12,"62 - 1011",79,88,76,3,9,0.962025316455696
"3707",2023-01-12,"3 - 1008",227,236,226,1,9,0.995594713656388
"3708",2023-01-12,"16 - 1022",53,53,44,9,0,0.830188679245283
"3709",2023-01-12,"24 - 1150",259,266,253,6,7,0.976833976833977
"3710",2023-01-12,"24 - 1153",311,399,311,0,88,1
"3711",2023-01-13,"62 - 1011",81,88,76,5,7,0.938271604938272
"3712",2023-01-13,"3 - 1008",227,236,227,0,9,1
"3713",2023-01-13,"16 - 1022",53,53,46,7,0,0.867924528301887
"3714",2023-01-13,"24 - 1150",259,266,258,1,7,0.996138996138996
"3715",2023-01-13,"24 - 1153",312,399,311,1,87,0.996794871794872
"3716",2023-01-14,"62 - 1011",81,88,78,3,7,0.962962962962963
"3717",2023-01-14,"3 - 1008",228,236,226,2,8,0.991228070175439
"3718",2023-01-14,"16 - 1022",52,53,47,5,1,0.903846153846154
"3719",2023-01-14,"24 - 1150",259,266,259,0,7,1
"3720",2023-01-14,"24 - 1153",312,399,310,2,87,0.993589743589744
"3721",2023-01-15,"62 - 1011",81,88,78,3,7,0.962962962962963
"3722",2023-01-15,"3 - 1008",228,236,228,0,8,1
"3723",2023-01-15,"16 - 1022",52,53,47,5,1,0.903846153846154
"3724",2023-01-15,"24 - 1150",259,266,255,4,7,0.984555984555985
"3725",2023-01-15,"24 - 1153",312,399,312,0,87,1
"3726",2023-01-16,"62 - 1011",81,88,76,5,7,0.938271604938272
"3727",2023-01-16,"3 - 1008",227,236,226,1,9,0.995594713656388
"3728",2023-01-16,"16 - 1022",52,53,50,2,1,0.961538461538462
"3729",2023-01-16,"24 - 1150",258,266,253,5,8,0.98062015503876
"3730",2023-01-16,"24 - 1153",321,402,321,0,81,1
"3731",2023-01-17,"62 - 1011",81,88,75,6,7,0.925925925925926
"3732",2023-01-17,"3 - 1008",227,236,225,2,9,0.991189427312775
"3733",2023-01-17,"16 - 1022",52,53,52,0,1,1
"3734",2023-01-17,"24 - 1150",259,266,255,4,7,0.984555984555985
"3735",2023-01-17,"24 - 1153",322,402,322,0,80,1
"3736",2023-01-18,"62 - 1011",81,88,76,5,7,0.938271604938272
"3737",2023-01-18,"3 - 1008",226,236,225,1,10,0.995575221238938
"3738",2023-01-18,"16 - 1022",52,53,52,0,1,1
"3739",2023-01-18,"24 - 1150",258,266,255,3,8,0.988372093023256
"3740",2023-01-18,"24 - 1153",338,422,336,2,84,0.994082840236686
"3741",2023-01-19,"62 - 1011",81,88,77,4,7,0.950617283950617
"3742",2023-01-19,"3 - 1008",230,236,228,2,6,0.991304347826087
"3743",2023-01-19,"16 - 1022",52,53,51,1,1,0.980769230769231
"3744",2023-01-19,"24 - 1150",259,266,257,2,7,0.992277992277992
"3745",2023-01-19,"24 - 1153",333,354,332,1,21,0.996996996996997
"3746",2023-01-20,"62 - 1011",81,88,77,4,7,0.950617283950617
"3747",2023-01-20,"3 - 1008",230,236,228,2,6,0.991304347826087
"3748",2023-01-20,"16 - 1022",52,53,50,2,1,0.961538461538462
"3749",2023-01-20,"24 - 1150",258,266,254,4,8,0.984496124031008
"3750",2023-01-20,"24 - 1153",334,362,333,1,28,0.997005988023952
"3751",2023-01-21,"62 - 1011",81,88,78,3,7,0.962962962962963
"3752",2023-01-21,"3 - 1008",230,236,228,2,6,0.991304347826087
"3753",2023-01-21,"16 - 1022",52,53,49,3,1,0.942307692307692
"3754",2023-01-21,"24 - 1150",258,266,254,4,8,0.984496124031008
"3755",2023-01-21,"24 - 1153",336,362,335,1,26,0.99702380952381
"3756",2023-01-22,"62 - 1011",81,88,79,2,7,0.975308641975309
"3757",2023-01-22,"3 - 1008",230,236,227,3,6,0.98695652173913
"3758",2023-01-22,"16 - 1022",52,53,49,3,1,0.942307692307692
"3759",2023-01-22,"24 - 1150",258,266,254,4,8,0.984496124031008
"3760",2023-01-22,"24 - 1153",337,362,337,0,25,1
"3761",2023-01-23,"62 - 1011",81,88,78,3,7,0.962962962962963
"3762",2023-01-23,"3 - 1008",228,236,226,2,8,0.991228070175439
"3763",2023-01-23,"16 - 1022",53,53,52,1,0,0.981132075471698
"3764",2023-01-23,"24 - 1150",259,266,257,2,7,0.992277992277992
"3765",2023-01-23,"24 - 1153",341,362,339,2,21,0.994134897360704
"3766",2023-01-24,"62 - 1011",81,98,78,3,17,0.962962962962963
"3767",2023-01-24,"3 - 1008",228,236,226,2,8,0.991228070175439
"3768",2023-01-24,"16 - 1022",53,53,51,2,0,0.962264150943396
"3769",2023-01-24,"24 - 1150",259,266,259,0,7,1
"3770",2023-01-24,"24 - 1153",343,362,343,0,19,1
"3771",2023-01-25,"62 - 1011",80,98,77,3,18,0.9625
"3772",2023-01-25,"3 - 1008",227,236,225,2,9,0.991189427312775
"3773",2023-01-25,"16 - 1022",53,53,51,2,0,0.962264150943396
"3774",2023-01-25,"24 - 1150",258,266,256,2,8,0.992248062015504
"3775",2023-01-25,"24 - 1153",346,365,343,3,19,0.991329479768786
"3776",2023-01-26,"62 - 1011",81,98,77,4,17,0.950617283950617
"3777",2023-01-26,"3 - 1008",227,236,226,1,9,0.995594713656388
"3778",2023-01-26,"16 - 1022",53,53,51,2,0,0.962264150943396
"3779",2023-01-26,"24 - 1150",259,266,253,6,7,0.976833976833977
"3780",2023-01-26,"24 - 1153",344,355,344,0,11,1
"3781",2023-01-27,"62 - 1011",81,98,76,5,17,0.938271604938272
"3782",2023-01-27,"3 - 1008",228,236,227,1,8,0.995614035087719
"3783",2023-01-27,"16 - 1022",53,53,51,2,0,0.962264150943396
"3784",2023-01-27,"24 - 1150",257,266,254,3,9,0.988326848249027
"3785",2023-01-27,"24 - 1153",345,355,340,5,10,0.985507246376812
"3786",2023-01-28,"62 - 1011",81,98,76,5,17,0.938271604938272
"3787",2023-01-28,"3 - 1008",228,236,226,2,8,0.991228070175439
"3788",2023-01-28,"16 - 1022",53,53,53,0,0,1
"3789",2023-01-28,"24 - 1150",257,266,254,3,9,0.988326848249027
"3790",2023-01-28,"24 - 1153",349,355,347,2,6,0.994269340974212
"3791",2023-01-29,"62 - 1011",81,98,76,5,17,0.938271604938272
"3792",2023-01-29,"3 - 1008",228,236,228,0,8,1
"3793",2023-01-29,"16 - 1022",53,53,53,0,0,1
"3794",2023-01-29,"24 - 1150",257,266,256,1,9,0.996108949416342
"3795",2023-01-29,"24 - 1153",349,355,348,1,6,0.997134670487106
"3796",2023-01-30,"62 - 1011",81,98,77,4,17,0.950617283950617
"3797",2023-01-30,"3 - 1008",228,236,227,1,8,0.995614035087719
"3798",2023-01-30,"16 - 1022",53,53,53,0,0,1
"3799",2023-01-30,"24 - 1150",257,266,256,1,9,0.996108949416342
"3800",2023-01-30,"24 - 1153",348,355,348,0,7,1
"3801",2023-01-31,"62 - 1011",81,98,77,4,17,0.950617283950617
"3802",2023-01-31,"3 - 1008",230,236,227,3,6,0.98695652173913
"3803",2023-01-31,"16 - 1022",53,53,52,1,0,0.981132075471698
"3804",2023-01-31,"24 - 1150",256,266,256,0,10,1
"3805",2023-01-31,"24 - 1153",348,355,348,0,7,1
"3806",2023-02-01,"62 - 1011",86,98,81,5,12,0.941860465116279
"3807",2023-02-01,"3 - 1008",234,236,229,5,2,0.978632478632479
"3808",2023-02-01,"16 - 1022",53,53,51,2,0,0.962264150943396
"3809",2023-02-01,"24 - 1150",256,266,255,1,10,0.99609375
"3810",2023-02-01,"24 - 1153",350,355,349,1,5,0.997142857142857
"3811",2023-02-02,"62 - 1011",83,98,81,2,15,0.975903614457831
"3812",2023-02-02,"3 - 1008",233,236,230,3,3,0.987124463519313
"3813",2023-02-02,"16 - 1022",53,53,52,1,0,0.981132075471698
"3814",2023-02-02,"24 - 1150",259,266,254,5,7,0.980694980694981
"3815",2023-02-02,"24 - 1153",352,355,352,0,3,1
"3816",2023-02-03,"62 - 1011",83,98,81,2,15,0.975903614457831
"3817",2023-02-03,"3 - 1008",233,236,228,5,3,0.978540772532189
"3818",2023-02-03,"16 - 1022",53,53,53,0,0,1
"3819",2023-02-03,"24 - 1150",259,266,257,2,7,0.992277992277992
"3820",2023-02-03,"24 - 1153",352,355,351,1,3,0.997159090909091
"3821",2023-02-04,"62 - 1011",97,98,81,16,1,0.835051546391753
"3822",2023-02-04,"3 - 1008",233,236,226,7,3,0.969957081545064
"3823",2023-02-04,"16 - 1022",53,53,53,0,0,1
"3824",2023-02-04,"24 - 1150",259,266,253,6,7,0.976833976833977
"3825",2023-02-04,"24 - 1153",351,355,349,2,4,0.994301994301994
"3826",2023-02-05,"62 - 1011",97,98,82,15,1,0.845360824742268
"3827",2023-02-05,"3 - 1008",233,236,227,6,3,0.974248927038627
"3828",2023-02-05,"16 - 1022",53,53,53,0,0,1
"3829",2023-02-05,"24 - 1150",259,266,258,1,7,0.996138996138996
"3830",2023-02-05,"24 - 1153",351,355,351,0,4,1
"3831",2023-02-06,"62 - 1011",97,98,80,17,1,0.824742268041237
"3832",2023-02-06,"3 - 1008",232,236,229,3,4,0.987068965517241
"3833",2023-02-06,"16 - 1022",53,53,52,1,0,0.981132075471698
"3834",2023-02-06,"24 - 1150",259,266,258,1,7,0.996138996138996
"3835",2023-02-06,"24 - 1153",351,355,351,0,4,1
"3836",2023-02-07,"62 - 1011",97,98,78,19,1,0.804123711340206
"3837",2023-02-07,"3 - 1008",233,236,229,4,3,0.982832618025751
"3838",2023-02-07,"16 - 1022",53,53,52,1,0,0.981132075471698
"3839",2023-02-07,"24 - 1150",259,266,258,1,7,0.996138996138996
"3840",2023-02-07,"24 - 1153",352,355,352,0,3,1
"3841",2023-02-08,"62 - 1011",97,98,77,20,1,0.793814432989691
"3842",2023-02-08,"3 - 1008",233,236,230,3,3,0.987124463519313
"3843",2023-02-08,"16 - 1022",53,53,52,1,0,0.981132075471698
"3844",2023-02-08,"24 - 1150",258,266,255,3,8,0.988372093023256
"3845",2023-02-08,"24 - 1153",337,355,336,1,18,0.997032640949555
"3846",2023-02-09,"62 - 1011",97,98,78,19,1,0.804123711340206
"3847",2023-02-09,"3 - 1008",233,236,231,2,3,0.991416309012876
"3848",2023-02-09,"16 - 1022",53,53,51,2,0,0.962264150943396
"3849",2023-02-09,"24 - 1150",258,266,255,3,8,0.988372093023256
"3850",2023-02-09,"24 - 1153",335,355,333,2,20,0.994029850746269
"3851",2023-02-10,"62 - 1011",97,98,80,17,1,0.824742268041237
"3852",2023-02-10,"3 - 1008",233,236,229,4,3,0.982832618025751
"3853",2023-02-10,"16 - 1022",53,53,51,2,0,0.962264150943396
"3854",2023-02-10,"24 - 1150",256,266,254,2,10,0.9921875
"3855",2023-02-10,"24 - 1153",343,355,341,2,12,0.994169096209913
"3856",2023-02-11,"62 - 1011",97,98,81,16,1,0.835051546391753
"3857",2023-02-11,"3 - 1008",233,236,231,2,3,0.991416309012876
"3858",2023-02-11,"16 - 1022",53,53,51,2,0,0.962264150943396
"3859",2023-02-11,"24 - 1150",256,266,255,1,10,0.99609375
"3860",2023-02-11,"24 - 1153",349,355,348,1,6,0.997134670487106
"3861",2023-02-12,"62 - 1011",97,98,80,17,1,0.824742268041237
"3862",2023-02-12,"3 - 1008",234,236,232,2,2,0.991452991452991
"3863",2023-02-12,"16 - 1022",53,53,50,3,0,0.943396226415094
"3864",2023-02-12,"24 - 1150",256,266,255,1,10,0.99609375
"3865",2023-02-12,"24 - 1153",349,355,348,1,6,0.997134670487106
"3866",2023-02-13,"62 - 1011",97,98,80,17,1,0.824742268041237
"3867",2023-02-13,"3 - 1008",234,236,232,2,2,0.991452991452991
"3868",2023-02-13,"16 - 1022",53,53,52,1,0,0.981132075471698
"3869",2023-02-13,"24 - 1150",256,266,251,5,10,0.98046875
"3870",2023-02-13,"24 - 1153",349,355,349,0,6,1
"3871",2023-02-14,"62 - 1011",97,98,80,17,1,0.824742268041237
"3872",2023-02-14,"3 - 1008",234,236,232,2,2,0.991452991452991
"3873",2023-02-14,"16 - 1022",52,53,50,2,1,0.961538461538462
"3874",2023-02-14,"24 - 1150",256,266,247,9,10,0.96484375
"3875",2023-02-14,"24 - 1153",349,355,349,0,6,1
"3876",2023-02-15,"62 - 1011",97,98,80,17,1,0.824742268041237
"3877",2023-02-15,"3 - 1008",234,236,232,2,2,0.991452991452991
"3878",2023-02-15,"16 - 1022",53,53,49,4,0,0.924528301886792
"3879",2023-02-15,"24 - 1150",256,266,247,9,10,0.96484375
"3880",2023-02-15,"24 - 1153",349,355,349,0,6,1
"3881",2023-02-16,"62 - 1011",97,98,81,16,1,0.835051546391753
"3882",2023-02-16,"3 - 1008",233,236,232,1,3,0.995708154506438
"3883",2023-02-16,"16 - 1022",53,53,51,2,0,0.962264150943396
"3884",2023-02-16,"24 - 1150",256,266,249,7,10,0.97265625
"3885",2023-02-16,"24 - 1153",349,355,349,0,6,1
"3886",2023-02-17,"62 - 1011",97,98,79,18,1,0.814432989690722
"3887",2023-02-17,"3 - 1008",234,236,231,3,2,0.987179487179487
"3888",2023-02-17,"16 - 1022",53,53,52,1,0,0.981132075471698
"3889",2023-02-17,"24 - 1150",258,266,251,7,8,0.972868217054264
"3890",2023-02-17,"24 - 1153",349,355,349,0,6,1
"3891",2023-02-18,"62 - 1011",97,98,81,16,1,0.835051546391753
"3892",2023-02-18,"3 - 1008",234,236,229,5,2,0.978632478632479
"3893",2023-02-18,"16 - 1022",53,53,51,2,0,0.962264150943396
"3894",2023-02-18,"24 - 1150",258,266,258,0,8,1
"3895",2023-02-18,"24 - 1153",349,355,349,0,6,1
"3896",2023-02-19,"62 - 1011",97,98,79,18,1,0.814432989690722
"3897",2023-02-19,"3 - 1008",234,236,232,2,2,0.991452991452991
"3898",2023-02-19,"16 - 1022",53,53,51,2,0,0.962264150943396
"3899",2023-02-19,"24 - 1150",256,266,254,2,10,0.9921875
"3900",2023-02-19,"24 - 1153",349,355,348,1,6,0.997134670487106
"3901",2023-02-20,"62 - 1011",97,98,84,13,1,0.865979381443299
"3902",2023-02-20,"3 - 1008",234,236,231,3,2,0.987179487179487
"3903",2023-02-20,"16 - 1022",53,53,51,2,0,0.962264150943396
"3904",2023-02-20,"24 - 1150",258,266,248,10,8,0.961240310077519
"3905",2023-02-20,"24 - 1153",349,355,349,0,6,1
"3906",2023-02-21,"62 - 1011",97,98,86,11,1,0.88659793814433
"3907",2023-02-21,"3 - 1008",234,236,232,2,2,0.991452991452991
"3908",2023-02-21,"16 - 1022",53,53,52,1,0,0.981132075471698
"3909",2023-02-21,"24 - 1150",258,266,254,4,8,0.984496124031008
"3910",2023-02-21,"24 - 1153",349,355,349,0,6,1
"3911",2023-02-22,"62 - 1011",97,98,85,12,1,0.876288659793814
"3912",2023-02-22,"3 - 1008",233,236,231,2,3,0.991416309012876
"3913",2023-02-22,"16 - 1022",53,53,53,0,0,1
"3914",2023-02-22,"24 - 1150",258,266,256,2,8,0.992248062015504
"3915",2023-02-22,"24 - 1153",348,355,347,1,7,0.997126436781609
"3916",2023-02-23,"62 - 1011",97,98,85,12,1,0.876288659793814
"3917",2023-02-23,"3 - 1008",232,236,229,3,4,0.987068965517241
"3918",2023-02-23,"16 - 1022",53,53,53,0,0,1
"3919",2023-02-23,"24 - 1150",258,266,253,5,8,0.98062015503876
"3920",2023-02-23,"24 - 1153",348,355,348,0,7,1
"3921",2023-02-24,"62 - 1011",97,98,86,11,1,0.88659793814433
"3922",2023-02-24,"3 - 1008",232,236,231,1,4,0.995689655172414
"3923",2023-02-24,"16 - 1022",53,53,52,1,0,0.981132075471698
"3924",2023-02-24,"24 - 1150",258,266,256,2,8,0.992248062015504
"3925",2023-02-24,"24 - 1153",348,355,348,0,7,1
"3926",2023-02-25,"62 - 1011",97,98,86,11,1,0.88659793814433
"3927",2023-02-25,"3 - 1008",232,236,231,1,4,0.995689655172414
"3928",2023-02-25,"16 - 1022",53,53,52,1,0,0.981132075471698
"3929",2023-02-25,"24 - 1150",258,266,258,0,8,1
"3930",2023-02-25,"24 - 1153",348,355,348,0,7,1
"3931",2023-02-26,"62 - 1011",97,98,86,11,1,0.88659793814433
"3932",2023-02-26,"3 - 1008",232,236,230,2,4,0.991379310344828
"3933",2023-02-26,"16 - 1022",53,53,51,2,0,0.962264150943396
"3934",2023-02-26,"24 - 1150",258,266,258,0,8,1
"3935",2023-02-26,"24 - 1153",348,355,347,1,7,0.997126436781609
"3936",2023-02-27,"62 - 1011",97,98,86,11,1,0.88659793814433
"3937",2023-02-27,"3 - 1008",231,236,228,3,5,0.987012987012987
"3938",2023-02-27,"16 - 1022",53,53,49,4,0,0.924528301886792
"3939",2023-02-27,"24 - 1150",258,266,258,0,8,1
"3940",2023-02-27,"24 - 1153",348,355,348,0,7,1
"3941",2023-02-28,"62 - 1011",97,98,84,13,1,0.865979381443299
"3942",2023-02-28,"3 - 1008",231,236,225,6,5,0.974025974025974
"3943",2023-02-28,"16 - 1022",53,53,49,4,0,0.924528301886792
"3944",2023-02-28,"24 - 1150",256,266,252,4,10,0.984375
"3945",2023-02-28,"24 - 1153",348,355,348,0,7,1
"3946",2023-03-01,"62 - 1011",97,98,85,12,1,0.876288659793814
"3947",2023-03-01,"3 - 1008",228,236,225,3,8,0.986842105263158
"3948",2023-03-01,"16 - 1022",53,53,50,3,0,0.943396226415094
"3949",2023-03-01,"24 - 1150",254,266,252,2,12,0.992125984251969
"3950",2023-03-01,"24 - 1153",347,355,344,3,8,0.99135446685879
"3951",2023-03-02,"62 - 1011",97,98,85,12,1,0.876288659793814
"3952",2023-03-02,"3 - 1008",230,236,226,4,6,0.982608695652174
"3953",2023-03-02,"16 - 1022",53,53,50,3,0,0.943396226415094
"3954",2023-03-02,"24 - 1150",254,266,246,8,12,0.968503937007874
"3955",2023-03-02,"24 - 1153",346,355,346,0,9,1
"3956",2023-03-03,"62 - 1011",97,98,85,12,1,0.876288659793814
"3957",2023-03-03,"3 - 1008",230,236,226,4,6,0.982608695652174
"3958",2023-03-03,"16 - 1022",53,53,50,3,0,0.943396226415094
"3959",2023-03-03,"24 - 1150",254,259,248,6,5,0.976377952755906
"3960",2023-03-03,"24 - 1153",347,355,347,0,8,1
"3961",2023-03-04,"62 - 1011",97,98,86,11,1,0.88659793814433
"3962",2023-03-04,"3 - 1008",230,236,227,3,6,0.98695652173913
"3963",2023-03-04,"16 - 1022",53,53,49,4,0,0.924528301886792
"3964",2023-03-04,"24 - 1150",254,259,251,3,5,0.988188976377953
"3965",2023-03-04,"24 - 1153",347,355,345,2,8,0.994236311239193
"3966",2023-03-05,"62 - 1011",97,98,85,12,1,0.876288659793814
"3967",2023-03-05,"3 - 1008",230,236,228,2,6,0.991304347826087
"3968",2023-03-05,"16 - 1022",53,53,50,3,0,0.943396226415094
"3969",2023-03-05,"24 - 1150",254,259,251,3,5,0.988188976377953
"3970",2023-03-05,"24 - 1153",346,355,346,0,9,1
"3971",2023-03-06,"62 - 1011",97,98,88,9,1,0.907216494845361
"3972",2023-03-06,"3 - 1008",230,236,226,4,6,0.982608695652174
"3973",2023-03-06,"16 - 1022",53,53,50,3,0,0.943396226415094
"3974",2023-03-06,"24 - 1150",253,259,252,1,6,0.99604743083004
"3975",2023-03-06,"24 - 1153",345,355,345,0,10,1
"3976",2023-03-07,"62 - 1011",97,98,88,9,1,0.907216494845361
"3977",2023-03-07,"3 - 1008",231,236,228,3,5,0.987012987012987
"3978",2023-03-07,"16 - 1022",53,53,51,2,0,0.962264150943396
"3979",2023-03-07,"24 - 1150",253,259,251,2,6,0.992094861660079
"3980",2023-03-07,"24 - 1153",345,355,344,1,10,0.997101449275362
"3981",2023-03-08,"62 - 1011",97,98,88,9,1,0.907216494845361
"3982",2023-03-08,"3 - 1008",231,236,224,7,5,0.96969696969697
"3983",2023-03-08,"16 - 1022",53,53,49,4,0,0.924528301886792
"3984",2023-03-08,"24 - 1150",254,259,248,6,5,0.976377952755906
"3985",2023-03-08,"24 - 1153",345,355,344,1,10,0.997101449275362
"3986",2023-03-09,"62 - 1011",97,98,87,10,1,0.896907216494845
"3987",2023-03-09,"3 - 1008",231,236,228,3,5,0.987012987012987
"3988",2023-03-09,"16 - 1022",53,53,48,5,0,0.905660377358491
"3989",2023-03-09,"24 - 1150",254,259,253,1,5,0.996062992125984
"3990",2023-03-09,"24 - 1153",351,355,350,1,4,0.997150997150997
"3991",2023-03-10,"62 - 1011",98,98,89,9,0,0.908163265306122
"3992",2023-03-10,"3 - 1008",231,236,229,2,5,0.991341991341991
"3993",2023-03-10,"16 - 1022",53,53,49,4,0,0.924528301886792
"3994",2023-03-10,"24 - 1150",254,259,252,2,5,0.992125984251969
"3995",2023-03-10,"24 - 1153",351,355,351,0,4,1
"3996",2023-03-11,"62 - 1011",98,98,89,9,0,0.908163265306122
"3997",2023-03-11,"3 - 1008",231,236,229,2,5,0.991341991341991
"3998",2023-03-11,"16 - 1022",53,53,50,3,0,0.943396226415094
"3999",2023-03-11,"24 - 1150",252,259,251,1,7,0.996031746031746
"4000",2023-03-11,"24 - 1153",351,355,351,0,4,1
"4001",2023-03-12,"62 - 1011",98,98,89,9,0,0.908163265306122
"4002",2023-03-12,"3 - 1008",231,236,229,2,5,0.991341991341991
"4003",2023-03-12,"16 - 1022",53,53,50,3,0,0.943396226415094
"4004",2023-03-12,"24 - 1150",250,259,250,0,9,1
"4005",2023-03-12,"24 - 1153",350,355,350,0,5,1
"4006",2023-03-13,"62 - 1011",98,98,87,11,0,0.887755102040816
"4007",2023-03-13,"3 - 1008",231,236,228,3,5,0.987012987012987
"4008",2023-03-13,"16 - 1022",53,53,51,2,0,0.962264150943396
"4009",2023-03-13,"24 - 1150",253,259,250,3,6,0.988142292490119
"4010",2023-03-13,"24 - 1153",350,355,349,1,5,0.997142857142857
"4011",2023-03-14,"62 - 1011",98,98,84,14,0,0.857142857142857
"4012",2023-03-14,"3 - 1008",231,236,228,3,5,0.987012987012987
"4013",2023-03-14,"16 - 1022",53,53,50,3,0,0.943396226415094
"4014",2023-03-14,"24 - 1150",255,259,253,2,4,0.992156862745098
"4015",2023-03-14,"24 - 1153",350,355,348,2,5,0.994285714285714
"4016",2023-03-15,"62 - 1011",98,98,86,12,0,0.877551020408163
"4017",2023-03-15,"3 - 1008",231,236,229,2,5,0.991341991341991
"4018",2023-03-15,"16 - 1022",53,53,51,2,0,0.962264150943396
"4019",2023-03-15,"24 - 1150",254,259,254,0,5,1
"4020",2023-03-15,"24 - 1153",350,355,350,0,5,1
"4021",2023-03-16,"62 - 1011",98,98,86,12,0,0.877551020408163
"4022",2023-03-16,"3 - 1008",232,236,231,1,4,0.995689655172414
"4023",2023-03-16,"16 - 1022",52,53,49,3,1,0.942307692307692
"4024",2023-03-16,"24 - 1150",253,259,253,0,6,1
"4025",2023-03-16,"24 - 1153",350,355,347,3,5,0.991428571428571
"4026",2023-03-17,"62 - 1011",98,98,81,17,0,0.826530612244898
"4027",2023-03-17,"3 - 1008",232,236,232,0,4,1
"4028",2023-03-17,"16 - 1022",53,53,51,2,0,0.962264150943396
"4029",2023-03-17,"24 - 1150",247,259,247,0,12,1
"4030",2023-03-17,"24 - 1153",351,355,351,0,4,1
"4031",2023-03-18,"62 - 1011",98,98,82,16,0,0.836734693877551
"4032",2023-03-18,"3 - 1008",232,236,231,1,4,0.995689655172414
"4033",2023-03-18,"16 - 1022",53,53,51,2,0,0.962264150943396
"4034",2023-03-18,"24 - 1150",247,259,245,2,12,0.991902834008097
"4035",2023-03-18,"24 - 1153",351,355,351,0,4,1
"4036",2023-03-19,"62 - 1011",98,98,82,16,0,0.836734693877551
"4037",2023-03-19,"3 - 1008",232,236,229,3,4,0.987068965517241
"4038",2023-03-19,"16 - 1022",53,53,51,2,0,0.962264150943396
"4039",2023-03-19,"24 - 1150",247,259,247,0,12,1
"4040",2023-03-19,"24 - 1153",351,355,351,0,4,1
"4041",2023-03-20,"62 - 1011",98,98,81,17,0,0.826530612244898
"4042",2023-03-20,"3 - 1008",231,236,230,1,5,0.995670995670996
"4043",2023-03-20,"16 - 1022",53,53,50,3,0,0.943396226415094
"4044",2023-03-20,"24 - 1150",249,259,245,4,10,0.983935742971888
"4045",2023-03-20,"24 - 1153",351,355,351,0,4,1
"4046",2023-03-21,"62 - 1011",98,98,82,16,0,0.836734693877551
"4047",2023-03-21,"3 - 1008",231,236,230,1,5,0.995670995670996
"4048",2023-03-21,"16 - 1022",53,53,51,2,0,0.962264150943396
"4049",2023-03-21,"24 - 1150",247,259,247,0,12,1
"4050",2023-03-21,"24 - 1153",350,355,350,0,5,1
"4051",2023-03-22,"62 - 1011",98,98,84,14,0,0.857142857142857
"4052",2023-03-22,"3 - 1008",231,236,229,2,5,0.991341991341991
"4053",2023-03-22,"16 - 1022",53,53,51,2,0,0.962264150943396
"4054",2023-03-22,"24 - 1150",241,259,241,0,18,1
"4055",2023-03-22,"24 - 1153",350,355,348,2,5,0.994285714285714
"4056",2023-03-23,"62 - 1011",98,98,86,12,0,0.877551020408163
"4057",2023-03-23,"3 - 1008",231,236,230,1,5,0.995670995670996
"4058",2023-03-23,"16 - 1022",53,53,51,2,0,0.962264150943396
"4059",2023-03-23,"24 - 1150",237,259,235,2,22,0.991561181434599
"4060",2023-03-23,"24 - 1153",350,355,349,1,5,0.997142857142857
"4061",2023-03-24,"62 - 1011",98,98,86,12,0,0.877551020408163
"4062",2023-03-24,"3 - 1008",230,236,229,1,6,0.995652173913044
"4063",2023-03-24,"16 - 1022",53,53,51,2,0,0.962264150943396
"4064",2023-03-24,"24 - 1150",233,259,232,1,26,0.995708154506438
"4065",2023-03-24,"24 - 1153",350,355,350,0,5,1
"4066",2023-03-25,"62 - 1011",98,98,86,12,0,0.877551020408163
"4067",2023-03-25,"3 - 1008",230,236,229,1,6,0.995652173913044
"4068",2023-03-25,"16 - 1022",53,53,51,2,0,0.962264150943396
"4069",2023-03-25,"24 - 1150",230,259,230,0,29,1
"4070",2023-03-25,"24 - 1153",350,355,350,0,5,1
"4071",2023-03-26,"62 - 1011",98,98,86,12,0,0.877551020408163
"4072",2023-03-26,"3 - 1008",230,236,229,1,6,0.995652173913044
"4073",2023-03-26,"16 - 1022",53,53,51,2,0,0.962264150943396
"4074",2023-03-26,"24 - 1150",230,259,230,0,29,1
"4075",2023-03-26,"24 - 1153",350,355,350,0,5,1
"4076",2023-03-27,"62 - 1011",98,98,86,12,0,0.877551020408163
"4077",2023-03-27,"3 - 1008",230,236,229,1,6,0.995652173913044
"4078",2023-03-27,"16 - 1022",53,53,51,2,0,0.962264150943396
"4079",2023-03-27,"24 - 1150",228,259,228,0,31,1
"4080",2023-03-27,"24 - 1153",350,355,348,2,5,0.994285714285714
"4081",2023-03-28,"62 - 1011",98,98,87,11,0,0.887755102040816
"4082",2023-03-28,"3 - 1008",230,236,229,1,6,0.995652173913044
"4083",2023-03-28,"16 - 1022",53,53,51,2,0,0.962264150943396
"4084",2023-03-28,"24 - 1150",253,259,248,5,6,0.980237154150198
"4085",2023-03-28,"24 - 1153",349,355,349,0,6,1
"4086",2023-03-29,"62 - 1011",98,98,86,12,0,0.877551020408163
"4087",2023-03-29,"3 - 1008",230,236,228,2,6,0.991304347826087
"4088",2023-03-29,"16 - 1022",53,53,51,2,0,0.962264150943396
"4089",2023-03-29,"24 - 1150",253,259,251,2,6,0.992094861660079
"4090",2023-03-29,"24 - 1153",349,355,347,2,6,0.994269340974212
"4091",2023-03-30,"62 - 1011",98,98,85,13,0,0.86734693877551
"4092",2023-03-30,"3 - 1008",231,236,227,4,5,0.982683982683983
"4093",2023-03-30,"16 - 1022",52,53,50,2,1,0.961538461538462
"4094",2023-03-30,"24 - 1150",253,259,252,1,6,0.99604743083004
"4095",2023-03-30,"24 - 1153",349,355,349,0,6,1
"4096",2023-03-31,"62 - 1011",98,98,85,13,0,0.86734693877551
"4097",2023-03-31,"3 - 1008",231,236,226,5,5,0.978354978354978
"4098",2023-03-31,"16 - 1022",52,53,48,4,1,0.923076923076923
"4099",2023-03-31,"24 - 1150",254,259,251,3,5,0.988188976377953
"4100",2023-03-31,"24 - 1153",349,355,349,0,6,1
"4101",2023-04-01,"62 - 1011",98,98,85,13,0,0.86734693877551
"4102",2023-04-01,"3 - 1008",231,236,225,6,5,0.974025974025974
"4103",2023-04-01,"16 - 1022",52,53,48,4,1,0.923076923076923
"4104",2023-04-01,"24 - 1150",253,259,247,6,6,0.976284584980237
"4105",2023-04-01,"24 - 1153",349,355,349,0,6,1
"4106",2023-04-02,"62 - 1011",98,98,85,13,0,0.86734693877551
"4107",2023-04-02,"3 - 1008",231,236,225,6,5,0.974025974025974
"4108",2023-04-02,"16 - 1022",52,53,48,4,1,0.923076923076923
"4109",2023-04-02,"24 - 1150",253,259,253,0,6,1
"4110",2023-04-02,"24 - 1153",349,355,349,0,6,1
"4111",2023-04-03,"62 - 1011",98,98,86,12,0,0.877551020408163
"4112",2023-04-03,"3 - 1008",231,236,225,6,5,0.974025974025974
"4113",2023-04-03,"16 - 1022",52,53,49,3,1,0.942307692307692
"4114",2023-04-03,"24 - 1150",252,259,250,2,7,0.992063492063492
"4115",2023-04-03,"24 - 1153",349,355,348,1,6,0.997134670487106
"4116",2023-04-04,"62 - 1011",98,98,86,12,0,0.877551020408163
"4117",2023-04-04,"3 - 1008",231,236,227,4,5,0.982683982683983
"4118",2023-04-04,"16 - 1022",52,53,49,3,1,0.942307692307692
"4119",2023-04-04,"24 - 1150",252,259,249,3,7,0.988095238095238
"4120",2023-04-04,"24 - 1153",349,355,347,2,6,0.994269340974212
"4121",2023-04-05,"62 - 1011",98,98,90,8,0,0.918367346938776
"4122",2023-04-05,"3 - 1008",230,236,227,3,6,0.98695652173913
"4123",2023-04-05,"16 - 1022",52,53,49,3,1,0.942307692307692
"4124",2023-04-05,"24 - 1150",251,259,251,0,8,1
"4125",2023-04-05,"24 - 1153",349,355,349,0,6,1
"4126",2023-04-06,"62 - 1011",97,98,92,5,1,0.948453608247423
"4127",2023-04-06,"3 - 1008",230,236,227,3,6,0.98695652173913
"4128",2023-04-06,"16 - 1022",52,53,50,2,1,0.961538461538462
"4129",2023-04-06,"24 - 1150",246,259,246,0,13,1
"4130",2023-04-06,"24 - 1153",350,355,348,2,5,0.994285714285714
"4131",2023-04-07,"62 - 1011",97,98,92,5,1,0.948453608247423
"4132",2023-04-07,"3 - 1008",230,236,227,3,6,0.98695652173913
"4133",2023-04-07,"16 - 1022",52,53,48,4,1,0.923076923076923
"4134",2023-04-07,"24 - 1150",248,259,246,2,11,0.991935483870968
"4135",2023-04-07,"24 - 1153",350,355,350,0,5,1
"4136",2023-04-08,"62 - 1011",96,98,93,3,2,0.96875
"4137",2023-04-08,"3 - 1008",230,236,227,3,6,0.98695652173913
"4138",2023-04-08,"16 - 1022",51,53,48,3,2,0.941176470588235
"4139",2023-04-08,"24 - 1150",248,259,245,3,11,0.987903225806452
"4140",2023-04-08,"24 - 1153",350,355,350,0,5,1
"4141",2023-04-09,"62 - 1011",96,98,93,3,2,0.96875
"4142",2023-04-09,"3 - 1008",230,236,227,3,6,0.98695652173913
"4143",2023-04-09,"16 - 1022",52,53,49,3,1,0.942307692307692
"4144",2023-04-09,"24 - 1150",248,259,246,2,11,0.991935483870968
"4145",2023-04-09,"24 - 1153",350,355,349,1,5,0.997142857142857
"4146",2023-04-10,"62 - 1011",96,98,92,4,2,0.958333333333333
"4147",2023-04-10,"3 - 1008",230,236,227,3,6,0.98695652173913
"4148",2023-04-10,"16 - 1022",52,53,48,4,1,0.923076923076923
"4149",2023-04-10,"24 - 1150",248,259,247,1,11,0.995967741935484
"4150",2023-04-10,"24 - 1153",350,355,350,0,5,1
"4151",2023-04-11,"62 - 1011",96,98,94,2,2,0.979166666666667
"4152",2023-04-11,"3 - 1008",230,236,227,3,6,0.98695652173913
"4153",2023-04-11,"16 - 1022",52,53,49,3,1,0.942307692307692
"4154",2023-04-11,"24 - 1150",250,259,250,0,9,1
"4155",2023-04-11,"24 - 1153",350,355,350,0,5,1
"4156",2023-04-12,"62 - 1011",96,98,95,1,2,0.989583333333333
"4157",2023-04-12,"3 - 1008",230,236,226,4,6,0.982608695652174
"4158",2023-04-12,"16 - 1022",52,53,50,2,1,0.961538461538462
"4159",2023-04-12,"24 - 1150",249,259,247,2,10,0.991967871485944
"4160",2023-04-12,"24 - 1153",350,355,350,0,5,1
"4161",2023-04-13,"62 - 1011",96,98,95,1,2,0.989583333333333
"4162",2023-04-13,"3 - 1008",230,236,225,5,6,0.978260869565217
"4163",2023-04-13,"16 - 1022",52,53,48,4,1,0.923076923076923
"4164",2023-04-13,"24 - 1150",245,259,241,4,14,0.983673469387755
"4165",2023-04-13,"24 - 1153",350,355,350,0,5,1
"4166",2023-04-14,"62 - 1011",96,98,95,1,2,0.989583333333333
"4167",2023-04-14,"3 - 1008",230,236,225,5,6,0.978260869565217
"4168",2023-04-14,"16 - 1022",53,53,53,0,0,1
"4169",2023-04-14,"24 - 1150",245,259,241,4,14,0.983673469387755
"4170",2023-04-14,"24 - 1153",350,355,350,0,5,1
"4171",2023-04-15,"62 - 1011",96,98,95,1,2,0.989583333333333
"4172",2023-04-15,"3 - 1008",230,236,226,4,6,0.982608695652174
"4173",2023-04-15,"16 - 1022",53,53,53,0,0,1
"4174",2023-04-15,"24 - 1150",243,259,243,0,16,1
"4175",2023-04-15,"24 - 1153",350,355,348,2,5,0.994285714285714
"4176",2023-04-16,"62 - 1011",96,98,95,1,2,0.989583333333333
"4177",2023-04-16,"3 - 1008",230,236,226,4,6,0.982608695652174
"4178",2023-04-16,"16 - 1022",53,53,53,0,0,1
"4179",2023-04-16,"24 - 1150",246,259,246,0,13,1
"4180",2023-04-16,"24 - 1153",350,355,350,0,5,1
"4181",2023-04-17,"62 - 1011",96,98,95,1,2,0.989583333333333
"4182",2023-04-17,"3 - 1008",230,236,223,7,6,0.969565217391304
"4183",2023-04-17,"16 - 1022",53,53,51,2,0,0.962264150943396
"4184",2023-04-17,"24 - 1150",253,259,251,2,6,0.992094861660079
"4185",2023-04-17,"24 - 1153",350,355,350,0,5,1
"4186",2023-04-18,"62 - 1011",96,98,95,1,2,0.989583333333333
"4187",2023-04-18,"3 - 1008",229,236,225,4,7,0.982532751091703
"4188",2023-04-18,"16 - 1022",53,53,52,1,0,0.981132075471698
"4189",2023-04-18,"24 - 1150",253,259,250,3,6,0.988142292490119
"4190",2023-04-18,"24 - 1153",351,355,350,1,4,0.997150997150997
"4191",2023-04-19,"62 - 1011",96,98,96,0,2,1
"4192",2023-04-19,"3 - 1008",228,236,223,5,8,0.978070175438597
"4193",2023-04-19,"16 - 1022",53,53,52,1,0,0.981132075471698
"4194",2023-04-19,"24 - 1150",253,259,250,3,6,0.988142292490119
"4195",2023-04-19,"24 - 1153",351,355,349,2,4,0.994301994301994
"4196",2023-04-20,"62 - 1011",96,98,95,1,2,0.989583333333333
"4197",2023-04-20,"3 - 1008",228,236,223,5,8,0.978070175438597
"4198",2023-04-20,"16 - 1022",53,53,52,1,0,0.981132075471698
"4199",2023-04-20,"24 - 1150",253,259,253,0,6,1
"4200",2023-04-20,"24 - 1153",350,355,350,0,5,1
"4201",2023-04-21,"62 - 1011",96,98,95,1,2,0.989583333333333
"4202",2023-04-21,"3 - 1008",228,236,223,5,8,0.978070175438597
"4203",2023-04-21,"16 - 1022",53,53,53,0,0,1
"4204",2023-04-21,"24 - 1150",253,259,251,2,6,0.992094861660079
"4205",2023-04-21,"24 - 1153",351,355,351,0,4,1
"4206",2023-04-22,"62 - 1011",96,98,91,5,2,0.947916666666667
"4207",2023-04-22,"3 - 1008",228,236,223,5,8,0.978070175438597
"4208",2023-04-22,"16 - 1022",53,53,52,1,0,0.981132075471698
"4209",2023-04-22,"24 - 1150",251,259,251,0,8,1
"4210",2023-04-22,"24 - 1153",351,355,350,1,4,0.997150997150997
"4211",2023-04-23,"62 - 1011",96,98,91,5,2,0.947916666666667
"4212",2023-04-23,"3 - 1008",228,236,223,5,8,0.978070175438597
"4213",2023-04-23,"16 - 1022",53,53,52,1,0,0.981132075471698
"4214",2023-04-23,"24 - 1150",251,259,251,0,8,1
"4215",2023-04-23,"24 - 1153",351,355,349,2,4,0.994301994301994
"4216",2023-04-24,"62 - 1011",96,98,93,3,2,0.96875
"4217",2023-04-24,"3 - 1008",228,236,221,7,8,0.969298245614035
"4218",2023-04-24,"16 - 1022",53,53,52,1,0,0.981132075471698
"4219",2023-04-24,"24 - 1150",253,259,248,5,6,0.980237154150198
"4220",2023-04-24,"24 - 1153",351,355,350,1,4,0.997150997150997
"4221",2023-04-25,"62 - 1011",96,98,91,5,2,0.947916666666667
"4222",2023-04-25,"3 - 1008",229,236,225,4,7,0.982532751091703
"4223",2023-04-25,"16 - 1022",53,53,53,0,0,1
"4224",2023-04-25,"24 - 1150",253,259,252,1,6,0.99604743083004
"4225",2023-04-25,"24 - 1153",351,355,351,0,4,1
"4226",2023-04-26,"62 - 1011",96,98,91,5,2,0.947916666666667
"4227",2023-04-26,"3 - 1008",229,236,224,5,7,0.978165938864629
"4228",2023-04-26,"16 - 1022",53,53,53,0,0,1
"4229",2023-04-26,"24 - 1150",252,259,249,3,7,0.988095238095238
"4230",2023-04-26,"24 - 1153",351,355,351,0,4,1
"4231",2023-04-27,"62 - 1011",96,98,91,5,2,0.947916666666667
"4232",2023-04-27,"3 - 1008",230,236,225,5,6,0.978260869565217
"4233",2023-04-27,"16 - 1022",53,53,53,0,0,1
"4234",2023-04-27,"24 - 1150",255,259,246,9,4,0.964705882352941
"4235",2023-04-27,"24 - 1153",351,355,351,0,4,1
"4236",2023-04-28,"62 - 1011",96,98,93,3,2,0.96875
"4237",2023-04-28,"3 - 1008",230,236,227,3,6,0.98695652173913
"4238",2023-04-28,"16 - 1022",53,53,53,0,0,1
"4239",2023-04-28,"24 - 1150",254,259,250,4,5,0.984251968503937
"4240",2023-04-28,"24 - 1153",351,355,349,2,4,0.994301994301994
"4241",2023-04-29,"62 - 1011",96,98,94,2,2,0.979166666666667
"4242",2023-04-29,"3 - 1008",230,236,227,3,6,0.98695652173913
"4243",2023-04-29,"16 - 1022",53,53,53,0,0,1
"4244",2023-04-29,"24 - 1150",252,259,248,4,7,0.984126984126984
"4245",2023-04-29,"24 - 1153",351,355,351,0,4,1
"4246",2023-04-30,"62 - 1011",96,98,93,3,2,0.96875
"4247",2023-04-30,"3 - 1008",230,236,226,4,6,0.982608695652174
"4248",2023-04-30,"16 - 1022",53,53,53,0,0,1
"4249",2023-04-30,"24 - 1150",252,259,252,0,7,1
"4250",2023-04-30,"24 - 1153",351,355,350,1,4,0.997150997150997
"4251",2023-05-01,"62 - 1011",96,98,94,2,2,0.979166666666667
"4252",2023-05-01,"3 - 1008",230,236,224,6,6,0.973913043478261
"4253",2023-05-01,"16 - 1022",53,53,50,3,0,0.943396226415094
"4254",2023-05-01,"24 - 1150",255,259,253,2,4,0.992156862745098
"4255",2023-05-01,"24 - 1153",351,355,351,0,4,1
"4256",2023-05-02,"62 - 1011",96,98,94,2,2,0.979166666666667
"4257",2023-05-02,"3 - 1008",231,236,225,6,5,0.974025974025974
"4258",2023-05-02,"16 - 1022",53,53,51,2,0,0.962264150943396
"4259",2023-05-02,"24 - 1150",257,259,255,2,2,0.992217898832685
"4260",2023-05-02,"24 - 1153",349,355,348,1,6,0.997134670487106
"4261",2023-05-03,"62 - 1011",96,98,94,2,2,0.979166666666667
"4262",2023-05-03,"3 - 1008",231,236,225,6,5,0.974025974025974
"4263",2023-05-03,"16 - 1022",53,53,48,5,0,0.905660377358491
"4264",2023-05-03,"24 - 1150",256,259,256,0,3,1
"4265",2023-05-03,"24 - 1153",348,355,345,3,7,0.991379310344828
"4266",2023-05-04,"62 - 1011",96,98,93,3,2,0.96875
"4267",2023-05-04,"3 - 1008",231,236,226,5,5,0.978354978354978
"4268",2023-05-04,"16 - 1022",53,53,48,5,0,0.905660377358491
"4269",2023-05-04,"24 - 1150",256,259,254,2,3,0.9921875
"4270",2023-05-04,"24 - 1153",347,355,346,1,8,0.997118155619596
"4271",2023-05-05,"62 - 1011",96,98,94,2,2,0.979166666666667
"4272",2023-05-05,"3 - 1008",231,236,226,5,5,0.978354978354978
"4273",2023-05-05,"16 - 1022",53,53,49,4,0,0.924528301886792
"4274",2023-05-05,"24 - 1150",254,259,251,3,5,0.988188976377953
"4275",2023-05-05,"24 - 1153",346,355,346,0,9,1
"4276",2023-05-06,"62 - 1011",96,98,94,2,2,0.979166666666667
"4277",2023-05-06,"3 - 1008",231,236,226,5,5,0.978354978354978
"4278",2023-05-06,"16 - 1022",53,53,50,3,0,0.943396226415094
"4279",2023-05-06,"24 - 1150",254,259,253,1,5,0.996062992125984
"4280",2023-05-06,"24 - 1153",341,355,341,0,14,1
"4281",2023-05-07,"62 - 1011",96,98,92,4,2,0.958333333333333
"4282",2023-05-07,"3 - 1008",231,236,225,6,5,0.974025974025974
"4283",2023-05-07,"16 - 1022",53,53,48,5,0,0.905660377358491
"4284",2023-05-07,"24 - 1150",255,259,254,1,4,0.996078431372549
"4285",2023-05-07,"24 - 1153",347,355,347,0,8,1
"4286",2023-05-08,"62 - 1011",96,98,94,2,2,0.979166666666667
"4287",2023-05-08,"3 - 1008",231,236,221,10,5,0.956709956709957
"4288",2023-05-08,"16 - 1022",53,53,50,3,0,0.943396226415094
"4289",2023-05-08,"24 - 1150",256,259,256,0,3,1
"4290",2023-05-08,"24 - 1153",351,355,351,0,4,1
"4291",2023-05-09,"62 - 1011",96,98,94,2,2,0.979166666666667
"4292",2023-05-09,"3 - 1008",231,236,223,8,5,0.965367965367965
"4293",2023-05-09,"16 - 1022",53,53,51,2,0,0.962264150943396
"4294",2023-05-09,"24 - 1150",254,259,254,0,5,1
"4295",2023-05-09,"24 - 1153",352,355,352,0,3,1
"4296",2023-05-10,"62 - 1011",96,98,94,2,2,0.979166666666667
"4297",2023-05-10,"3 - 1008",231,236,224,7,5,0.96969696969697
"4298",2023-05-10,"16 - 1022",53,53,51,2,0,0.962264150943396
"4299",2023-05-10,"24 - 1150",253,259,253,0,6,1
"4300",2023-05-10,"24 - 1153",350,355,349,1,5,0.997142857142857
"4301",2023-05-11,"62 - 1011",96,98,92,4,2,0.958333333333333
"4302",2023-05-11,"3 - 1008",231,236,224,7,5,0.96969696969697
"4303",2023-05-11,"16 - 1022",53,53,51,2,0,0.962264150943396
"4304",2023-05-11,"24 - 1150",247,259,247,0,12,1
"4305",2023-05-11,"24 - 1153",348,355,348,0,7,1
"4306",2023-05-12,"62 - 1011",96,98,92,4,2,0.958333333333333
"4307",2023-05-12,"3 - 1008",231,236,223,8,5,0.965367965367965
"4308",2023-05-12,"16 - 1022",53,53,52,1,0,0.981132075471698
"4309",2023-05-12,"24 - 1150",240,259,240,0,19,1
"4310",2023-05-12,"24 - 1153",343,355,343,0,12,1
"4311",2023-05-13,"62 - 1011",96,98,93,3,2,0.96875
"4312",2023-05-13,"3 - 1008",231,236,223,8,5,0.965367965367965
"4313",2023-05-13,"16 - 1022",53,53,52,1,0,0.981132075471698
"4314",2023-05-13,"24 - 1150",239,259,239,0,20,1
"4315",2023-05-13,"24 - 1153",344,355,344,0,11,1
"4316",2023-05-14,"62 - 1011",96,98,94,2,2,0.979166666666667
"4317",2023-05-14,"3 - 1008",231,236,223,8,5,0.965367965367965
"4318",2023-05-14,"16 - 1022",53,53,52,1,0,0.981132075471698
"4319",2023-05-14,"24 - 1150",235,259,235,0,24,1
"4320",2023-05-14,"24 - 1153",347,355,347,0,8,1
"4321",2023-05-15,"62 - 1011",96,98,94,2,2,0.979166666666667
"4322",2023-05-15,"3 - 1008",231,236,224,7,5,0.96969696969697
"4323",2023-05-15,"16 - 1022",53,53,52,1,0,0.981132075471698
"4324",2023-05-15,"24 - 1150",232,259,232,0,27,1
"4325",2023-05-15,"24 - 1153",348,355,348,0,7,1
"4326",2023-05-16,"62 - 1011",96,98,93,3,2,0.96875
"4327",2023-05-16,"3 - 1008",231,236,224,7,5,0.96969696969697
"4328",2023-05-16,"16 - 1022",53,53,52,1,0,0.981132075471698
"4329",2023-05-16,"24 - 1150",230,259,230,0,29,1
"4330",2023-05-16,"24 - 1153",353,355,353,0,2,1
"4331",2023-05-17,"62 - 1011",96,98,93,3,2,0.96875
"4332",2023-05-17,"3 - 1008",231,236,225,6,5,0.974025974025974
"4333",2023-05-17,"16 - 1022",53,53,52,1,0,0.981132075471698
"4334",2023-05-17,"24 - 1150",231,259,230,1,28,0.995670995670996
"4335",2023-05-17,"24 - 1153",351,355,351,0,4,1
"4336",2023-05-18,"62 - 1011",96,98,96,0,2,1
"4337",2023-05-18,"3 - 1008",231,236,226,5,5,0.978354978354978
"4338",2023-05-18,"16 - 1022",53,53,52,1,0,0.981132075471698
"4339",2023-05-18,"24 - 1150",235,259,235,0,24,1
"4340",2023-05-18,"24 - 1153",352,355,352,0,3,1
"4341",2023-05-19,"62 - 1011",96,98,96,0,2,1
"4342",2023-05-19,"3 - 1008",231,236,227,4,5,0.982683982683983
"4343",2023-05-19,"16 - 1022",53,53,52,1,0,0.981132075471698
"4344",2023-05-19,"24 - 1150",241,259,239,2,18,0.991701244813278
"4345",2023-05-19,"24 - 1153",350,355,350,0,5,1
"4346",2023-05-20,"62 - 1011",96,98,96,0,2,1
"4347",2023-05-20,"3 - 1008",231,236,227,4,5,0.982683982683983
"4348",2023-05-20,"16 - 1022",53,53,52,1,0,0.981132075471698
"4349",2023-05-20,"24 - 1150",239,259,239,0,20,1
"4350",2023-05-20,"24 - 1153",352,355,352,0,3,1
"4351",2023-05-21,"62 - 1011",96,98,96,0,2,1
"4352",2023-05-21,"3 - 1008",231,236,227,4,5,0.982683982683983
"4353",2023-05-21,"16 - 1022",53,53,51,2,0,0.962264150943396
"4354",2023-05-21,"24 - 1150",237,259,237,0,22,1
"4355",2023-05-21,"24 - 1153",352,355,352,0,3,1
"4356",2023-05-22,"62 - 1011",96,98,96,0,2,1
"4357",2023-05-22,"3 - 1008",231,236,227,4,5,0.982683982683983
"4358",2023-05-22,"16 - 1022",53,53,51,2,0,0.962264150943396
"4359",2023-05-22,"24 - 1150",236,259,236,0,23,1
"4360",2023-05-22,"24 - 1153",351,355,350,1,4,0.997150997150997
"4361",2023-05-23,"62 - 1011",96,98,96,0,2,1
"4362",2023-05-23,"3 - 1008",231,236,225,6,5,0.974025974025974
"4363",2023-05-23,"16 - 1022",52,53,52,0,1,1
"4364",2023-05-23,"24 - 1150",236,259,233,3,23,0.98728813559322
"4365",2023-05-23,"24 - 1153",353,355,352,1,2,0.997167138810198
"4366",2023-05-24,"62 - 1011",96,98,96,0,2,1
"4367",2023-05-24,"3 - 1008",231,236,227,4,5,0.982683982683983
"4368",2023-05-24,"16 - 1022",52,53,52,0,1,1
"4369",2023-05-24,"24 - 1150",229,259,229,0,30,1
"4370",2023-05-24,"24 - 1153",347,355,347,0,8,1
"4371",2023-05-25,"62 - 1011",96,98,96,0,2,1
"4372",2023-05-25,"3 - 1008",231,236,227,4,5,0.982683982683983
"4373",2023-05-25,"16 - 1022",53,53,53,0,0,1
"4374",2023-05-25,"24 - 1150",236,259,235,1,23,0.995762711864407
"4375",2023-05-25,"24 - 1153",339,355,339,0,16,1
"4376",2023-05-26,"62 - 1011",96,98,95,1,2,0.989583333333333
"4377",2023-05-26,"3 - 1008",230,236,225,5,6,0.978260869565217
"4378",2023-05-26,"16 - 1022",53,53,52,1,0,0.981132075471698
"4379",2023-05-26,"24 - 1150",236,259,236,0,23,1
"4380",2023-05-26,"24 - 1153",337,355,336,1,18,0.997032640949555
"4381",2023-05-27,"62 - 1011",96,98,96,0,2,1
"4382",2023-05-27,"3 - 1008",230,236,227,3,6,0.98695652173913
"4383",2023-05-27,"16 - 1022",53,53,52,1,0,0.981132075471698
"4384",2023-05-27,"24 - 1150",236,259,236,0,23,1
"4385",2023-05-27,"24 - 1153",337,355,337,0,18,1
"4386",2023-05-28,"62 - 1011",96,98,96,0,2,1
"4387",2023-05-28,"3 - 1008",230,236,227,3,6,0.98695652173913
"4388",2023-05-28,"16 - 1022",53,53,52,1,0,0.981132075471698
"4389",2023-05-28,"24 - 1150",236,259,236,0,23,1
"4390",2023-05-28,"24 - 1153",337,355,337,0,18,1
"4391",2023-05-29,"62 - 1011",96,98,95,1,2,0.989583333333333
"4392",2023-05-29,"3 - 1008",230,236,227,3,6,0.98695652173913
"4393",2023-05-29,"16 - 1022",53,53,53,0,0,1
"4394",2023-05-29,"24 - 1150",234,259,234,0,25,1
"4395",2023-05-29,"24 - 1153",332,355,332,0,23,1
"4396",2023-05-30,"62 - 1011",96,98,96,0,2,1
"4397",2023-05-30,"3 - 1008",230,236,224,6,6,0.973913043478261
"4398",2023-05-30,"16 - 1022",53,53,52,1,0,0.981132075471698
"4399",2023-05-30,"24 - 1150",242,259,240,2,17,0.991735537190083
"4400",2023-05-30,"24 - 1153",329,355,329,0,26,1
"4401",2023-05-31,"62 - 1011",96,98,95,1,2,0.989583333333333
"4402",2023-05-31,"3 - 1008",230,236,225,5,6,0.978260869565217
"4403",2023-05-31,"16 - 1022",53,53,52,1,0,0.981132075471698
"4404",2023-05-31,"24 - 1150",244,259,244,0,15,1
"4405",2023-05-31,"24 - 1153",327,355,327,0,28,1
"4406",2023-06-01,"62 - 1011",96,98,94,2,2,0.979166666666667
"4407",2023-06-01,"3 - 1008",230,236,225,5,6,0.978260869565217
"4408",2023-06-01,"16 - 1022",53,53,50,3,0,0.943396226415094
"4409",2023-06-01,"24 - 1150",243,259,241,2,16,0.991769547325103
"4410",2023-06-01,"24 - 1153",347,355,347,0,8,1
"4411",2023-06-02,"62 - 1011",96,98,96,0,2,1
"4412",2023-06-02,"3 - 1008",230,236,224,6,6,0.973913043478261
"4413",2023-06-02,"16 - 1022",53,53,49,4,0,0.924528301886792
"4414",2023-06-02,"24 - 1150",247,259,242,5,12,0.979757085020243
"4415",2023-06-02,"24 - 1153",351,355,351,0,4,1
"4416",2023-06-03,"62 - 1011",96,98,96,0,2,1
"4417",2023-06-03,"3 - 1008",230,236,225,5,6,0.978260869565217
"4418",2023-06-03,"16 - 1022",53,53,49,4,0,0.924528301886792
"4419",2023-06-03,"24 - 1150",244,259,244,0,15,1
"4420",2023-06-03,"24 - 1153",348,355,348,0,7,1
"4421",2023-06-04,"62 - 1011",96,98,96,0,2,1
"4422",2023-06-04,"3 - 1008",230,236,225,5,6,0.978260869565217
"4423",2023-06-04,"16 - 1022",53,53,48,5,0,0.905660377358491
"4424",2023-06-04,"24 - 1150",244,259,244,0,15,1
"4425",2023-06-04,"24 - 1153",348,355,348,0,7,1
"4426",2023-06-05,"62 - 1011",96,98,94,2,2,0.979166666666667
"4427",2023-06-05,"3 - 1008",230,236,225,5,6,0.978260869565217
"4428",2023-06-05,"16 - 1022",53,53,50,3,0,0.943396226415094
"4429",2023-06-05,"24 - 1150",244,259,238,6,15,0.975409836065574
"4430",2023-06-05,"24 - 1153",353,355,351,2,2,0.994334277620397
"4431",2023-06-06,"62 - 1011",96,98,95,1,2,0.989583333333333
"4432",2023-06-06,"3 - 1008",230,236,226,4,6,0.982608695652174
"4433",2023-06-06,"16 - 1022",52,53,50,2,1,0.961538461538462
"4434",2023-06-06,"24 - 1150",252,259,235,17,7,0.932539682539683
"4435",2023-06-06,"24 - 1153",353,355,352,1,2,0.997167138810198
"4436",2023-06-07,"62 - 1011",96,98,94,2,2,0.979166666666667
"4437",2023-06-07,"3 - 1008",230,236,226,4,6,0.982608695652174
"4438",2023-06-07,"16 - 1022",52,53,49,3,1,0.942307692307692
"4439",2023-06-07,"24 - 1150",254,259,244,10,5,0.960629921259842
"4440",2023-06-07,"24 - 1153",353,355,353,0,2,1
"4441",2023-06-08,"62 - 1011",96,98,94,2,2,0.979166666666667
"4442",2023-06-08,"3 - 1008",230,236,226,4,6,0.982608695652174
"4443",2023-06-08,"16 - 1022",52,53,50,2,1,0.961538461538462
"4444",2023-06-08,"24 - 1150",255,259,247,8,4,0.968627450980392
"4445",2023-06-08,"24 - 1153",353,355,353,0,2,1
"4446",2023-06-09,"62 - 1011",96,98,94,2,2,0.979166666666667
"4447",2023-06-09,"3 - 1008",230,236,226,4,6,0.982608695652174
"4448",2023-06-09,"16 - 1022",52,53,52,0,1,1
"4449",2023-06-09,"24 - 1150",254,259,251,3,5,0.988188976377953
"4450",2023-06-09,"24 - 1153",353,355,353,0,2,1
"4451",2023-06-10,"62 - 1011",96,98,93,3,2,0.96875
"4452",2023-06-10,"3 - 1008",230,236,226,4,6,0.982608695652174
"4453",2023-06-10,"16 - 1022",52,53,52,0,1,1
"4454",2023-06-10,"24 - 1150",254,259,254,0,5,1
"4455",2023-06-10,"24 - 1153",353,355,353,0,2,1
"4456",2023-06-11,"62 - 1011",96,98,93,3,2,0.96875
"4457",2023-06-11,"3 - 1008",230,236,226,4,6,0.982608695652174
"4458",2023-06-11,"16 - 1022",52,53,51,1,1,0.980769230769231
"4459",2023-06-11,"24 - 1150",254,259,254,0,5,1
"4460",2023-06-11,"24 - 1153",353,355,353,0,2,1
"4461",2023-06-12,"62 - 1011",96,98,91,5,2,0.947916666666667
"4462",2023-06-12,"3 - 1008",230,236,226,4,6,0.982608695652174
"4463",2023-06-12,"16 - 1022",52,53,50,2,1,0.961538461538462
"4464",2023-06-12,"24 - 1150",254,259,250,4,5,0.984251968503937
"4465",2023-06-12,"24 - 1153",353,355,353,0,2,1
"4466",2023-06-13,"62 - 1011",96,98,91,5,2,0.947916666666667
"4467",2023-06-13,"3 - 1008",230,236,227,3,6,0.98695652173913
"4468",2023-06-13,"16 - 1022",53,53,51,2,0,0.962264150943396
"4469",2023-06-13,"24 - 1150",254,259,252,2,5,0.992125984251969
"4470",2023-06-13,"24 - 1153",353,355,353,0,2,1
"4471",2023-06-14,"62 - 1011",96,98,91,5,2,0.947916666666667
"4472",2023-06-14,"3 - 1008",231,236,228,3,5,0.987012987012987
"4473",2023-06-14,"16 - 1022",53,53,52,1,0,0.981132075471698
"4474",2023-06-14,"24 - 1150",254,259,253,1,5,0.996062992125984
"4475",2023-06-14,"24 - 1153",351,355,351,0,4,1
"4476",2023-06-15,"62 - 1011",96,98,91,5,2,0.947916666666667
"4477",2023-06-15,"3 - 1008",231,236,227,4,5,0.982683982683983
"4478",2023-06-15,"16 - 1022",53,53,52,1,0,0.981132075471698
"4479",2023-06-15,"24 - 1150",253,259,253,0,6,1
"4480",2023-06-15,"24 - 1153",352,355,352,0,3,1
"4481",2023-06-16,"62 - 1011",96,98,91,5,2,0.947916666666667
"4482",2023-06-16,"3 - 1008",231,236,228,3,5,0.987012987012987
"4483",2023-06-16,"16 - 1022",53,53,52,1,0,0.981132075471698
"4484",2023-06-16,"24 - 1150",252,259,252,0,7,1
"4485",2023-06-16,"24 - 1153",352,355,352,0,3,1
"4486",2023-06-17,"62 - 1011",96,98,91,5,2,0.947916666666667
"4487",2023-06-17,"3 - 1008",231,236,229,2,5,0.991341991341991
"4488",2023-06-17,"16 - 1022",53,53,50,3,0,0.943396226415094
"4489",2023-06-17,"24 - 1150",251,259,251,0,8,1
"4490",2023-06-17,"24 - 1153",352,355,352,0,3,1
"4491",2023-06-18,"62 - 1011",96,98,91,5,2,0.947916666666667
"4492",2023-06-18,"3 - 1008",231,236,229,2,5,0.991341991341991
"4493",2023-06-18,"16 - 1022",53,53,50,3,0,0.943396226415094
"4494",2023-06-18,"24 - 1150",253,259,253,0,6,1
"4495",2023-06-18,"24 - 1153",352,355,352,0,3,1
"4496",2023-06-19,"62 - 1011",96,98,90,6,2,0.9375
"4497",2023-06-19,"3 - 1008",231,236,229,2,5,0.991341991341991
"4498",2023-06-19,"16 - 1022",53,53,50,3,0,0.943396226415094
"4499",2023-06-19,"24 - 1150",255,259,255,0,4,1
"4500",2023-06-19,"24 - 1153",352,355,352,0,3,1
"4501",2023-06-20,"62 - 1011",96,98,91,5,2,0.947916666666667
"4502",2023-06-20,"3 - 1008",231,236,229,2,5,0.991341991341991
"4503",2023-06-20,"16 - 1022",53,53,50,3,0,0.943396226415094
"4504",2023-06-20,"24 - 1150",252,259,250,2,7,0.992063492063492
"4505",2023-06-20,"24 - 1153",352,355,352,0,3,1
"4506",2023-06-21,"62 - 1011",96,98,90,6,2,0.9375
"4507",2023-06-21,"3 - 1008",231,236,230,1,5,0.995670995670996
"4508",2023-06-21,"16 - 1022",53,53,51,2,0,0.962264150943396
"4509",2023-06-21,"24 - 1150",255,259,253,2,4,0.992156862745098
"4510",2023-06-21,"24 - 1153",353,355,353,0,2,1
"4511",2023-06-22,"62 - 1011",88,98,88,0,10,1
"4512",2023-06-22,"3 - 1008",230,236,228,2,6,0.991304347826087
"4513",2023-06-22,"16 - 1022",53,53,52,1,0,0.981132075471698
"4514",2023-06-22,"24 - 1150",252,259,251,1,7,0.996031746031746
"4515",2023-06-22,"24 - 1153",353,355,353,0,2,1
"4516",2023-06-23,"62 - 1011",88,98,88,0,10,1
"4517",2023-06-23,"3 - 1008",230,236,227,3,6,0.98695652173913
"4518",2023-06-23,"16 - 1022",53,53,53,0,0,1
"4519",2023-06-23,"24 - 1150",252,259,252,0,7,1
"4520",2023-06-23,"24 - 1153",353,355,353,0,2,1
"4521",2023-06-24,"62 - 1011",88,98,88,0,10,1
"4522",2023-06-24,"3 - 1008",230,236,227,3,6,0.98695652173913
"4523",2023-06-24,"16 - 1022",53,53,53,0,0,1
"4524",2023-06-24,"24 - 1150",252,259,252,0,7,1
"4525",2023-06-24,"24 - 1153",353,355,353,0,2,1
"4526",2023-06-25,"62 - 1011",88,98,88,0,10,1
"4527",2023-06-25,"3 - 1008",230,236,227,3,6,0.98695652173913
"4528",2023-06-25,"16 - 1022",53,53,53,0,0,1
"4529",2023-06-25,"24 - 1150",253,259,251,2,6,0.992094861660079
"4530",2023-06-25,"24 - 1153",353,355,353,0,2,1
"4531",2023-06-26,"62 - 1011",88,98,88,0,10,1
"4532",2023-06-26,"3 - 1008",230,236,228,2,6,0.991304347826087
"4533",2023-06-26,"16 - 1022",53,53,52,1,0,0.981132075471698
"4534",2023-06-26,"24 - 1150",256,259,249,7,3,0.97265625
"4535",2023-06-26,"24 - 1153",353,355,353,0,2,1
"4536",2023-06-27,"62 - 1011",88,98,88,0,10,1
"4537",2023-06-27,"3 - 1008",230,236,227,3,6,0.98695652173913
"4538",2023-06-27,"16 - 1022",53,53,52,1,0,0.981132075471698
"4539",2023-06-27,"24 - 1150",255,259,253,2,4,0.992156862745098
"4540",2023-06-27,"24 - 1153",352,355,352,0,3,1
"4541",2023-06-28,"62 - 1011",88,98,88,0,10,1
"4542",2023-06-28,"3 - 1008",230,236,227,3,6,0.98695652173913
"4543",2023-06-28,"16 - 1022",53,53,52,1,0,0.981132075471698
"4544",2023-06-28,"24 - 1150",255,259,253,2,4,0.992156862745098
"4545",2023-06-28,"24 - 1153",353,355,353,0,2,1
"4546",2023-06-29,"62 - 1011",88,98,88,0,10,1
"4547",2023-06-29,"3 - 1008",230,236,227,3,6,0.98695652173913
"4548",2023-06-29,"16 - 1022",53,53,52,1,0,0.981132075471698
"4549",2023-06-29,"24 - 1150",256,259,256,0,3,1
"4550",2023-06-29,"24 - 1153",353,355,352,1,2,0.997167138810198
"4551",2023-06-30,"62 - 1011",88,98,87,1,10,0.988636363636364
"4552",2023-06-30,"3 - 1008",230,236,226,4,6,0.982608695652174
"4553",2023-06-30,"16 - 1022",52,53,50,2,1,0.961538461538462
"4554",2023-06-30,"24 - 1150",256,259,254,2,3,0.9921875
"4555",2023-06-30,"24 - 1153",353,355,353,0,2,1
"4556",2023-07-01,"62 - 1011",88,98,87,1,10,0.988636363636364
"4557",2023-07-01,"3 - 1008",231,236,227,4,5,0.982683982683983
"4558",2023-07-01,"16 - 1022",52,53,50,2,1,0.961538461538462
"4559",2023-07-01,"24 - 1150",255,259,255,0,4,1
"4560",2023-07-01,"24 - 1153",353,355,353,0,2,1
"4561",2023-07-02,"62 - 1011",88,98,87,1,10,0.988636363636364
"4562",2023-07-02,"3 - 1008",231,236,227,4,5,0.982683982683983
"4563",2023-07-02,"16 - 1022",53,53,51,2,0,0.962264150943396
"4564",2023-07-02,"24 - 1150",255,259,255,0,4,1
"4565",2023-07-02,"24 - 1153",353,355,352,1,2,0.997167138810198
"4566",2023-07-03,"62 - 1011",88,98,86,2,10,0.977272727272727
"4567",2023-07-03,"3 - 1008",231,236,226,5,5,0.978354978354978
"4568",2023-07-03,"16 - 1022",53,53,51,2,0,0.962264150943396
"4569",2023-07-03,"24 - 1150",255,259,253,2,4,0.992156862745098
"4570",2023-07-03,"24 - 1153",353,355,353,0,2,1
"4571",2023-07-04,"62 - 1011",88,98,86,2,10,0.977272727272727
"4572",2023-07-04,"3 - 1008",231,236,226,5,5,0.978354978354978
"4573",2023-07-04,"16 - 1022",53,53,51,2,0,0.962264150943396
"4574",2023-07-04,"24 - 1150",255,259,253,2,4,0.992156862745098
"4575",2023-07-04,"24 - 1153",353,355,353,0,2,1
"4576",2023-07-05,"62 - 1011",88,98,85,3,10,0.965909090909091
"4577",2023-07-05,"3 - 1008",231,236,226,5,5,0.978354978354978
"4578",2023-07-05,"16 - 1022",53,53,51,2,0,0.962264150943396
"4579",2023-07-05,"24 - 1150",255,259,252,3,4,0.988235294117647
"4580",2023-07-05,"24 - 1153",353,355,353,0,2,1
"4581",2023-07-06,"62 - 1011",88,98,85,3,10,0.965909090909091
"4582",2023-07-06,"3 - 1008",232,236,228,4,4,0.982758620689655
"4583",2023-07-06,"16 - 1022",53,53,51,2,0,0.962264150943396
"4584",2023-07-06,"24 - 1150",255,259,253,2,4,0.992156862745098
"4585",2023-07-06,"24 - 1153",353,355,353,0,2,1
"4586",2023-07-07,"62 - 1011",88,98,85,3,10,0.965909090909091
"4587",2023-07-07,"3 - 1008",231,236,227,4,5,0.982683982683983
"4588",2023-07-07,"16 - 1022",53,53,51,2,0,0.962264150943396
"4589",2023-07-07,"24 - 1150",256,259,252,4,3,0.984375
"4590",2023-07-07,"24 - 1153",351,355,351,0,4,1
"4591",2023-07-08,"62 - 1011",88,98,86,2,10,0.977272727272727
"4592",2023-07-08,"3 - 1008",231,236,227,4,5,0.982683982683983
"4593",2023-07-08,"16 - 1022",53,53,51,2,0,0.962264150943396
"4594",2023-07-08,"24 - 1150",255,259,255,0,4,1
"4595",2023-07-08,"24 - 1153",352,355,352,0,3,1
"4596",2023-07-09,"62 - 1011",88,98,86,2,10,0.977272727272727
"4597",2023-07-09,"3 - 1008",231,236,227,4,5,0.982683982683983
"4598",2023-07-09,"16 - 1022",53,53,50,3,0,0.943396226415094
"4599",2023-07-09,"24 - 1150",254,259,254,0,5,1
"4600",2023-07-09,"24 - 1153",352,355,352,0,3,1
"4601",2023-07-10,"62 - 1011",88,98,86,2,10,0.977272727272727
"4602",2023-07-10,"3 - 1008",231,236,228,3,5,0.987012987012987
"4603",2023-07-10,"16 - 1022",53,53,50,3,0,0.943396226415094
"4604",2023-07-10,"24 - 1150",256,259,256,0,3,1
"4605",2023-07-10,"24 - 1153",353,355,353,0,2,1
"4606",2023-07-11,"62 - 1011",88,98,85,3,10,0.965909090909091
"4607",2023-07-11,"3 - 1008",231,236,227,4,5,0.982683982683983
"4608",2023-07-11,"16 - 1022",53,53,51,2,0,0.962264150943396
"4609",2023-07-11,"24 - 1150",258,259,256,2,1,0.992248062015504
"4610",2023-07-11,"24 - 1153",353,355,353,0,2,1
"4611",2023-07-12,"62 - 1011",88,98,86,2,10,0.977272727272727
"4612",2023-07-12,"3 - 1008",231,236,227,4,5,0.982683982683983
"4613",2023-07-12,"16 - 1022",53,53,51,2,0,0.962264150943396
"4614",2023-07-12,"24 - 1150",253,259,253,0,6,1
"4615",2023-07-12,"24 - 1153",353,355,353,0,2,1
"4616",2023-07-13,"62 - 1011",88,98,88,0,10,1
"4617",2023-07-13,"3 - 1008",231,236,227,4,5,0.982683982683983
"4618",2023-07-13,"16 - 1022",53,53,51,2,0,0.962264150943396
"4619",2023-07-13,"24 - 1150",253,259,253,0,6,1
"4620",2023-07-13,"24 - 1153",353,355,353,0,2,1
"4621",2023-07-14,"62 - 1011",88,98,88,0,10,1
"4622",2023-07-14,"3 - 1008",231,236,229,2,5,0.991341991341991
"4623",2023-07-14,"16 - 1022",53,53,51,2,0,0.962264150943396
"4624",2023-07-14,"24 - 1150",256,259,252,4,3,0.984375
"4625",2023-07-14,"24 - 1153",353,355,353,0,2,1
"4626",2023-07-15,"62 - 1011",88,98,88,0,10,1
"4627",2023-07-15,"3 - 1008",232,236,229,3,4,0.987068965517241
"4628",2023-07-15,"16 - 1022",53,53,51,2,0,0.962264150943396
"4629",2023-07-15,"24 - 1150",256,259,252,4,3,0.984375
"4630",2023-07-15,"24 - 1153",353,355,353,0,2,1
"4631",2023-07-16,"62 - 1011",88,98,87,1,10,0.988636363636364
"4632",2023-07-16,"3 - 1008",232,236,228,4,4,0.982758620689655
"4633",2023-07-16,"16 - 1022",53,53,51,2,0,0.962264150943396
"4634",2023-07-16,"24 - 1150",258,259,256,2,1,0.992248062015504
"4635",2023-07-16,"24 - 1153",353,355,352,1,2,0.997167138810198
"4636",2023-07-17,"62 - 1011",88,98,88,0,10,1
"4637",2023-07-17,"3 - 1008",232,236,228,4,4,0.982758620689655
"4638",2023-07-17,"16 - 1022",53,53,52,1,0,0.981132075471698
"4639",2023-07-17,"24 - 1150",256,259,256,0,3,1
"4640",2023-07-17,"24 - 1153",353,355,353,0,2,1
"4641",2023-07-18,"62 - 1011",88,98,88,0,10,1
"4642",2023-07-18,"3 - 1008",232,236,228,4,4,0.982758620689655
"4643",2023-07-18,"16 - 1022",53,53,52,1,0,0.981132075471698
"4644",2023-07-18,"24 - 1150",258,259,256,2,1,0.992248062015504
"4645",2023-07-18,"24 - 1153",353,355,353,0,2,1
"4646",2023-07-19,"62 - 1011",88,98,87,1,10,0.988636363636364
"4647",2023-07-19,"3 - 1008",232,236,225,7,4,0.969827586206897
"4648",2023-07-19,"16 - 1022",53,60,52,1,7,0.981132075471698
"4649",2023-07-19,"24 - 1150",257,259,257,0,2,1
"4650",2023-07-19,"24 - 1153",353,355,353,0,2,1
"4651",2023-07-20,"62 - 1011",88,98,87,1,10,0.988636363636364
"4652",2023-07-20,"3 - 1008",232,236,227,5,4,0.978448275862069
"4653",2023-07-20,"16 - 1022",53,60,52,1,7,0.981132075471698
"4654",2023-07-20,"24 - 1150",257,259,257,0,2,1
"4655",2023-07-20,"24 - 1153",353,355,353,0,2,1
"4656",2023-07-21,"62 - 1011",88,98,87,1,10,0.988636363636364
"4657",2023-07-21,"3 - 1008",231,236,227,4,5,0.982683982683983
"4658",2023-07-21,"16 - 1022",53,60,52,1,7,0.981132075471698
"4659",2023-07-21,"24 - 1150",257,259,256,1,2,0.996108949416342
"4660",2023-07-21,"24 - 1153",353,355,353,0,2,1
"4661",2023-07-22,"62 - 1011",88,98,88,0,10,1
"4662",2023-07-22,"3 - 1008",231,236,228,3,5,0.987012987012987
"4663",2023-07-22,"16 - 1022",53,60,52,1,7,0.981132075471698
"4664",2023-07-22,"24 - 1150",257,259,256,1,2,0.996108949416342
"4665",2023-07-22,"24 - 1153",353,355,353,0,2,1
"4666",2023-07-23,"62 - 1011",88,98,88,0,10,1
"4667",2023-07-23,"3 - 1008",231,236,229,2,5,0.991341991341991
"4668",2023-07-23,"16 - 1022",53,60,52,1,7,0.981132075471698
"4669",2023-07-23,"24 - 1150",256,259,256,0,3,1
"4670",2023-07-23,"24 - 1153",353,355,353,0,2,1
"4671",2023-07-24,"62 - 1011",88,98,88,0,10,1
"4672",2023-07-24,"3 - 1008",231,236,229,2,5,0.991341991341991
"4673",2023-07-24,"16 - 1022",56,60,56,0,4,1
"4674",2023-07-24,"24 - 1150",257,259,255,2,2,0.992217898832685
"4675",2023-07-24,"24 - 1153",353,355,353,0,2,1
"4676",2023-07-25,"62 - 1011",88,98,88,0,10,1
"4677",2023-07-25,"3 - 1008",231,236,229,2,5,0.991341991341991
"4678",2023-07-25,"16 - 1022",56,60,56,0,4,1
"4679",2023-07-25,"24 - 1150",254,259,250,4,5,0.984251968503937
"4680",2023-07-25,"24 - 1153",353,355,353,0,2,1
"4681",2023-07-26,"62 - 1011",96,98,88,8,2,0.916666666666667
"4682",2023-07-26,"3 - 1008",231,236,229,2,5,0.991341991341991
"4683",2023-07-26,"16 - 1022",57,60,56,1,3,0.982456140350877
"4684",2023-07-26,"24 - 1150",252,259,252,0,7,1
"4685",2023-07-26,"24 - 1153",353,355,353,0,2,1
"4686",2023-07-27,"62 - 1011",96,98,88,8,2,0.916666666666667
"4687",2023-07-27,"3 - 1008",231,236,230,1,5,0.995670995670996
"4688",2023-07-27,"16 - 1022",57,60,56,1,3,0.982456140350877
"4689",2023-07-27,"24 - 1150",250,259,250,0,9,1
"4690",2023-07-27,"24 - 1153",353,355,353,0,2,1
"4691",2023-07-28,"62 - 1011",96,98,88,8,2,0.916666666666667
"4692",2023-07-28,"3 - 1008",231,236,229,2,5,0.991341991341991
"4693",2023-07-28,"16 - 1022",57,60,56,1,3,0.982456140350877
"4694",2023-07-28,"24 - 1150",248,259,248,0,11,1
"4695",2023-07-28,"24 - 1153",353,355,353,0,2,1
"4696",2023-07-29,"62 - 1011",96,98,88,8,2,0.916666666666667
"4697",2023-07-29,"3 - 1008",231,236,228,3,5,0.987012987012987
"4698",2023-07-29,"16 - 1022",58,60,57,1,2,0.982758620689655
"4699",2023-07-29,"24 - 1150",247,259,247,0,12,1
"4700",2023-07-29,"24 - 1153",353,355,353,0,2,1
"4701",2023-07-30,"62 - 1011",96,98,88,8,2,0.916666666666667
"4702",2023-07-30,"3 - 1008",231,236,229,2,5,0.991341991341991
"4703",2023-07-30,"16 - 1022",57,60,55,2,3,0.964912280701754
"4704",2023-07-30,"24 - 1150",244,259,243,1,15,0.995901639344262
"4705",2023-07-30,"24 - 1153",353,355,353,0,2,1
"4706",2023-07-31,"62 - 1011",96,98,89,7,2,0.927083333333333
"4707",2023-07-31,"3 - 1008",231,236,229,2,5,0.991341991341991
"4708",2023-07-31,"16 - 1022",57,60,54,3,3,0.947368421052632
"4709",2023-07-31,"24 - 1150",242,259,242,0,17,1
"4710",2023-07-31,"24 - 1153",353,355,353,0,2,1
"4711",2023-08-01,"62 - 1011",96,98,89,7,2,0.927083333333333
"4712",2023-08-01,"3 - 1008",231,236,227,4,5,0.982683982683983
"4713",2023-08-01,"16 - 1022",57,60,53,4,3,0.929824561403509
"4714",2023-08-01,"24 - 1150",241,259,240,1,18,0.995850622406639
"4715",2023-08-01,"24 - 1153",353,355,353,0,2,1
"4716",2023-08-02,"62 - 1011",96,98,90,6,2,0.9375
"4717",2023-08-02,"3 - 1008",231,236,225,6,5,0.974025974025974
"4718",2023-08-02,"16 - 1022",57,60,54,3,3,0.947368421052632
"4719",2023-08-02,"24 - 1150",243,259,243,0,16,1
"4720",2023-08-02,"24 - 1153",353,355,353,0,2,1
"4721",2023-08-03,"62 - 1011",96,98,92,4,2,0.958333333333333
"4722",2023-08-03,"3 - 1008",231,236,226,5,5,0.978354978354978
"4723",2023-08-03,"16 - 1022",60,60,58,2,0,0.966666666666667
"4724",2023-08-03,"24 - 1150",241,259,241,0,18,1
"4725",2023-08-03,"24 - 1153",353,355,353,0,2,1
"4726",2023-08-04,"62 - 1011",96,98,93,3,2,0.96875
"4727",2023-08-04,"3 - 1008",231,246,226,5,15,0.978354978354978
"4728",2023-08-04,"16 - 1022",60,60,59,1,0,0.983333333333333
"4729",2023-08-04,"24 - 1150",240,259,240,0,19,1
"4730",2023-08-04,"24 - 1153",353,355,353,0,2,1
"4731",2023-08-05,"62 - 1011",96,98,93,3,2,0.96875
"4732",2023-08-05,"3 - 1008",233,246,227,6,13,0.974248927038627
"4733",2023-08-05,"16 - 1022",60,60,59,1,0,0.983333333333333
"4734",2023-08-05,"24 - 1150",240,259,240,0,19,1
"4735",2023-08-05,"24 - 1153",353,355,353,0,2,1
"4736",2023-08-06,"62 - 1011",96,98,93,3,2,0.96875
"4737",2023-08-06,"3 - 1008",235,255,230,5,20,0.978723404255319
"4738",2023-08-06,"16 - 1022",60,60,59,1,0,0.983333333333333
"4739",2023-08-06,"24 - 1150",240,259,240,0,19,1
"4740",2023-08-06,"24 - 1153",353,355,353,0,2,1
"4741",2023-08-07,"62 - 1011",96,98,92,4,2,0.958333333333333
"4742",2023-08-07,"3 - 1008",235,255,230,5,20,0.978723404255319
"4743",2023-08-07,"16 - 1022",60,60,59,1,0,0.983333333333333
"4744",2023-08-07,"24 - 1150",237,259,237,0,22,1
"4745",2023-08-07,"24 - 1153",353,355,353,0,2,1
"4746",2023-08-08,"62 - 1011",96,98,93,3,2,0.96875
"4747",2023-08-08,"3 - 1008",236,255,231,5,19,0.978813559322034
"4748",2023-08-08,"16 - 1022",60,60,59,1,0,0.983333333333333
"4749",2023-08-08,"24 - 1150",233,259,233,0,26,1
"4750",2023-08-08,"24 - 1153",353,355,353,0,2,1
"4751",2023-08-09,"62 - 1011",96,98,95,1,2,0.989583333333333
"4752",2023-08-09,"3 - 1008",239,255,235,4,16,0.98326359832636
"4753",2023-08-09,"16 - 1022",60,60,60,0,0,1
"4754",2023-08-09,"24 - 1150",235,259,235,0,24,1
"4755",2023-08-09,"24 - 1153",353,355,353,0,2,1
"4756",2023-08-10,"62 - 1011",96,98,95,1,2,0.989583333333333
"4757",2023-08-10,"3 - 1008",239,255,235,4,16,0.98326359832636
"4758",2023-08-10,"16 - 1022",60,60,60,0,0,1
"4759",2023-08-10,"24 - 1150",231,259,231,0,28,1
"4760",2023-08-10,"24 - 1153",353,355,353,0,2,1
"4761",2023-08-11,"62 - 1011",96,98,94,2,2,0.979166666666667
"4762",2023-08-11,"3 - 1008",240,255,237,3,15,0.9875
"4763",2023-08-11,"16 - 1022",60,60,59,1,0,0.983333333333333
"4764",2023-08-11,"24 - 1150",235,259,235,0,24,1
"4765",2023-08-11,"24 - 1153",353,355,353,0,2,1
"4766",2023-08-12,"62 - 1011",96,98,95,1,2,0.989583333333333
"4767",2023-08-12,"3 - 1008",240,255,237,3,15,0.9875
"4768",2023-08-12,"16 - 1022",60,60,59,1,0,0.983333333333333
"4769",2023-08-12,"24 - 1150",235,259,235,0,24,1
"4770",2023-08-12,"24 - 1153",353,355,353,0,2,1
"4771",2023-08-13,"62 - 1011",96,98,95,1,2,0.989583333333333
"4772",2023-08-13,"3 - 1008",240,255,237,3,15,0.9875
"4773",2023-08-13,"16 - 1022",60,60,57,3,0,0.95
"4774",2023-08-13,"24 - 1150",233,259,233,0,26,1
"4775",2023-08-13,"24 - 1153",353,355,353,0,2,1
"4776",2023-08-14,"62 - 1011",96,98,94,2,2,0.979166666666667
"4777",2023-08-14,"3 - 1008",240,255,237,3,15,0.9875
"4778",2023-08-14,"16 - 1022",60,60,60,0,0,1
"4779",2023-08-14,"24 - 1150",232,259,232,0,27,1
"4780",2023-08-14,"24 - 1153",353,355,353,0,2,1
"4781",2023-08-15,"62 - 1011",96,98,94,2,2,0.979166666666667
"4782",2023-08-15,"3 - 1008",240,255,237,3,15,0.9875
"4783",2023-08-15,"16 - 1022",59,60,59,0,1,1
"4784",2023-08-15,"24 - 1150",231,259,231,0,28,1
"4785",2023-08-15,"24 - 1153",353,355,353,0,2,1
"4786",2023-08-16,"62 - 1011",96,98,94,2,2,0.979166666666667
"4787",2023-08-16,"3 - 1008",240,255,237,3,15,0.9875
"4788",2023-08-16,"16 - 1022",60,60,59,1,0,0.983333333333333
"4789",2023-08-16,"24 - 1150",229,259,229,0,30,1
"4790",2023-08-16,"24 - 1153",353,355,353,0,2,1
"4791",2023-08-17,"62 - 1011",96,98,94,2,2,0.979166666666667
"4792",2023-08-17,"3 - 1008",240,255,238,2,15,0.991666666666667
"4793",2023-08-17,"16 - 1022",60,60,57,3,0,0.95
"4794",2023-08-17,"24 - 1150",226,259,226,0,33,1
"4795",2023-08-17,"24 - 1153",353,355,353,0,2,1
"4796",2023-08-18,"62 - 1011",96,98,95,1,2,0.989583333333333
"4797",2023-08-18,"3 - 1008",240,255,238,2,15,0.991666666666667
"4798",2023-08-18,"16 - 1022",60,60,58,2,0,0.966666666666667
"4799",2023-08-18,"24 - 1150",225,259,225,0,34,1
"4800",2023-08-18,"24 - 1153",353,355,353,0,2,1
"4801",2023-08-19,"62 - 1011",96,98,95,1,2,0.989583333333333
"4802",2023-08-19,"3 - 1008",240,255,238,2,15,0.991666666666667
"4803",2023-08-19,"16 - 1022",60,60,58,2,0,0.966666666666667
"4804",2023-08-19,"24 - 1150",225,259,225,0,34,1
"4805",2023-08-19,"24 - 1153",353,355,353,0,2,1
"4806",2023-08-20,"62 - 1011",96,98,95,1,2,0.989583333333333
"4807",2023-08-20,"3 - 1008",241,255,239,2,14,0.991701244813278
"4808",2023-08-20,"16 - 1022",60,60,58,2,0,0.966666666666667
"4809",2023-08-20,"24 - 1150",224,259,224,0,35,1
"4810",2023-08-20,"24 - 1153",353,355,353,0,2,1
"4811",2023-08-21,"62 - 1011",96,98,94,2,2,0.979166666666667
"4812",2023-08-21,"3 - 1008",243,255,241,2,12,0.991769547325103
"4813",2023-08-21,"16 - 1022",60,60,59,1,0,0.983333333333333
"4814",2023-08-21,"24 - 1150",219,259,219,0,40,1
"4815",2023-08-21,"24 - 1153",353,355,353,0,2,1
"4816",2023-08-22,"62 - 1011",96,98,94,2,2,0.979166666666667
"4817",2023-08-22,"3 - 1008",244,255,242,2,11,0.991803278688525
"4818",2023-08-22,"16 - 1022",60,60,59,1,0,0.983333333333333
"4819",2023-08-22,"24 - 1150",220,259,220,0,39,1
"4820",2023-08-22,"24 - 1153",353,355,353,0,2,1
"4821",2023-08-23,"62 - 1011",96,98,93,3,2,0.96875
"4822",2023-08-23,"3 - 1008",244,255,241,3,11,0.987704918032787
"4823",2023-08-23,"16 - 1022",60,60,59,1,0,0.983333333333333
"4824",2023-08-23,"24 - 1150",222,259,222,0,37,1
"4825",2023-08-23,"24 - 1153",353,355,352,1,2,0.997167138810198
"4826",2023-08-24,"62 - 1011",96,98,92,4,2,0.958333333333333
"4827",2023-08-24,"3 - 1008",244,255,242,2,11,0.991803278688525
"4828",2023-08-24,"16 - 1022",60,60,59,1,0,0.983333333333333
"4829",2023-08-24,"24 - 1150",223,259,222,1,36,0.995515695067265
"4830",2023-08-24,"24 - 1153",353,355,353,0,2,1
"4831",2023-08-25,"62 - 1011",96,98,93,3,2,0.96875
"4832",2023-08-25,"3 - 1008",244,255,241,3,11,0.987704918032787
"4833",2023-08-25,"16 - 1022",60,60,60,0,0,1
"4834",2023-08-25,"24 - 1150",224,259,224,0,35,1
"4835",2023-08-25,"24 - 1153",352,355,352,0,3,1
"4836",2023-08-26,"62 - 1011",96,98,94,2,2,0.979166666666667
"4837",2023-08-26,"3 - 1008",244,255,240,4,11,0.983606557377049
"4838",2023-08-26,"16 - 1022",60,60,58,2,0,0.966666666666667
"4839",2023-08-26,"24 - 1150",224,259,224,0,35,1
"4840",2023-08-26,"24 - 1153",352,355,352,0,3,1
"4841",2023-08-27,"62 - 1011",96,98,94,2,2,0.979166666666667
"4842",2023-08-27,"3 - 1008",244,255,240,4,11,0.983606557377049
"4843",2023-08-27,"16 - 1022",60,60,58,2,0,0.966666666666667
"4844",2023-08-27,"24 - 1150",224,259,224,0,35,1
"4845",2023-08-27,"24 - 1153",352,355,352,0,3,1
"4846",2023-08-28,"62 - 1011",96,98,95,1,2,0.989583333333333
"4847",2023-08-28,"3 - 1008",244,255,241,3,11,0.987704918032787
"4848",2023-08-28,"16 - 1022",60,60,56,4,0,0.933333333333333
"4849",2023-08-28,"24 - 1150",225,259,225,0,34,1
"4850",2023-08-28,"24 - 1153",352,355,352,0,3,1
"4851",2023-08-29,"62 - 1011",96,98,95,1,2,0.989583333333333
"4852",2023-08-29,"3 - 1008",244,255,241,3,11,0.987704918032787
"4853",2023-08-29,"16 - 1022",60,60,58,2,0,0.966666666666667
"4854",2023-08-29,"24 - 1150",223,259,223,0,36,1
"4855",2023-08-29,"24 - 1153",352,355,352,0,3,1
"4856",2023-08-30,"62 - 1011",96,98,94,2,2,0.979166666666667
"4857",2023-08-30,"3 - 1008",242,255,239,3,13,0.987603305785124
"4858",2023-08-30,"16 - 1022",60,60,58,2,0,0.966666666666667
"4859",2023-08-30,"24 - 1150",224,259,224,0,35,1
"4860",2023-08-30,"24 - 1153",386,410,377,9,24,0.976683937823834
"4861",2023-08-31,"62 - 1011",96,98,94,2,2,0.979166666666667
"4862",2023-08-31,"3 - 1008",243,255,239,4,12,0.983539094650206
"4863",2023-08-31,"16 - 1022",60,60,58,2,0,0.966666666666667
"4864",2023-08-31,"24 - 1150",216,259,216,0,43,1
"4865",2023-08-31,"24 - 1153",395,410,395,0,15,1
"4866",2023-09-01,"62 - 1011",96,98,94,2,2,0.979166666666667
"4867",2023-09-01,"3 - 1008",243,255,238,5,12,0.979423868312757
"4868",2023-09-01,"16 - 1022",60,60,56,4,0,0.933333333333333
"4869",2023-09-01,"24 - 1150",215,259,214,1,44,0.995348837209302
"4870",2023-09-01,"24 - 1153",389,410,389,0,21,1
"4871",2023-09-02,"62 - 1011",96,98,94,2,2,0.979166666666667
"4872",2023-09-02,"3 - 1008",243,255,238,5,12,0.979423868312757
"4873",2023-09-02,"16 - 1022",60,60,56,4,0,0.933333333333333
"4874",2023-09-02,"24 - 1150",214,259,214,0,45,1
"4875",2023-09-02,"24 - 1153",390,410,390,0,20,1
"4876",2023-09-03,"62 - 1011",96,98,93,3,2,0.96875
"4877",2023-09-03,"3 - 1008",243,255,238,5,12,0.979423868312757
"4878",2023-09-03,"16 - 1022",60,60,54,6,0,0.9
"4879",2023-09-03,"24 - 1150",213,259,213,0,46,1
"4880",2023-09-03,"24 - 1153",390,410,390,0,20,1
"4881",2023-09-04,"62 - 1011",96,98,93,3,2,0.96875
"4882",2023-09-04,"3 - 1008",243,255,238,5,12,0.979423868312757
"4883",2023-09-04,"16 - 1022",60,60,54,6,0,0.9
"4884",2023-09-04,"24 - 1150",211,259,211,0,48,1
"4885",2023-09-04,"24 - 1153",390,410,390,0,20,1
"4886",2023-09-05,"62 - 1011",96,98,93,3,2,0.96875
"4887",2023-09-05,"3 - 1008",243,255,238,5,12,0.979423868312757
"4888",2023-09-05,"16 - 1022",60,60,55,5,0,0.916666666666667
"4889",2023-09-05,"24 - 1150",211,259,211,0,48,1
"4890",2023-09-05,"24 - 1153",390,410,390,0,20,1
"4891",2023-09-06,"62 - 1011",96,98,93,3,2,0.96875
"4892",2023-09-06,"3 - 1008",243,255,239,4,12,0.983539094650206
"4893",2023-09-06,"16 - 1022",60,60,55,5,0,0.916666666666667
"4894",2023-09-06,"24 - 1150",212,259,212,0,47,1
"4895",2023-09-06,"24 - 1153",393,410,393,0,17,1
"4896",2023-09-07,"62 - 1011",96,98,92,4,2,0.958333333333333
"4897",2023-09-07,"3 - 1008",243,255,236,7,12,0.97119341563786
"4898",2023-09-07,"16 - 1022",60,60,55,5,0,0.916666666666667
"4899",2023-09-07,"24 - 1150",210,259,210,0,49,1
"4900",2023-09-07,"24 - 1153",393,410,393,0,17,1
"4901",2023-09-08,"62 - 1011",96,98,91,5,2,0.947916666666667
"4902",2023-09-08,"3 - 1008",243,255,238,5,12,0.979423868312757
"4903",2023-09-08,"16 - 1022",60,60,57,3,0,0.95
"4904",2023-09-08,"24 - 1150",218,287,218,0,69,1
"4905",2023-09-08,"24 - 1153",393,410,393,0,17,1
"4906",2023-09-09,"62 - 1011",96,98,93,3,2,0.96875
"4907",2023-09-09,"3 - 1008",243,255,238,5,12,0.979423868312757
"4908",2023-09-09,"16 - 1022",60,60,57,3,0,0.95
"4909",2023-09-09,"24 - 1150",216,287,216,0,71,1
"4910",2023-09-09,"24 - 1153",393,410,393,0,17,1
"4911",2023-09-10,"62 - 1011",96,98,93,3,2,0.96875
"4912",2023-09-10,"3 - 1008",243,255,238,5,12,0.979423868312757
"4913",2023-09-10,"16 - 1022",60,60,57,3,0,0.95
"4914",2023-09-10,"24 - 1150",216,287,216,0,71,1
"4915",2023-09-10,"24 - 1153",392,410,392,0,18,1
"4916",2023-09-11,"62 - 1011",96,98,92,4,2,0.958333333333333
"4917",2023-09-11,"3 - 1008",243,255,238,5,12,0.979423868312757
"4918",2023-09-11,"16 - 1022",60,60,59,1,0,0.983333333333333
"4919",2023-09-11,"24 - 1150",216,287,216,0,71,1
"4920",2023-09-11,"24 - 1153",390,410,390,0,20,1
"4921",2023-09-12,"62 - 1011",96,98,91,5,2,0.947916666666667
"4922",2023-09-12,"3 - 1008",243,255,237,6,12,0.975308641975309
"4923",2023-09-12,"16 - 1022",59,60,58,1,1,0.983050847457627
"4924",2023-09-12,"24 - 1150",224,287,219,5,63,0.977678571428571
"4925",2023-09-12,"24 - 1153",392,410,392,0,18,1
"4926",2023-09-13,"62 - 1011",96,98,90,6,2,0.9375
"4927",2023-09-13,"3 - 1008",243,255,238,5,12,0.979423868312757
"4928",2023-09-13,"16 - 1022",60,60,58,2,0,0.966666666666667
"4929",2023-09-13,"24 - 1150",245,287,244,1,42,0.995918367346939
"4930",2023-09-13,"24 - 1153",390,410,390,0,20,1
"4931",2023-09-14,"62 - 1011",96,98,90,6,2,0.9375
"4932",2023-09-14,"3 - 1008",243,255,240,3,12,0.987654320987654
"4933",2023-09-14,"16 - 1022",60,60,60,0,0,1
"4934",2023-09-14,"24 - 1150",259,287,251,8,28,0.969111969111969
"4935",2023-09-14,"24 - 1153",386,410,386,0,24,1
"4936",2023-09-15,"62 - 1011",96,98,90,6,2,0.9375
"4937",2023-09-15,"3 - 1008",243,255,236,7,12,0.97119341563786
"4938",2023-09-15,"16 - 1022",60,60,59,1,0,0.983333333333333
"4939",2023-09-15,"24 - 1150",260,287,260,0,27,1
"4940",2023-09-15,"24 - 1153",396,416,396,0,20,1
"4941",2023-09-16,"62 - 1011",96,98,90,6,2,0.9375
"4942",2023-09-16,"3 - 1008",243,255,235,8,12,0.967078189300412
"4943",2023-09-16,"16 - 1022",60,60,57,3,0,0.95
"4944",2023-09-16,"24 - 1150",261,287,261,0,26,1
"4945",2023-09-16,"24 - 1153",396,416,396,0,20,1
"4946",2023-09-17,"62 - 1011",96,98,91,5,2,0.947916666666667
"4947",2023-09-17,"3 - 1008",243,255,235,8,12,0.967078189300412
"4948",2023-09-17,"16 - 1022",60,60,57,3,0,0.95
"4949",2023-09-17,"24 - 1150",261,287,261,0,26,1
"4950",2023-09-17,"24 - 1153",396,416,396,0,20,1
"4951",2023-09-18,"62 - 1011",96,98,93,3,2,0.96875
"4952",2023-09-18,"3 - 1008",245,255,237,8,10,0.96734693877551
"4953",2023-09-18,"16 - 1022",60,60,59,1,0,0.983333333333333
"4954",2023-09-18,"24 - 1150",261,287,259,2,26,0.992337164750958
"4955",2023-09-18,"24 - 1153",406,416,406,0,10,1
"4956",2023-09-19,"62 - 1011",96,98,94,2,2,0.979166666666667
"4957",2023-09-19,"3 - 1008",248,255,238,10,7,0.959677419354839
"4958",2023-09-19,"16 - 1022",60,60,57,3,0,0.95
"4959",2023-09-19,"24 - 1150",262,287,262,0,25,1
"4960",2023-09-19,"24 - 1153",404,416,403,1,12,0.997524752475248
"4961",2023-09-20,"62 - 1011",96,98,96,0,2,1
"4962",2023-09-20,"3 - 1008",250,255,240,10,5,0.96
"4963",2023-09-20,"16 - 1022",59,60,57,2,1,0.966101694915254
"4964",2023-09-20,"24 - 1150",261,287,261,0,26,1
"4965",2023-09-20,"24 - 1153",403,416,403,0,13,1
"4966",2023-09-21,"62 - 1011",96,98,95,1,2,0.989583333333333
"4967",2023-09-21,"3 - 1008",250,255,240,10,5,0.96
"4968",2023-09-21,"16 - 1022",60,60,58,2,0,0.966666666666667
"4969",2023-09-21,"24 - 1150",273,287,271,2,14,0.992673992673993
"4970",2023-09-21,"24 - 1153",405,416,405,0,11,1
"4971",2023-09-22,"62 - 1011",96,98,95,1,2,0.989583333333333
"4972",2023-09-22,"3 - 1008",250,255,240,10,5,0.96
"4973",2023-09-22,"16 - 1022",60,60,58,2,0,0.966666666666667
"4974",2023-09-22,"24 - 1150",275,287,275,0,12,1
"4975",2023-09-22,"24 - 1153",409,420,409,0,11,1
"4976",2023-09-23,"62 - 1011",96,98,96,0,2,1
"4977",2023-09-23,"3 - 1008",250,255,240,10,5,0.96
"4978",2023-09-23,"16 - 1022",60,60,58,2,0,0.966666666666667
"4979",2023-09-23,"24 - 1150",275,287,275,0,12,1
"4980",2023-09-23,"24 - 1153",410,420,410,0,10,1
"4981",2023-09-24,"62 - 1011",96,98,96,0,2,1
"4982",2023-09-24,"3 - 1008",250,255,239,11,5,0.956
"4983",2023-09-24,"16 - 1022",60,60,58,2,0,0.966666666666667
"4984",2023-09-24,"24 - 1150",273,287,273,0,14,1
"4985",2023-09-24,"24 - 1153",410,420,410,0,10,1
"4986",2023-09-25,"62 - 1011",96,98,96,0,2,1
"4987",2023-09-25,"3 - 1008",250,255,239,11,5,0.956
"4988",2023-09-25,"16 - 1022",60,60,58,2,0,0.966666666666667
"4989",2023-09-25,"24 - 1150",280,287,280,0,7,1
"4990",2023-09-25,"24 - 1153",410,420,409,1,10,0.997560975609756
"4991",2023-09-26,"62 - 1011",96,98,96,0,2,1
"4992",2023-09-26,"3 - 1008",250,255,239,11,5,0.956
"4993",2023-09-26,"16 - 1022",60,60,59,1,0,0.983333333333333
"4994",2023-09-26,"24 - 1150",279,287,279,0,8,1
"4995",2023-09-26,"24 - 1153",412,420,412,0,8,1
"4996",2023-09-27,"62 - 1011",96,98,95,1,2,0.989583333333333
"4997",2023-09-27,"3 - 1008",250,255,237,13,5,0.948
"4998",2023-09-27,"16 - 1022",60,60,59,1,0,0.983333333333333
"4999",2023-09-27,"24 - 1150",282,287,282,0,5,1
"5000",2023-09-27,"24 - 1153",412,420,412,0,8,1
"5001",2023-09-28,"62 - 1011",108,112,108,0,4,1
"5002",2023-09-28,"3 - 1008",250,255,237,13,5,0.948
"5003",2023-09-28,"16 - 1022",60,60,59,1,0,0.983333333333333
"5004",2023-09-28,"24 - 1150",283,287,283,0,4,1
"5005",2023-09-28,"24 - 1153",413,420,413,0,7,1
"5006",2023-09-29,"62 - 1011",112,112,110,2,0,0.982142857142857
"5007",2023-09-29,"3 - 1008",250,255,238,12,5,0.952
"5008",2023-09-29,"16 - 1022",60,60,58,2,0,0.966666666666667
"5009",2023-09-29,"24 - 1150",281,287,281,0,6,1
"5010",2023-09-29,"24 - 1153",413,420,413,0,7,1
"5011",2023-09-30,"62 - 1011",112,112,112,0,0,1
"5012",2023-09-30,"3 - 1008",250,255,238,12,5,0.952
"5013",2023-09-30,"16 - 1022",60,60,58,2,0,0.966666666666667
"5014",2023-09-30,"24 - 1150",279,287,279,0,8,1
"5015",2023-09-30,"24 - 1153",413,420,413,0,7,1
"5016",2023-10-01,"62 - 1011",112,112,112,0,0,1
"5017",2023-10-01,"3 - 1008",250,255,238,12,5,0.952
"5018",2023-10-01,"16 - 1022",60,60,57,3,0,0.95
"5019",2023-10-01,"24 - 1150",276,287,276,0,11,1
"5020",2023-10-01,"24 - 1153",414,420,414,0,6,1
"5021",2023-10-02,"62 - 1011",112,112,110,2,0,0.982142857142857
"5022",2023-10-02,"3 - 1008",250,255,237,13,5,0.948
"5023",2023-10-02,"16 - 1022",60,60,54,6,0,0.9
"5024",2023-10-02,"24 - 1150",282,287,274,8,5,0.971631205673759
"5025",2023-10-02,"24 - 1153",415,420,415,0,5,1
"5026",2023-10-03,"62 - 1011",112,112,112,0,0,1
"5027",2023-10-03,"3 - 1008",250,255,238,12,5,0.952
"5028",2023-10-03,"16 - 1022",60,60,56,4,0,0.933333333333333
"5029",2023-10-03,"24 - 1150",280,287,280,0,7,1
"5030",2023-10-03,"24 - 1153",415,420,415,0,5,1
"5031",2023-10-04,"62 - 1011",112,112,112,0,0,1
"5032",2023-10-04,"3 - 1008",250,255,238,12,5,0.952
"5033",2023-10-04,"16 - 1022",60,60,57,3,0,0.95
"5034",2023-10-04,"24 - 1150",282,287,280,2,5,0.99290780141844
"5035",2023-10-04,"24 - 1153",416,420,416,0,4,1
"5036",2023-10-05,"62 - 1011",112,112,111,1,0,0.991071428571429
"5037",2023-10-05,"3 - 1008",250,255,237,13,5,0.948
"5038",2023-10-05,"16 - 1022",60,60,57,3,0,0.95
"5039",2023-10-05,"24 - 1150",280,287,278,2,7,0.992857142857143
"5040",2023-10-05,"24 - 1153",416,420,416,0,4,1
"5041",2023-10-06,"62 - 1011",116,116,116,0,0,1
"5042",2023-10-06,"3 - 1008",250,255,237,13,5,0.948
"5043",2023-10-06,"16 - 1022",60,60,56,4,0,0.933333333333333
"5044",2023-10-06,"24 - 1150",282,287,280,2,5,0.99290780141844
"5045",2023-10-06,"24 - 1153",417,420,416,1,3,0.997601918465228
"5046",2023-10-07,"62 - 1011",116,116,116,0,0,1
"5047",2023-10-07,"3 - 1008",250,255,236,14,5,0.944
"5048",2023-10-07,"16 - 1022",60,60,56,4,0,0.933333333333333
"5049",2023-10-07,"24 - 1150",282,287,280,2,5,0.99290780141844
"5050",2023-10-07,"24 - 1153",417,420,417,0,3,1
"5051",2023-10-08,"62 - 1011",116,116,116,0,0,1
"5052",2023-10-08,"3 - 1008",250,255,237,13,5,0.948
"5053",2023-10-08,"16 - 1022",60,60,56,4,0,0.933333333333333
"5054",2023-10-08,"24 - 1150",282,287,282,0,5,1
"5055",2023-10-08,"24 - 1153",417,420,417,0,3,1
"5056",2023-10-09,"62 - 1011",116,116,116,0,0,1
"5057",2023-10-09,"3 - 1008",250,255,237,13,5,0.948
"5058",2023-10-09,"16 - 1022",60,60,56,4,0,0.933333333333333
"5059",2023-10-09,"24 - 1150",283,287,283,0,4,1
"5060",2023-10-09,"24 - 1153",417,420,416,1,3,0.997601918465228
"5061",2023-10-10,"62 - 1011",116,116,116,0,0,1
"5062",2023-10-10,"3 - 1008",250,255,236,14,5,0.944
"5063",2023-10-10,"16 - 1022",60,60,59,1,0,0.983333333333333
"5064",2023-10-10,"24 - 1150",284,287,284,0,3,1
"5065",2023-10-10,"24 - 1153",417,420,417,0,3,1
"5066",2023-10-11,"62 - 1011",116,116,114,2,0,0.982758620689655
"5067",2023-10-11,"3 - 1008",250,255,234,16,5,0.936
"5068",2023-10-11,"16 - 1022",60,60,60,0,0,1
"5069",2023-10-11,"24 - 1150",285,287,285,0,2,1
"5070",2023-10-11,"24 - 1153",417,420,416,1,3,0.997601918465228
"5071",2023-10-12,"62 - 1011",116,116,116,0,0,1
"5072",2023-10-12,"3 - 1008",251,255,235,16,4,0.936254980079681
"5073",2023-10-12,"16 - 1022",60,60,60,0,0,1
"5074",2023-10-12,"24 - 1150",286,287,285,1,1,0.996503496503496
"5075",2023-10-12,"24 - 1153",417,420,417,0,3,1
"5076",2023-10-13,"62 - 1011",116,116,116,0,0,1
"5077",2023-10-13,"3 - 1008",251,255,236,15,4,0.940239043824701
"5078",2023-10-13,"16 - 1022",60,60,60,0,0,1
"5079",2023-10-13,"24 - 1150",285,287,285,0,2,1
"5080",2023-10-13,"24 - 1153",417,420,417,0,3,1
"5081",2023-10-14,"62 - 1011",116,116,116,0,0,1
"5082",2023-10-14,"3 - 1008",252,255,237,15,3,0.94047619047619
"5083",2023-10-14,"16 - 1022",60,60,60,0,0,1
"5084",2023-10-14,"24 - 1150",284,287,284,0,3,1
"5085",2023-10-14,"24 - 1153",417,420,417,0,3,1
"5086",2023-10-15,"62 - 1011",116,116,116,0,0,1
"5087",2023-10-15,"3 - 1008",252,255,237,15,3,0.94047619047619
"5088",2023-10-15,"16 - 1022",60,60,60,0,0,1
"5089",2023-10-15,"24 - 1150",284,287,284,0,3,1
"5090",2023-10-15,"24 - 1153",417,420,417,0,3,1
"5091",2023-10-16,"62 - 1011",116,116,116,0,0,1
"5092",2023-10-16,"3 - 1008",254,255,239,15,1,0.940944881889764
"5093",2023-10-16,"16 - 1022",60,60,60,0,0,1
"5094",2023-10-16,"24 - 1150",284,287,284,0,3,1
"5095",2023-10-16,"24 - 1153",418,420,418,0,2,1
"5096",2023-10-17,"62 - 1011",116,116,115,1,0,0.991379310344828
"5097",2023-10-17,"3 - 1008",254,255,240,14,1,0.94488188976378
"5098",2023-10-17,"16 - 1022",60,60,60,0,0,1
"5099",2023-10-17,"24 - 1150",285,287,285,0,2,1
"5100",2023-10-17,"24 - 1153",418,420,418,0,2,1
"5101",2023-10-18,"62 - 1011",116,116,113,3,0,0.974137931034483
"5102",2023-10-18,"3 - 1008",253,255,239,14,2,0.944664031620553
"5103",2023-10-18,"16 - 1022",60,60,60,0,0,1
"5104",2023-10-18,"24 - 1150",285,287,285,0,2,1
"5105",2023-10-18,"24 - 1153",416,420,416,0,4,1
"5106",2023-10-19,"62 - 1011",116,116,116,0,0,1
"5107",2023-10-19,"3 - 1008",253,255,239,14,2,0.944664031620553
"5108",2023-10-19,"16 - 1022",60,60,60,0,0,1
"5109",2023-10-19,"24 - 1150",284,287,284,0,3,1
"5110",2023-10-19,"24 - 1153",416,420,416,0,4,1
"5111",2023-10-20,"62 - 1011",116,116,116,0,0,1
"5112",2023-10-20,"3 - 1008",254,255,241,13,1,0.948818897637795
"5113",2023-10-20,"16 - 1022",60,60,59,1,0,0.983333333333333
"5114",2023-10-20,"24 - 1150",284,287,284,0,3,1
"5115",2023-10-20,"24 - 1153",416,420,416,0,4,1
"5116",2023-10-21,"62 - 1011",116,116,116,0,0,1
"5117",2023-10-21,"3 - 1008",254,255,241,13,1,0.948818897637795
"5118",2023-10-21,"16 - 1022",60,60,59,1,0,0.983333333333333
"5119",2023-10-21,"24 - 1150",281,287,281,0,6,1
"5120",2023-10-21,"24 - 1153",416,420,416,0,4,1
"5121",2023-10-22,"62 - 1011",116,116,115,1,0,0.991379310344828
"5122",2023-10-22,"3 - 1008",253,255,240,13,2,0.948616600790514
"5123",2023-10-22,"16 - 1022",60,60,59,1,0,0.983333333333333
"5124",2023-10-22,"24 - 1150",282,287,282,0,5,1
"5125",2023-10-22,"24 - 1153",416,420,416,0,4,1
"5126",2023-10-23,"62 - 1011",116,116,116,0,0,1
"5127",2023-10-23,"3 - 1008",253,255,240,13,2,0.948616600790514
"5128",2023-10-23,"16 - 1022",60,60,60,0,0,1
"5129",2023-10-23,"24 - 1150",282,287,282,0,5,1
"5130",2023-10-23,"24 - 1153",416,420,415,1,4,0.997596153846154
"5131",2023-10-24,"62 - 1011",116,116,116,0,0,1
"5132",2023-10-24,"3 - 1008",252,255,238,14,3,0.944444444444444
"5133",2023-10-24,"16 - 1022",60,60,60,0,0,1
"5134",2023-10-24,"24 - 1150",282,287,282,0,5,1
"5135",2023-10-24,"24 - 1153",416,420,416,0,4,1
"5136",2023-10-25,"62 - 1011",116,116,116,0,0,1
"5137",2023-10-25,"3 - 1008",251,255,239,12,4,0.952191235059761
"5138",2023-10-25,"16 - 1022",60,60,60,0,0,1
"5139",2023-10-25,"24 - 1150",282,287,282,0,5,1
"5140",2023-10-25,"24 - 1153",418,420,418,0,2,1
"5141",2023-10-26,"62 - 1011",116,116,116,0,0,1
"5142",2023-10-26,"3 - 1008",251,255,239,12,4,0.952191235059761
"5143",2023-10-26,"16 - 1022",60,60,60,0,0,1
"5144",2023-10-26,"24 - 1150",281,287,281,0,6,1
"5145",2023-10-26,"24 - 1153",418,420,418,0,2,1
"5146",2023-10-27,"62 - 1011",116,116,116,0,0,1
"5147",2023-10-27,"3 - 1008",251,255,240,11,4,0.956175298804781
"5148",2023-10-27,"16 - 1022",60,60,59,1,0,0.983333333333333
"5149",2023-10-27,"24 - 1150",281,287,279,2,6,0.99288256227758
"5150",2023-10-27,"24 - 1153",418,420,418,0,2,1
"5151",2023-10-28,"62 - 1011",116,116,115,1,0,0.991379310344828
"5152",2023-10-28,"3 - 1008",249,255,238,11,6,0.955823293172691
"5153",2023-10-28,"16 - 1022",60,60,59,1,0,0.983333333333333
"5154",2023-10-28,"24 - 1150",282,287,282,0,5,1
"5155",2023-10-28,"24 - 1153",418,420,418,0,2,1
"5156",2023-10-29,"62 - 1011",116,116,116,0,0,1
"5157",2023-10-29,"3 - 1008",249,255,238,11,6,0.955823293172691
"5158",2023-10-29,"16 - 1022",60,60,59,1,0,0.983333333333333
"5159",2023-10-29,"24 - 1150",282,287,282,0,5,1
"5160",2023-10-29,"24 - 1153",418,420,418,0,2,1
"5161",2023-10-30,"62 - 1011",116,116,115,1,0,0.991379310344828
"5162",2023-10-30,"3 - 1008",249,255,238,11,6,0.955823293172691
"5163",2023-10-30,"16 - 1022",60,60,59,1,0,0.983333333333333
"5164",2023-10-30,"24 - 1150",282,287,282,0,5,1
"5165",2023-10-30,"24 - 1153",418,420,418,0,2,1
"5166",2023-10-31,"62 - 1011",116,116,114,2,0,0.982758620689655
"5167",2023-10-31,"3 - 1008",249,255,238,11,6,0.955823293172691
"5168",2023-10-31,"16 - 1022",60,60,59,1,0,0.983333333333333
"5169",2023-10-31,"24 - 1150",282,287,282,0,5,1
"5170",2023-10-31,"24 - 1153",418,420,418,0,2,1
"5171",2023-11-01,"62 - 1011",116,116,114,2,0,0.982758620689655
"5172",2023-11-01,"3 - 1008",248,255,238,10,7,0.959677419354839
"5173",2023-11-01,"16 - 1022",60,60,58,2,0,0.966666666666667
"5174",2023-11-01,"24 - 1150",281,287,281,0,6,1
"5175",2023-11-01,"24 - 1153",418,420,418,0,2,1
"5176",2023-11-02,"62 - 1011",116,116,114,2,0,0.982758620689655
"5177",2023-11-02,"3 - 1008",249,255,241,8,6,0.967871485943775
"5178",2023-11-02,"16 - 1022",60,60,59,1,0,0.983333333333333
"5179",2023-11-02,"24 - 1150",279,287,279,0,8,1
"5180",2023-11-02,"24 - 1153",418,420,418,0,2,1
"5181",2023-11-03,"62 - 1011",116,116,114,2,0,0.982758620689655
"5182",2023-11-03,"3 - 1008",249,255,242,7,6,0.971887550200803
"5183",2023-11-03,"16 - 1022",60,60,58,2,0,0.966666666666667
"5184",2023-11-03,"24 - 1150",279,287,277,2,8,0.992831541218638
"5185",2023-11-03,"24 - 1153",418,420,418,0,2,1
"5186",2023-11-04,"62 - 1011",116,116,115,1,0,0.991379310344828
"5187",2023-11-04,"3 - 1008",249,255,242,7,6,0.971887550200803
"5188",2023-11-04,"16 - 1022",60,60,58,2,0,0.966666666666667
"5189",2023-11-04,"24 - 1150",278,287,278,0,9,1
"5190",2023-11-04,"24 - 1153",418,420,418,0,2,1
"5191",2023-11-05,"62 - 1011",116,116,115,1,0,0.991379310344828
"5192",2023-11-05,"3 - 1008",249,255,242,7,6,0.971887550200803
"5193",2023-11-05,"16 - 1022",60,60,58,2,0,0.966666666666667
"5194",2023-11-05,"24 - 1150",278,287,278,0,9,1
"5195",2023-11-05,"24 - 1153",418,420,417,1,2,0.997607655502392
"5196",2023-11-06,"62 - 1011",116,116,115,1,0,0.991379310344828
"5197",2023-11-06,"3 - 1008",250,255,241,9,5,0.964
"5198",2023-11-06,"16 - 1022",60,60,57,3,0,0.95
"5199",2023-11-06,"24 - 1150",276,287,274,2,11,0.992753623188406
"5200",2023-11-06,"24 - 1153",418,420,418,0,2,1
"5201",2023-11-07,"62 - 1011",116,116,116,0,0,1
"5202",2023-11-07,"3 - 1008",250,255,240,10,5,0.96
"5203",2023-11-07,"16 - 1022",60,60,58,2,0,0.966666666666667
"5204",2023-11-07,"24 - 1150",276,287,276,0,11,1
"5205",2023-11-07,"24 - 1153",418,420,418,0,2,1
"5206",2023-11-08,"62 - 1011",116,116,115,1,0,0.991379310344828
"5207",2023-11-08,"3 - 1008",250,354,242,8,104,0.968
"5208",2023-11-08,"16 - 1022",60,60,59,1,0,0.983333333333333
"5209",2023-11-08,"24 - 1150",279,287,279,0,8,1
"5210",2023-11-08,"24 - 1153",418,420,418,0,2,1
"5211",2023-11-09,"62 - 1011",116,116,116,0,0,1
"5212",2023-11-09,"3 - 1008",250,354,241,9,104,0.964
"5213",2023-11-09,"16 - 1022",60,60,58,2,0,0.966666666666667
"5214",2023-11-09,"24 - 1150",281,287,281,0,6,1
"5215",2023-11-09,"24 - 1153",418,420,418,0,2,1
"5216",2023-11-10,"62 - 1011",116,116,116,0,0,1
"5217",2023-11-10,"3 - 1008",250,354,242,8,104,0.968
"5218",2023-11-10,"16 - 1022",60,60,56,4,0,0.933333333333333
"5219",2023-11-10,"24 - 1150",282,287,282,0,5,1
"5220",2023-11-10,"24 - 1153",418,420,418,0,2,1
"5221",2023-11-11,"62 - 1011",116,116,116,0,0,1
"5222",2023-11-11,"3 - 1008",250,354,242,8,104,0.968
"5223",2023-11-11,"16 - 1022",60,60,56,4,0,0.933333333333333
"5224",2023-11-11,"24 - 1150",283,287,283,0,4,1
"5225",2023-11-11,"24 - 1153",418,420,418,0,2,1
"5226",2023-11-12,"62 - 1011",116,116,116,0,0,1
"5227",2023-11-12,"3 - 1008",250,354,241,9,104,0.964
"5228",2023-11-12,"16 - 1022",60,60,56,4,0,0.933333333333333
"5229",2023-11-12,"24 - 1150",283,287,283,0,4,1
"5230",2023-11-12,"24 - 1153",418,420,418,0,2,1
"5231",2023-11-13,"62 - 1011",116,116,116,0,0,1
"5232",2023-11-13,"3 - 1008",250,354,242,8,104,0.968
"5233",2023-11-13,"16 - 1022",60,60,56,4,0,0.933333333333333
"5234",2023-11-13,"24 - 1150",283,287,283,0,4,1
"5235",2023-11-13,"24 - 1153",418,420,418,0,2,1
"5236",2023-11-14,"62 - 1011",116,116,113,3,0,0.974137931034483
"5237",2023-11-14,"3 - 1008",250,354,243,7,104,0.972
"5238",2023-11-14,"16 - 1022",60,60,56,4,0,0.933333333333333
"5239",2023-11-14,"24 - 1150",284,287,284,0,3,1
"5240",2023-11-14,"24 - 1153",418,420,418,0,2,1
"5241",2023-11-15,"62 - 1011",116,116,113,3,0,0.974137931034483
"5242",2023-11-15,"3 - 1008",270,354,259,11,84,0.959259259259259
"5243",2023-11-15,"16 - 1022",60,60,56,4,0,0.933333333333333
"5244",2023-11-15,"24 - 1150",285,287,285,0,2,1
"5245",2023-11-15,"24 - 1153",418,420,418,0,2,1
"5246",2023-11-16,"62 - 1011",116,116,113,3,0,0.974137931034483
"5247",2023-11-16,"3 - 1008",275,354,270,5,79,0.981818181818182
"5248",2023-11-16,"16 - 1022",60,60,57,3,0,0.95
"5249",2023-11-16,"24 - 1150",285,287,285,0,2,1
"5250",2023-11-16,"24 - 1153",418,420,418,0,2,1
"5251",2023-11-17,"62 - 1011",116,116,114,2,0,0.982758620689655
"5252",2023-11-17,"3 - 1008",292,354,289,3,62,0.98972602739726
"5253",2023-11-17,"16 - 1022",60,60,57,3,0,0.95
"5254",2023-11-17,"24 - 1150",285,287,285,0,2,1
"5255",2023-11-17,"24 - 1153",418,420,418,0,2,1
"5256",2023-11-18,"62 - 1011",116,116,113,3,0,0.974137931034483
"5257",2023-11-18,"3 - 1008",311,354,308,3,43,0.990353697749196
"5258",2023-11-18,"16 - 1022",60,60,57,3,0,0.95
"5259",2023-11-18,"24 - 1150",285,287,285,0,2,1
"5260",2023-11-18,"24 - 1153",418,420,418,0,2,1
"5261",2023-11-19,"62 - 1011",116,116,113,3,0,0.974137931034483
"5262",2023-11-19,"3 - 1008",319,354,316,3,35,0.990595611285266
"5263",2023-11-19,"16 - 1022",60,60,58,2,0,0.966666666666667
"5264",2023-11-19,"24 - 1150",285,287,285,0,2,1
"5265",2023-11-19,"24 - 1153",418,420,418,0,2,1
"5266",2023-11-20,"62 - 1011",116,116,113,3,0,0.974137931034483
"5267",2023-11-20,"3 - 1008",326,354,319,7,28,0.978527607361963
"5268",2023-11-20,"16 - 1022",60,60,59,1,0,0.983333333333333
"5269",2023-11-20,"24 - 1150",285,287,285,0,2,1
"5270",2023-11-20,"24 - 1153",418,420,418,0,2,1
"5271",2023-11-21,"62 - 1011",116,116,113,3,0,0.974137931034483
"5272",2023-11-21,"3 - 1008",338,354,331,7,16,0.979289940828402
"5273",2023-11-21,"16 - 1022",60,60,59,1,0,0.983333333333333
"5274",2023-11-21,"24 - 1150",285,287,285,0,2,1
"5275",2023-11-21,"24 - 1153",418,420,418,0,2,1
"5276",2023-11-22,"62 - 1011",116,116,114,2,0,0.982758620689655
"5277",2023-11-22,"3 - 1008",346,354,338,8,8,0.976878612716763
"5278",2023-11-22,"16 - 1022",60,60,58,2,0,0.966666666666667
"5279",2023-11-22,"24 - 1150",285,287,285,0,2,1
"5280",2023-11-22,"24 - 1153",418,420,418,0,2,1
"5281",2023-11-23,"62 - 1011",116,116,115,1,0,0.991379310344828
"5282",2023-11-23,"3 - 1008",346,354,341,5,8,0.985549132947977
"5283",2023-11-23,"16 - 1022",60,60,58,2,0,0.966666666666667
"5284",2023-11-23,"24 - 1150",284,287,284,0,3,1
"5285",2023-11-23,"24 - 1153",417,420,417,0,3,1
"5286",2023-11-24,"62 - 1011",116,116,115,1,0,0.991379310344828
"5287",2023-11-24,"3 - 1008",346,354,341,5,8,0.985549132947977
"5288",2023-11-24,"16 - 1022",60,60,60,0,0,1
"5289",2023-11-24,"24 - 1150",283,287,283,0,4,1
"5290",2023-11-24,"24 - 1153",417,420,417,0,3,1
"5291",2023-11-25,"62 - 1011",116,116,115,1,0,0.991379310344828
"5292",2023-11-25,"3 - 1008",346,354,342,4,8,0.988439306358382
"5293",2023-11-25,"16 - 1022",60,60,60,0,0,1
"5294",2023-11-25,"24 - 1150",284,287,284,0,3,1
"5295",2023-11-25,"24 - 1153",417,420,416,1,3,0.997601918465228
"5296",2023-11-26,"62 - 1011",116,116,115,1,0,0.991379310344828
"5297",2023-11-26,"3 - 1008",346,354,342,4,8,0.988439306358382
"5298",2023-11-26,"16 - 1022",60,60,60,0,0,1
"5299",2023-11-26,"24 - 1150",284,287,284,0,3,1
"5300",2023-11-26,"24 - 1153",417,420,417,0,3,1
"5301",2023-11-27,"62 - 1011",116,116,116,0,0,1
"5302",2023-11-27,"3 - 1008",347,354,342,5,7,0.985590778097983
"5303",2023-11-27,"16 - 1022",60,60,60,0,0,1
"5304",2023-11-27,"24 - 1150",281,287,281,0,6,1
"5305",2023-11-27,"24 - 1153",417,420,417,0,3,1
"5306",2023-11-28,"62 - 1011",116,116,114,2,0,0.982758620689655
"5307",2023-11-28,"3 - 1008",347,354,343,4,7,0.988472622478386
"5308",2023-11-28,"16 - 1022",60,60,60,0,0,1
"5309",2023-11-28,"24 - 1150",281,287,281,0,6,1
"5310",2023-11-28,"24 - 1153",416,420,416,0,4,1
"5311",2023-11-29,"62 - 1011",116,116,113,3,0,0.974137931034483
"5312",2023-11-29,"3 - 1008",346,354,343,3,8,0.991329479768786
"5313",2023-11-29,"16 - 1022",60,60,60,0,0,1
"5314",2023-11-29,"24 - 1150",281,287,281,0,6,1
"5315",2023-11-29,"24 - 1153",418,420,418,0,2,1
"5316",2023-11-30,"62 - 1011",116,116,116,0,0,1
"5317",2023-11-30,"3 - 1008",346,354,343,3,8,0.991329479768786
"5318",2023-11-30,"16 - 1022",60,60,58,2,0,0.966666666666667
"5319",2023-11-30,"24 - 1150",284,287,284,0,3,1
"5320",2023-11-30,"24 - 1153",418,420,418,0,2,1
"5321",2023-12-01,"62 - 1011",116,116,115,1,0,0.991379310344828
"5322",2023-12-01,"3 - 1008",346,354,343,3,8,0.991329479768786
"5323",2023-12-01,"16 - 1022",60,60,59,1,0,0.983333333333333
"5324",2023-12-01,"24 - 1150",283,287,283,0,4,1
"5325",2023-12-01,"24 - 1153",418,420,418,0,2,1
"5326",2023-12-02,"62 - 1011",116,116,112,4,0,0.96551724137931
"5327",2023-12-02,"3 - 1008",346,354,343,3,8,0.991329479768786
"5328",2023-12-02,"16 - 1022",60,60,57,3,0,0.95
"5329",2023-12-02,"24 - 1150",283,287,283,0,4,1
"5330",2023-12-02,"24 - 1153",418,420,418,0,2,1
"5331",2023-12-03,"62 - 1011",116,116,112,4,0,0.96551724137931
"5332",2023-12-03,"3 - 1008",346,354,343,3,8,0.991329479768786
"5333",2023-12-03,"16 - 1022",60,60,57,3,0,0.95
"5334",2023-12-03,"24 - 1150",281,287,281,0,6,1
"5335",2023-12-03,"24 - 1153",418,420,418,0,2,1
"5336",2023-12-04,"62 - 1011",116,116,114,2,0,0.982758620689655
"5337",2023-12-04,"3 - 1008",346,354,342,4,8,0.988439306358382
"5338",2023-12-04,"16 - 1022",60,60,56,4,0,0.933333333333333
"5339",2023-12-04,"24 - 1150",283,287,283,0,4,1
"5340",2023-12-04,"24 - 1153",418,420,418,0,2,1
"5341",2023-12-05,"62 - 1011",116,116,114,2,0,0.982758620689655
"5342",2023-12-05,"3 - 1008",350,354,344,6,4,0.982857142857143
"5343",2023-12-05,"16 - 1022",59,60,56,3,1,0.949152542372881
"5344",2023-12-05,"24 - 1150",285,287,285,0,2,1
"5345",2023-12-05,"24 - 1153",418,420,418,0,2,1
"5346",2023-12-06,"62 - 1011",116,116,113,3,0,0.974137931034483
"5347",2023-12-06,"3 - 1008",349,354,343,6,5,0.982808022922636
"5348",2023-12-06,"16 - 1022",59,60,56,3,1,0.949152542372881
"5349",2023-12-06,"24 - 1150",285,287,285,0,2,1
"5350",2023-12-06,"24 - 1153",418,420,418,0,2,1
"5351",2023-12-07,"62 - 1011",116,116,114,2,0,0.982758620689655
"5352",2023-12-07,"3 - 1008",348,354,342,6,6,0.982758620689655
"5353",2023-12-07,"16 - 1022",59,60,56,3,1,0.949152542372881
"5354",2023-12-07,"24 - 1150",284,287,284,0,3,1
"5355",2023-12-07,"24 - 1153",418,420,416,2,2,0.995215311004785
"5356",2023-12-08,"62 - 1011",116,116,114,2,0,0.982758620689655
"5357",2023-12-08,"3 - 1008",348,354,341,7,6,0.979885057471264
"5358",2023-12-08,"16 - 1022",59,60,56,3,1,0.949152542372881
"5359",2023-12-08,"24 - 1150",283,287,283,0,4,1
"5360",2023-12-08,"24 - 1153",418,420,418,0,2,1
"5361",2023-12-09,"62 - 1011",116,116,113,3,0,0.974137931034483
"5362",2023-12-09,"3 - 1008",348,354,341,7,6,0.979885057471264
"5363",2023-12-09,"16 - 1022",59,60,56,3,1,0.949152542372881
"5364",2023-12-09,"24 - 1150",284,287,284,0,3,1
"5365",2023-12-09,"24 - 1153",418,420,417,1,2,0.997607655502392
"5366",2023-12-10,"62 - 1011",116,116,113,3,0,0.974137931034483
"5367",2023-12-10,"3 - 1008",348,354,339,9,6,0.974137931034483
"5368",2023-12-10,"16 - 1022",59,60,56,3,1,0.949152542372881
"5369",2023-12-10,"24 - 1150",284,287,282,2,3,0.992957746478873
"5370",2023-12-10,"24 - 1153",418,420,417,1,2,0.997607655502392
"5371",2023-12-11,"62 - 1011",116,116,113,3,0,0.974137931034483
"5372",2023-12-11,"3 - 1008",348,354,342,6,6,0.982758620689655
"5373",2023-12-11,"16 - 1022",59,60,56,3,1,0.949152542372881
"5374",2023-12-11,"24 - 1150",285,287,285,0,2,1
"5375",2023-12-11,"24 - 1153",418,420,418,0,2,1
"5376",2023-12-12,"62 - 1011",116,116,112,4,0,0.96551724137931
"5377",2023-12-12,"3 - 1008",348,354,341,7,6,0.979885057471264
"5378",2023-12-12,"16 - 1022",59,60,57,2,1,0.966101694915254
"5379",2023-12-12,"24 - 1150",284,287,282,2,3,0.992957746478873
"5380",2023-12-12,"24 - 1153",418,420,418,0,2,1
"5381",2023-12-13,"62 - 1011",116,116,113,3,0,0.974137931034483
"5382",2023-12-13,"3 - 1008",345,354,339,6,9,0.982608695652174
"5383",2023-12-13,"16 - 1022",59,60,57,2,1,0.966101694915254
"5384",2023-12-13,"24 - 1150",285,287,285,0,2,1
"5385",2023-12-13,"24 - 1153",418,420,417,1,2,0.997607655502392
"5386",2023-12-14,"62 - 1011",116,116,112,4,0,0.96551724137931
"5387",2023-12-14,"3 - 1008",345,354,334,11,9,0.968115942028986
"5388",2023-12-14,"16 - 1022",59,60,57,2,1,0.966101694915254
"5389",2023-12-14,"24 - 1150",285,287,285,0,2,1
"5390",2023-12-14,"24 - 1153",418,420,418,0,2,1
"5391",2023-12-15,"62 - 1011",116,116,111,5,0,0.956896551724138
"5392",2023-12-15,"3 - 1008",345,354,338,7,9,0.979710144927536
"5393",2023-12-15,"16 - 1022",59,60,56,3,1,0.949152542372881
"5394",2023-12-15,"24 - 1150",285,287,285,0,2,1
"5395",2023-12-15,"24 - 1153",418,420,418,0,2,1
"5396",2023-12-16,"62 - 1011",116,116,111,5,0,0.956896551724138
"5397",2023-12-16,"3 - 1008",345,354,341,4,9,0.988405797101449
"5398",2023-12-16,"16 - 1022",59,60,55,4,1,0.932203389830508
"5399",2023-12-16,"24 - 1150",285,287,285,0,2,1
"5400",2023-12-16,"24 - 1153",418,420,418,0,2,1
"5401",2023-12-17,"62 - 1011",116,116,111,5,0,0.956896551724138
"5402",2023-12-17,"3 - 1008",344,354,341,3,10,0.991279069767442
"5403",2023-12-17,"16 - 1022",59,60,57,2,1,0.966101694915254
"5404",2023-12-17,"24 - 1150",284,287,284,0,3,1
"5405",2023-12-17,"24 - 1153",418,420,418,0,2,1
"5406",2023-12-18,"62 - 1011",116,116,112,4,0,0.96551724137931
"5407",2023-12-18,"3 - 1008",344,354,341,3,10,0.991279069767442
"5408",2023-12-18,"16 - 1022",59,60,58,1,1,0.983050847457627
"5409",2023-12-18,"24 - 1150",283,287,283,0,4,1
"5410",2023-12-18,"24 - 1153",418,420,418,0,2,1
"5411",2023-12-19,"62 - 1011",116,116,112,4,0,0.96551724137931
"5412",2023-12-19,"3 - 1008",343,354,342,1,11,0.997084548104956
"5413",2023-12-19,"16 - 1022",59,60,58,1,1,0.983050847457627
"5414",2023-12-19,"24 - 1150",282,287,282,0,5,1
"5415",2023-12-19,"24 - 1153",420,420,419,1,0,0.997619047619048
"5416",2023-12-20,"62 - 1011",116,116,112,4,0,0.96551724137931
"5417",2023-12-20,"3 - 1008",341,354,338,3,13,0.991202346041056
"5418",2023-12-20,"16 - 1022",59,60,59,0,1,1
"5419",2023-12-20,"24 - 1150",283,287,283,0,4,1
"5420",2023-12-20,"24 - 1153",420,420,420,0,0,1
"5421",2023-12-21,"62 - 1011",116,116,112,4,0,0.96551724137931
"5422",2023-12-21,"3 - 1008",339,354,338,1,15,0.997050147492625
"5423",2023-12-21,"16 - 1022",59,60,57,2,1,0.966101694915254
"5424",2023-12-21,"24 - 1150",281,287,281,0,6,1
"5425",2023-12-21,"24 - 1153",420,420,420,0,0,1
"5426",2023-12-22,"62 - 1011",116,116,111,5,0,0.956896551724138
"5427",2023-12-22,"3 - 1008",339,354,337,2,15,0.994100294985251
"5428",2023-12-22,"16 - 1022",60,60,58,2,0,0.966666666666667
"5429",2023-12-22,"24 - 1150",280,287,280,0,7,1
"5430",2023-12-22,"24 - 1153",420,420,419,1,0,0.997619047619048
"5431",2023-12-23,"62 - 1011",116,116,111,5,0,0.956896551724138
"5432",2023-12-23,"3 - 1008",338,354,337,1,16,0.997041420118343
"5433",2023-12-23,"16 - 1022",60,60,58,2,0,0.966666666666667
"5434",2023-12-23,"24 - 1150",278,287,278,0,9,1
"5435",2023-12-23,"24 - 1153",420,420,420,0,0,1
"5436",2023-12-24,"62 - 1011",116,116,110,6,0,0.948275862068966
"5437",2023-12-24,"3 - 1008",338,354,336,2,16,0.994082840236686
"5438",2023-12-24,"16 - 1022",60,60,57,3,0,0.95
"5439",2023-12-24,"24 - 1150",280,287,279,1,7,0.996428571428571
"5440",2023-12-24,"24 - 1153",420,420,420,0,0,1
"5441",2023-12-25,"62 - 1011",116,116,110,6,0,0.948275862068966
"5442",2023-12-25,"3 - 1008",338,354,336,2,16,0.994082840236686
"5443",2023-12-25,"16 - 1022",60,60,57,3,0,0.95
"5444",2023-12-25,"24 - 1150",280,287,280,0,7,1
"5445",2023-12-25,"24 - 1153",420,420,420,0,0,1
"5446",2023-12-26,"62 - 1011",116,116,110,6,0,0.948275862068966
"5447",2023-12-26,"3 - 1008",338,354,336,2,16,0.994082840236686
"5448",2023-12-26,"16 - 1022",60,60,57,3,0,0.95
"5449",2023-12-26,"24 - 1150",279,287,278,1,8,0.996415770609319
"5450",2023-12-26,"24 - 1153",420,420,420,0,0,1
"5451",2023-12-27,"62 - 1011",116,116,110,6,0,0.948275862068966
"5452",2023-12-27,"3 - 1008",340,354,338,2,14,0.994117647058824
"5453",2023-12-27,"16 - 1022",60,60,57,3,0,0.95
"5454",2023-12-27,"24 - 1150",280,287,279,1,7,0.996428571428571
"5455",2023-12-27,"24 - 1153",420,420,420,0,0,1
"5456",2023-12-28,"62 - 1011",116,116,108,8,0,0.931034482758621
"5457",2023-12-28,"3 - 1008",340,354,338,2,14,0.994117647058824
"5458",2023-12-28,"16 - 1022",60,60,57,3,0,0.95
"5459",2023-12-28,"24 - 1150",281,287,280,1,6,0.99644128113879
"5460",2023-12-28,"24 - 1153",420,420,420,0,0,1
"5461",2023-12-29,"62 - 1011",116,116,108,8,0,0.931034482758621
"5462",2023-12-29,"3 - 1008",340,354,338,2,14,0.994117647058824
"5463",2023-12-29,"16 - 1022",60,60,59,1,0,0.983333333333333
"5464",2023-12-29,"24 - 1150",282,287,281,1,5,0.99645390070922
"5465",2023-12-29,"24 - 1153",420,420,420,0,0,1
"5466",2023-12-30,"62 - 1011",116,116,108,8,0,0.931034482758621
"5467",2023-12-30,"3 - 1008",342,354,337,5,12,0.985380116959064
"5468",2023-12-30,"16 - 1022",60,60,59,1,0,0.983333333333333
"5469",2023-12-30,"24 - 1150",281,287,280,1,6,0.99644128113879
"5470",2023-12-30,"24 - 1153",420,420,420,0,0,1
"5471",2023-12-31,"62 - 1011",116,116,107,9,0,0.922413793103448
"5472",2023-12-31,"3 - 1008",342,354,337,5,12,0.985380116959064
"5473",2023-12-31,"16 - 1022",60,60,58,2,0,0.966666666666667
"5474",2023-12-31,"24 - 1150",281,287,280,1,6,0.99644128113879
"5475",2023-12-31,"24 - 1153",420,420,420,0,0,1
"5476",2024-01-01,"62 - 1011",116,116,107,9,0,0.922413793103448
"5477",2024-01-01,"3 - 1008",342,354,339,3,12,0.991228070175439
"5478",2024-01-01,"16 - 1022",60,60,58,2,0,0.966666666666667
"5479",2024-01-01,"24 - 1150",280,287,279,1,7,0.996428571428571
"5480",2024-01-01,"24 - 1153",420,420,420,0,0,1
"5481",2024-01-02,"62 - 1011",116,116,106,10,0,0.913793103448276
"5482",2024-01-02,"3 - 1008",344,354,339,5,10,0.98546511627907
"5483",2024-01-02,"16 - 1022",60,60,58,2,0,0.966666666666667
"5484",2024-01-02,"24 - 1150",284,287,282,2,3,0.992957746478873
"5485",2024-01-02,"24 - 1153",420,420,420,0,0,1
"5486",2024-01-03,"62 - 1011",116,116,105,11,0,0.905172413793103
"5487",2024-01-03,"3 - 1008",344,354,337,7,10,0.979651162790698
"5488",2024-01-03,"16 - 1022",60,60,58,2,0,0.966666666666667
"5489",2024-01-03,"24 - 1150",284,287,282,2,3,0.992957746478873
"5490",2024-01-03,"24 - 1153",420,420,419,1,0,0.997619047619048
"5491",2024-01-04,"62 - 1011",116,116,106,10,0,0.913793103448276
"5492",2024-01-04,"3 - 1008",344,354,335,9,10,0.973837209302326
"5493",2024-01-04,"16 - 1022",60,60,59,1,0,0.983333333333333
"5494",2024-01-04,"24 - 1150",284,287,284,0,3,1
"5495",2024-01-04,"24 - 1153",420,420,420,0,0,1
"5496",2024-01-05,"62 - 1011",116,116,109,7,0,0.939655172413793
"5497",2024-01-05,"3 - 1008",343,354,337,6,11,0.982507288629738
"5498",2024-01-05,"16 - 1022",60,60,58,2,0,0.966666666666667
"5499",2024-01-05,"24 - 1150",284,287,283,1,3,0.996478873239437
"5500",2024-01-05,"24 - 1153",420,420,420,0,0,1
"5501",2024-01-06,"62 - 1011",116,116,109,7,0,0.939655172413793
"5502",2024-01-06,"3 - 1008",343,354,337,6,11,0.982507288629738
"5503",2024-01-06,"16 - 1022",60,60,58,2,0,0.966666666666667
"5504",2024-01-06,"24 - 1150",284,287,284,0,3,1
"5505",2024-01-06,"24 - 1153",420,420,419,1,0,0.997619047619048
"5506",2024-01-07,"62 - 1011",116,116,109,7,0,0.939655172413793
"5507",2024-01-07,"3 - 1008",344,354,341,3,10,0.991279069767442
"5508",2024-01-07,"16 - 1022",60,60,58,2,0,0.966666666666667
"5509",2024-01-07,"24 - 1150",284,287,284,0,3,1
"5510",2024-01-07,"24 - 1153",420,420,420,0,0,1
"5511",2024-01-08,"62 - 1011",116,116,109,7,0,0.939655172413793
"5512",2024-01-08,"3 - 1008",344,354,342,2,10,0.994186046511628
"5513",2024-01-08,"16 - 1022",60,60,59,1,0,0.983333333333333
"5514",2024-01-08,"24 - 1150",283,287,283,0,4,1
"5515",2024-01-08,"24 - 1153",420,420,420,0,0,1
"5516",2024-01-09,"62 - 1011",116,116,110,6,0,0.948275862068966
"5517",2024-01-09,"3 - 1008",345,354,340,5,9,0.985507246376812
"5518",2024-01-09,"16 - 1022",60,60,59,1,0,0.983333333333333
"5519",2024-01-09,"24 - 1150",283,287,283,0,4,1
"5520",2024-01-09,"24 - 1153",420,420,420,0,0,1
"5521",2024-01-10,"62 - 1011",116,116,110,6,0,0.948275862068966
"5522",2024-01-10,"3 - 1008",346,354,340,6,8,0.982658959537572
"5523",2024-01-10,"16 - 1022",60,60,59,1,0,0.983333333333333
"5524",2024-01-10,"24 - 1150",283,287,283,0,4,1
"5525",2024-01-10,"24 - 1153",420,420,418,2,0,0.995238095238095
"5526",2024-01-11,"62 - 1011",116,116,110,6,0,0.948275862068966
"5527",2024-01-11,"3 - 1008",346,354,341,5,8,0.985549132947977
"5528",2024-01-11,"16 - 1022",60,60,59,1,0,0.983333333333333
"5529",2024-01-11,"24 - 1150",284,287,283,1,3,0.996478873239437
"5530",2024-01-11,"24 - 1153",420,420,420,0,0,1
"5531",2024-01-12,"62 - 1011",116,116,110,6,0,0.948275862068966
"5532",2024-01-12,"3 - 1008",346,354,341,5,8,0.985549132947977
"5533",2024-01-12,"16 - 1022",60,60,58,2,0,0.966666666666667
"5534",2024-01-12,"24 - 1150",283,287,283,0,4,1
"5535",2024-01-12,"24 - 1153",420,420,417,3,0,0.992857142857143
"5536",2024-01-13,"62 - 1011",116,116,111,5,0,0.956896551724138
"5537",2024-01-13,"3 - 1008",346,354,342,4,8,0.988439306358382
"5538",2024-01-13,"16 - 1022",60,60,58,2,0,0.966666666666667
"5539",2024-01-13,"24 - 1150",283,287,283,0,4,1
"5540",2024-01-13,"24 - 1153",420,420,420,0,0,1
"5541",2024-01-14,"62 - 1011",116,116,111,5,0,0.956896551724138
"5542",2024-01-14,"3 - 1008",346,354,343,3,8,0.991329479768786
"5543",2024-01-14,"16 - 1022",60,60,58,2,0,0.966666666666667
"5544",2024-01-14,"24 - 1150",283,287,283,0,4,1
"5545",2024-01-14,"24 - 1153",420,420,420,0,0,1
"5546",2024-01-15,"62 - 1011",116,116,110,6,0,0.948275862068966
"5547",2024-01-15,"3 - 1008",348,354,345,3,6,0.991379310344828
"5548",2024-01-15,"16 - 1022",59,60,57,2,1,0.966101694915254
"5549",2024-01-15,"24 - 1150",283,287,283,0,4,1
"5550",2024-01-15,"24 - 1153",420,420,419,1,0,0.997619047619048
"5551",2024-01-16,"62 - 1011",116,116,111,5,0,0.956896551724138
"5552",2024-01-16,"3 - 1008",348,354,345,3,6,0.991379310344828
"5553",2024-01-16,"16 - 1022",59,60,57,2,1,0.966101694915254
"5554",2024-01-16,"24 - 1150",284,287,282,2,3,0.992957746478873
"5555",2024-01-16,"24 - 1153",420,420,420,0,0,1
"5556",2024-01-17,"62 - 1011",116,116,111,5,0,0.956896551724138
"5557",2024-01-17,"3 - 1008",348,354,343,5,6,0.985632183908046
"5558",2024-01-17,"16 - 1022",59,60,57,2,1,0.966101694915254
"5559",2024-01-17,"24 - 1150",285,287,283,2,2,0.992982456140351
"5560",2024-01-17,"24 - 1153",420,420,420,0,0,1
"5561",2024-01-18,"62 - 1011",116,116,111,5,0,0.956896551724138
"5562",2024-01-18,"3 - 1008",349,354,347,2,5,0.994269340974212
"5563",2024-01-18,"16 - 1022",59,60,59,0,1,1
"5564",2024-01-18,"24 - 1150",284,287,282,2,3,0.992957746478873
"5565",2024-01-18,"24 - 1153",420,420,420,0,0,1
"5566",2024-01-19,"62 - 1011",116,116,111,5,0,0.956896551724138
"5567",2024-01-19,"3 - 1008",349,354,347,2,5,0.994269340974212
"5568",2024-01-19,"16 - 1022",59,60,59,0,1,1
"5569",2024-01-19,"24 - 1150",284,287,284,0,3,1
"5570",2024-01-19,"24 - 1153",420,420,420,0,0,1
"5571",2024-01-20,"62 - 1011",116,116,111,5,0,0.956896551724138
"5572",2024-01-20,"3 - 1008",349,354,348,1,5,0.997134670487106
"5573",2024-01-20,"16 - 1022",59,60,59,0,1,1
"5574",2024-01-20,"24 - 1150",284,287,284,0,3,1
"5575",2024-01-20,"24 - 1153",419,420,418,1,1,0.997613365155131
"5576",2024-01-21,"62 - 1011",116,116,110,6,0,0.948275862068966
"5577",2024-01-21,"3 - 1008",349,354,349,0,5,1
"5578",2024-01-21,"16 - 1022",59,60,59,0,1,1
"5579",2024-01-21,"24 - 1150",284,287,284,0,3,1
"5580",2024-01-21,"24 - 1153",420,420,420,0,0,1
"5581",2024-01-22,"62 - 1011",116,116,111,5,0,0.956896551724138
"5582",2024-01-22,"3 - 1008",349,354,348,1,5,0.997134670487106
"5583",2024-01-22,"16 - 1022",59,60,56,3,1,0.949152542372881
"5584",2024-01-22,"24 - 1150",283,287,283,0,4,1
"5585",2024-01-22,"24 - 1153",420,420,420,0,0,1
"5586",2024-01-23,"62 - 1011",116,116,112,4,0,0.96551724137931
"5587",2024-01-23,"3 - 1008",350,354,350,0,4,1
"5588",2024-01-23,"16 - 1022",59,60,57,2,1,0.966101694915254
"5589",2024-01-23,"24 - 1150",284,287,283,1,3,0.996478873239437
"5590",2024-01-23,"24 - 1153",420,420,420,0,0,1
"5591",2024-01-24,"62 - 1011",116,116,111,5,0,0.956896551724138
"5592",2024-01-24,"3 - 1008",350,354,349,1,4,0.997142857142857
"5593",2024-01-24,"16 - 1022",59,60,59,0,1,1
"5594",2024-01-24,"24 - 1150",283,287,283,0,4,1
"5595",2024-01-24,"24 - 1153",420,420,420,0,0,1
"5596",2024-01-25,"62 - 1011",116,116,110,6,0,0.948275862068966
"5597",2024-01-25,"3 - 1008",351,354,351,0,3,1
"5598",2024-01-25,"16 - 1022",59,60,59,0,1,1
"5599",2024-01-25,"24 - 1150",284,287,284,0,3,1
"5600",2024-01-25,"24 - 1153",420,420,419,1,0,0.997619047619048
"5601",2024-01-26,"62 - 1011",116,116,111,5,0,0.956896551724138
"5602",2024-01-26,"3 - 1008",350,354,350,0,4,1
"5603",2024-01-26,"16 - 1022",59,60,59,0,1,1
"5604",2024-01-26,"24 - 1150",283,287,283,0,4,1
"5605",2024-01-26,"24 - 1153",420,420,420,0,0,1
"5606",2024-01-27,"62 - 1011",116,116,110,6,0,0.948275862068966
"5607",2024-01-27,"3 - 1008",352,354,352,0,2,1
"5608",2024-01-27,"16 - 1022",59,60,58,1,1,0.983050847457627
"5609",2024-01-27,"24 - 1150",281,287,281,0,6,1
"5610",2024-01-27,"24 - 1153",420,420,420,0,0,1
"5611",2024-01-28,"62 - 1011",116,116,110,6,0,0.948275862068966
"5612",2024-01-28,"3 - 1008",352,354,352,0,2,1
"5613",2024-01-28,"16 - 1022",59,60,58,1,1,0.983050847457627
"5614",2024-01-28,"24 - 1150",284,287,284,0,3,1
"5615",2024-01-28,"24 - 1153",420,420,420,0,0,1
"5616",2024-01-29,"62 - 1011",116,116,110,6,0,0.948275862068966
"5617",2024-01-29,"3 - 1008",351,354,349,2,3,0.994301994301994
"5618",2024-01-29,"16 - 1022",59,60,58,1,1,0.983050847457627
"5619",2024-01-29,"24 - 1150",284,287,284,0,3,1
"5620",2024-01-29,"24 - 1153",420,420,420,0,0,1
"5621",2024-01-30,"62 - 1011",116,116,108,8,0,0.931034482758621
"5622",2024-01-30,"3 - 1008",347,354,346,1,7,0.997118155619596
"5623",2024-01-30,"16 - 1022",60,60,59,1,0,0.983333333333333
"5624",2024-01-30,"24 - 1150",285,287,285,0,2,1
"5625",2024-01-30,"24 - 1153",419,420,419,0,1,1
"5626",2024-01-31,"62 - 1011",116,116,109,7,0,0.939655172413793
"5627",2024-01-31,"3 - 1008",347,354,346,1,7,0.997118155619596
"5628",2024-01-31,"16 - 1022",60,60,58,2,0,0.966666666666667
"5629",2024-01-31,"24 - 1150",281,287,281,0,6,1
"5630",2024-01-31,"24 - 1153",420,420,420,0,0,1
"5631",2024-02-01,"62 - 1011",116,116,109,7,0,0.939655172413793
"5632",2024-02-01,"3 - 1008",347,354,344,3,7,0.99135446685879
"5633",2024-02-01,"16 - 1022",60,60,58,2,0,0.966666666666667
"5634",2024-02-01,"24 - 1150",281,287,280,1,6,0.99644128113879
"5635",2024-02-01,"24 - 1153",417,420,416,1,3,0.997601918465228
"5636",2024-02-02,"62 - 1011",116,116,109,7,0,0.939655172413793
"5637",2024-02-02,"3 - 1008",343,354,339,4,11,0.988338192419825
"5638",2024-02-02,"16 - 1022",60,60,57,3,0,0.95
"5639",2024-02-02,"24 - 1150",278,287,276,2,9,0.992805755395683
"5640",2024-02-02,"24 - 1153",414,420,414,0,6,1
"5641",2024-02-03,"62 - 1011",116,116,109,7,0,0.939655172413793
"5642",2024-02-03,"3 - 1008",343,354,341,2,11,0.994169096209913
"5643",2024-02-03,"16 - 1022",60,60,57,3,0,0.95
"5644",2024-02-03,"24 - 1150",283,287,278,5,4,0.982332155477032
"5645",2024-02-03,"24 - 1153",413,420,413,0,7,1
"5646",2024-02-04,"62 - 1011",116,116,109,7,0,0.939655172413793
"5647",2024-02-04,"3 - 1008",343,354,341,2,11,0.994169096209913
"5648",2024-02-04,"16 - 1022",60,60,57,3,0,0.95
"5649",2024-02-04,"24 - 1150",285,287,283,2,2,0.992982456140351
"5650",2024-02-04,"24 - 1153",411,414,411,0,3,1
"5651",2024-02-05,"62 - 1011",116,116,110,6,0,0.948275862068966
"5652",2024-02-05,"3 - 1008",347,354,346,1,7,0.997118155619596
"5653",2024-02-05,"16 - 1022",60,60,58,2,0,0.966666666666667
"5654",2024-02-05,"24 - 1150",285,287,285,0,2,1
"5655",2024-02-05,"24 - 1153",420,420,420,0,0,1
"5656",2024-02-06,"62 - 1011",116,116,111,5,0,0.956896551724138
"5657",2024-02-06,"3 - 1008",348,354,346,2,6,0.994252873563218
"5658",2024-02-06,"16 - 1022",60,60,59,1,0,0.983333333333333
"5659",2024-02-06,"24 - 1150",283,287,283,0,4,1
"5660",2024-02-06,"24 - 1153",419,420,419,0,1,1
"5661",2024-02-07,"62 - 1011",116,116,114,2,0,0.982758620689655
"5662",2024-02-07,"3 - 1008",346,354,345,1,8,0.997109826589595
"5663",2024-02-07,"16 - 1022",60,60,57,3,0,0.95
"5664",2024-02-07,"24 - 1150",285,287,283,2,2,0.992982456140351
"5665",2024-02-07,"24 - 1153",419,420,419,0,1,1
"5666",2024-02-08,"62 - 1011",116,116,111,5,0,0.956896551724138
"5667",2024-02-08,"3 - 1008",347,354,344,3,7,0.99135446685879
"5668",2024-02-08,"16 - 1022",60,60,58,2,0,0.966666666666667
"5669",2024-02-08,"24 - 1150",284,287,284,0,3,1
"5670",2024-02-08,"24 - 1153",417,420,417,0,3,1
"5671",2024-02-09,"62 - 1011",116,116,111,5,0,0.956896551724138
"5672",2024-02-09,"3 - 1008",347,354,344,3,7,0.99135446685879
"5673",2024-02-09,"16 - 1022",60,60,60,0,0,1
"5674",2024-02-09,"24 - 1150",283,287,283,0,4,1
"5675",2024-02-09,"24 - 1153",416,420,416,0,4,1
"5676",2024-02-10,"62 - 1011",116,116,109,7,0,0.939655172413793
"5677",2024-02-10,"3 - 1008",347,354,345,2,7,0.994236311239193
"5678",2024-02-10,"16 - 1022",60,60,58,2,0,0.966666666666667
"5679",2024-02-10,"24 - 1150",285,287,283,2,2,0.992982456140351
"5680",2024-02-10,"24 - 1153",416,420,416,0,4,1
"5681",2024-02-11,"62 - 1011",116,116,109,7,0,0.939655172413793
"5682",2024-02-11,"3 - 1008",347,354,345,2,7,0.994236311239193
"5683",2024-02-11,"16 - 1022",60,60,58,2,0,0.966666666666667
"5684",2024-02-11,"24 - 1150",285,287,285,0,2,1
"5685",2024-02-11,"24 - 1153",416,420,416,0,4,1
"5686",2024-02-12,"62 - 1011",116,116,109,7,0,0.939655172413793
"5687",2024-02-12,"3 - 1008",346,354,344,2,8,0.994219653179191
"5688",2024-02-12,"16 - 1022",60,60,57,3,0,0.95
"5689",2024-02-12,"24 - 1150",284,287,284,0,3,1
"5690",2024-02-12,"24 - 1153",413,420,413,0,7,1
"5691",2024-02-13,"62 - 1011",116,116,108,8,0,0.931034482758621
"5692",2024-02-13,"3 - 1008",346,354,345,1,8,0.997109826589595
"5693",2024-02-13,"16 - 1022",60,60,58,2,0,0.966666666666667
"5694",2024-02-13,"24 - 1150",284,287,283,1,3,0.996478873239437
"5695",2024-02-13,"24 - 1153",410,410,410,0,0,1
"5696",2024-02-14,"62 - 1011",116,116,107,9,0,0.922413793103448
"5697",2024-02-14,"3 - 1008",347,354,346,1,7,0.997118155619596
"5698",2024-02-14,"16 - 1022",60,60,58,2,0,0.966666666666667
"5699",2024-02-14,"24 - 1150",281,287,281,0,6,1
"5700",2024-02-14,"24 - 1153",419,420,419,0,1,1
"5701",2024-02-15,"62 - 1011",116,116,107,9,0,0.922413793103448
"5702",2024-02-15,"3 - 1008",348,354,347,1,6,0.997126436781609
"5703",2024-02-15,"16 - 1022",60,60,58,2,0,0.966666666666667
"5704",2024-02-15,"24 - 1150",281,287,281,0,6,1
"5705",2024-02-15,"24 - 1153",420,420,420,0,0,1
"5706",2024-02-16,"62 - 1011",116,116,107,9,0,0.922413793103448
"5707",2024-02-16,"3 - 1008",348,354,345,3,6,0.991379310344828
"5708",2024-02-16,"16 - 1022",60,60,58,2,0,0.966666666666667
"5709",2024-02-16,"24 - 1150",282,287,281,1,5,0.99645390070922
"5710",2024-02-16,"24 - 1153",420,420,420,0,0,1
"5711",2024-02-17,"62 - 1011",116,116,108,8,0,0.931034482758621
"5712",2024-02-17,"3 - 1008",349,354,347,2,5,0.994269340974212
"5713",2024-02-17,"16 - 1022",60,60,58,2,0,0.966666666666667
"5714",2024-02-17,"24 - 1150",281,287,281,0,6,1
"5715",2024-02-17,"24 - 1153",419,420,419,0,1,1
"5716",2024-02-18,"62 - 1011",116,116,108,8,0,0.931034482758621
"5717",2024-02-18,"3 - 1008",349,354,347,2,5,0.994269340974212
"5718",2024-02-18,"16 - 1022",60,60,57,3,0,0.95
"5719",2024-02-18,"24 - 1150",282,287,282,0,5,1
"5720",2024-02-18,"24 - 1153",420,420,420,0,0,1
"5721",2024-02-19,"62 - 1011",116,116,111,5,0,0.956896551724138
"5722",2024-02-19,"3 - 1008",349,354,345,4,5,0.988538681948424
"5723",2024-02-19,"16 - 1022",60,60,57,3,0,0.95
"5724",2024-02-19,"24 - 1150",282,287,281,1,5,0.99645390070922
"5725",2024-02-19,"24 - 1153",420,420,420,0,0,1
"5726",2024-02-20,"62 - 1011",116,116,112,4,0,0.96551724137931
"5727",2024-02-20,"3 - 1008",349,354,348,1,5,0.997134670487106
"5728",2024-02-20,"16 - 1022",60,60,56,4,0,0.933333333333333
"5729",2024-02-20,"24 - 1150",280,287,280,0,7,1
"5730",2024-02-20,"24 - 1153",420,420,420,0,0,1
"5731",2024-02-21,"62 - 1011",116,116,111,5,0,0.956896551724138
"5732",2024-02-21,"3 - 1008",349,354,348,1,5,0.997134670487106
"5733",2024-02-21,"16 - 1022",60,60,57,3,0,0.95
"5734",2024-02-21,"24 - 1150",281,287,281,0,6,1
"5735",2024-02-21,"24 - 1153",420,420,420,0,0,1
"5736",2024-02-22,"62 - 1011",116,116,109,7,0,0.939655172413793
"5737",2024-02-22,"3 - 1008",350,354,349,1,4,0.997142857142857
"5738",2024-02-22,"16 - 1022",60,60,58,2,0,0.966666666666667
"5739",2024-02-22,"24 - 1150",282,287,281,1,5,0.99645390070922
"5740",2024-02-22,"24 - 1153",420,420,420,0,0,1
"5741",2024-02-23,"62 - 1011",116,116,108,8,0,0.931034482758621
"5742",2024-02-23,"3 - 1008",350,354,349,1,4,0.997142857142857
"5743",2024-02-23,"16 - 1022",60,60,59,1,0,0.983333333333333
"5744",2024-02-23,"24 - 1150",282,287,281,1,5,0.99645390070922
"5745",2024-02-23,"24 - 1153",420,420,420,0,0,1
"5746",2024-02-24,"62 - 1011",116,116,108,8,0,0.931034482758621
"5747",2024-02-24,"3 - 1008",350,354,348,2,4,0.994285714285714
"5748",2024-02-24,"16 - 1022",60,60,58,2,0,0.966666666666667
"5749",2024-02-24,"24 - 1150",282,287,282,0,5,1
"5750",2024-02-24,"24 - 1153",420,420,420,0,0,1
"5751",2024-02-25,"62 - 1011",116,116,108,8,0,0.931034482758621
"5752",2024-02-25,"3 - 1008",348,354,347,1,6,0.997126436781609
"5753",2024-02-25,"16 - 1022",60,60,58,2,0,0.966666666666667
"5754",2024-02-25,"24 - 1150",281,287,281,0,6,1
"5755",2024-02-25,"24 - 1153",420,420,420,0,0,1
"5756",2024-02-26,"62 - 1011",116,116,108,8,0,0.931034482758621
"5757",2024-02-26,"3 - 1008",349,354,348,1,5,0.997134670487106
"5758",2024-02-26,"16 - 1022",60,60,59,1,0,0.983333333333333
"5759",2024-02-26,"24 - 1150",281,287,281,0,6,1
"5760",2024-02-26,"24 - 1153",420,420,420,0,0,1
"5761",2024-02-27,"62 - 1011",116,116,108,8,0,0.931034482758621
"5762",2024-02-27,"3 - 1008",349,354,346,3,5,0.991404011461318
"5763",2024-02-27,"16 - 1022",60,60,60,0,0,1
"5764",2024-02-27,"24 - 1150",282,287,282,0,5,1
"5765",2024-02-27,"24 - 1153",420,420,420,0,0,1
"5766",2024-02-28,"62 - 1011",116,116,107,9,0,0.922413793103448
"5767",2024-02-28,"3 - 1008",349,354,346,3,5,0.991404011461318
"5768",2024-02-28,"16 - 1022",60,60,59,1,0,0.983333333333333
"5769",2024-02-28,"24 - 1150",283,287,283,0,4,1
"5770",2024-02-28,"24 - 1153",420,420,420,0,0,1
"5771",2024-02-29,"62 - 1011",116,116,108,8,0,0.931034482758621
"5772",2024-02-29,"3 - 1008",349,354,348,1,5,0.997134670487106
"5773",2024-02-29,"16 - 1022",60,60,59,1,0,0.983333333333333
"5774",2024-02-29,"24 - 1150",284,287,284,0,3,1
"5775",2024-02-29,"24 - 1153",420,420,420,0,0,1
"5776",2024-03-01,"62 - 1011",116,116,108,8,0,0.931034482758621
"5777",2024-03-01,"3 - 1008",349,354,348,1,5,0.997134670487106
"5778",2024-03-01,"16 - 1022",60,60,59,1,0,0.983333333333333
"5779",2024-03-01,"24 - 1150",282,287,282,0,5,1
"5780",2024-03-01,"24 - 1153",418,420,417,1,2,0.997607655502392
"5781",2024-03-02,"62 - 1011",116,116,108,8,0,0.931034482758621
"5782",2024-03-02,"3 - 1008",349,354,348,1,5,0.997134670487106
"5783",2024-03-02,"16 - 1022",60,60,58,2,0,0.966666666666667
"5784",2024-03-02,"24 - 1150",284,287,284,0,3,1
"5785",2024-03-02,"24 - 1153",418,420,418,0,2,1
"5786",2024-03-03,"62 - 1011",116,116,109,7,0,0.939655172413793
"5787",2024-03-03,"3 - 1008",351,354,350,1,3,0.997150997150997
"5788",2024-03-03,"16 - 1022",60,60,58,2,0,0.966666666666667
"5789",2024-03-03,"24 - 1150",284,287,284,0,3,1
"5790",2024-03-03,"24 - 1153",418,420,418,0,2,1
"5791",2024-03-04,"62 - 1011",116,116,110,6,0,0.948275862068966
"5792",2024-03-04,"3 - 1008",352,354,350,2,2,0.994318181818182
"5793",2024-03-04,"16 - 1022",60,60,58,2,0,0.966666666666667
"5794",2024-03-04,"24 - 1150",284,287,284,0,3,1
"5795",2024-03-04,"24 - 1153",418,420,417,1,2,0.997607655502392
"5796",2024-03-05,"62 - 1011",116,116,110,6,0,0.948275862068966
"5797",2024-03-05,"3 - 1008",350,354,349,1,4,0.997142857142857
"5798",2024-03-05,"16 - 1022",68,81,64,4,13,0.941176470588235
"5799",2024-03-05,"24 - 1150",284,287,284,0,3,1
"5800",2024-03-05,"24 - 1153",417,420,417,0,3,1
"5801",2024-03-06,"62 - 1011",116,116,111,5,0,0.956896551724138
"5802",2024-03-06,"3 - 1008",349,354,348,1,5,0.997134670487106
"5803",2024-03-06,"16 - 1022",76,81,71,5,5,0.93421052631579
"5804",2024-03-06,"24 - 1150",284,287,284,0,3,1
"5805",2024-03-06,"24 - 1153",420,420,420,0,0,1
"5806",2024-03-07,"62 - 1011",116,116,112,4,0,0.96551724137931
"5807",2024-03-07,"3 - 1008",347,354,342,5,7,0.985590778097983
"5808",2024-03-07,"16 - 1022",81,81,76,5,0,0.938271604938272
"5809",2024-03-07,"24 - 1150",284,287,282,2,3,0.992957746478873
"5810",2024-03-07,"24 - 1153",420,420,420,0,0,1
"5811",2024-03-08,"62 - 1011",116,116,114,2,0,0.982758620689655
"5812",2024-03-08,"3 - 1008",347,354,344,3,7,0.99135446685879
"5813",2024-03-08,"16 - 1022",81,81,77,4,0,0.950617283950617
"5814",2024-03-08,"24 - 1150",282,287,282,0,5,1
"5815",2024-03-08,"24 - 1153",420,420,420,0,0,1
"5816",2024-03-09,"62 - 1011",116,116,114,2,0,0.982758620689655
"5817",2024-03-09,"3 - 1008",347,354,345,2,7,0.994236311239193
"5818",2024-03-09,"16 - 1022",81,81,76,5,0,0.938271604938272
"5819",2024-03-09,"24 - 1150",280,287,280,0,7,1
"5820",2024-03-09,"24 - 1153",420,420,420,0,0,1
"5821",2024-03-10,"62 - 1011",116,116,114,2,0,0.982758620689655
"5822",2024-03-10,"3 - 1008",347,354,345,2,7,0.994236311239193
"5823",2024-03-10,"16 - 1022",81,81,75,6,0,0.925925925925926
"5824",2024-03-10,"24 - 1150",280,287,279,1,7,0.996428571428571
"5825",2024-03-10,"24 - 1153",420,420,420,0,0,1
"5826",2024-03-11,"62 - 1011",116,116,115,1,0,0.991379310344828
"5827",2024-03-11,"3 - 1008",350,354,345,5,4,0.985714285714286
"5828",2024-03-11,"16 - 1022",81,81,74,7,0,0.91358024691358
"5829",2024-03-11,"24 - 1150",279,287,279,0,8,1
"5830",2024-03-11,"24 - 1153",420,420,420,0,0,1
"5831",2024-03-12,"62 - 1011",116,116,115,1,0,0.991379310344828
"5832",2024-03-12,"3 - 1008",350,354,346,4,4,0.988571428571429
"5833",2024-03-12,"16 - 1022",81,81,75,6,0,0.925925925925926
"5834",2024-03-12,"24 - 1150",279,287,279,0,8,1
"5835",2024-03-12,"24 - 1153",420,420,420,0,0,1
"5836",2024-03-13,"62 - 1011",116,116,116,0,0,1
"5837",2024-03-13,"3 - 1008",349,354,346,3,5,0.991404011461318
"5838",2024-03-13,"16 - 1022",81,81,76,5,0,0.938271604938272
"5839",2024-03-13,"24 - 1150",279,287,278,1,8,0.996415770609319
"5840",2024-03-13,"24 - 1153",418,420,418,0,2,1
"5841",2024-03-14,"62 - 1011",116,116,115,1,0,0.991379310344828
"5842",2024-03-14,"3 - 1008",349,354,344,5,5,0.98567335243553
"5843",2024-03-14,"16 - 1022",81,81,76,5,0,0.938271604938272
"5844",2024-03-14,"24 - 1150",284,287,282,2,3,0.992957746478873
"5845",2024-03-14,"24 - 1153",418,420,418,0,2,1
"5846",2024-03-15,"62 - 1011",116,116,116,0,0,1
"5847",2024-03-15,"3 - 1008",349,354,344,5,5,0.98567335243553
"5848",2024-03-15,"16 - 1022",81,81,78,3,0,0.962962962962963
"5849",2024-03-15,"24 - 1150",284,287,284,0,3,1
"5850",2024-03-15,"24 - 1153",418,420,418,0,2,1
"5851",2024-03-16,"62 - 1011",116,116,116,0,0,1
"5852",2024-03-16,"3 - 1008",349,354,343,6,5,0.982808022922636
"5853",2024-03-16,"16 - 1022",81,81,78,3,0,0.962962962962963
"5854",2024-03-16,"24 - 1150",284,287,284,0,3,1
"5855",2024-03-16,"24 - 1153",418,420,418,0,2,1
"5856",2024-03-17,"62 - 1011",116,116,116,0,0,1
"5857",2024-03-17,"3 - 1008",349,354,341,8,5,0.977077363896848
"5858",2024-03-17,"16 - 1022",81,81,78,3,0,0.962962962962963
"5859",2024-03-17,"24 - 1150",284,287,284,0,3,1
"5860",2024-03-17,"24 - 1153",417,420,417,0,3,1
"5861",2024-03-18,"62 - 1011",116,116,116,0,0,1
"5862",2024-03-18,"3 - 1008",351,354,343,8,3,0.977207977207977
"5863",2024-03-18,"16 - 1022",81,81,76,5,0,0.938271604938272
"5864",2024-03-18,"24 - 1150",284,287,284,0,3,1
"5865",2024-03-18,"24 - 1153",419,420,419,0,1,1
"5866",2024-03-19,"62 - 1011",116,116,116,0,0,1
"5867",2024-03-19,"3 - 1008",349,354,346,3,5,0.991404011461318
"5868",2024-03-19,"16 - 1022",81,81,78,3,0,0.962962962962963
"5869",2024-03-19,"24 - 1150",284,287,283,1,3,0.996478873239437
"5870",2024-03-19,"24 - 1153",420,420,420,0,0,1
"5871",2024-03-20,"62 - 1011",116,116,116,0,0,1
"5872",2024-03-20,"3 - 1008",349,354,346,3,5,0.991404011461318
"5873",2024-03-20,"16 - 1022",81,81,80,1,0,0.987654320987654
"5874",2024-03-20,"24 - 1150",284,287,284,0,3,1
"5875",2024-03-20,"24 - 1153",419,420,419,0,1,1
"5876",2024-03-21,"62 - 1011",116,116,116,0,0,1
"5877",2024-03-21,"3 - 1008",350,354,348,2,4,0.994285714285714
"5878",2024-03-21,"16 - 1022",81,81,79,2,0,0.975308641975309
"5879",2024-03-21,"24 - 1150",284,287,284,0,3,1
"5880",2024-03-21,"24 - 1153",418,420,418,0,2,1
"5881",2024-03-22,"62 - 1011",116,116,116,0,0,1
"5882",2024-03-22,"3 - 1008",350,354,348,2,4,0.994285714285714
"5883",2024-03-22,"16 - 1022",81,81,81,0,0,1
"5884",2024-03-22,"24 - 1150",283,287,282,1,4,0.996466431095406
"5885",2024-03-22,"24 - 1153",418,420,418,0,2,1
"5886",2024-03-23,"62 - 1011",116,116,116,0,0,1
"5887",2024-03-23,"3 - 1008",350,354,348,2,4,0.994285714285714
"5888",2024-03-23,"16 - 1022",81,81,81,0,0,1
"5889",2024-03-23,"24 - 1150",282,287,282,0,5,1
"5890",2024-03-23,"24 - 1153",420,420,420,0,0,1
"5891",2024-03-24,"62 - 1011",116,116,116,0,0,1
"5892",2024-03-24,"3 - 1008",349,354,347,2,5,0.994269340974212
"5893",2024-03-24,"16 - 1022",80,81,79,1,1,0.9875
"5894",2024-03-24,"24 - 1150",283,287,283,0,4,1
"5895",2024-03-24,"24 - 1153",420,420,420,0,0,1
"5896",2024-03-25,"62 - 1011",116,116,116,0,0,1
"5897",2024-03-25,"3 - 1008",348,354,345,3,6,0.991379310344828
"5898",2024-03-25,"16 - 1022",80,81,79,1,1,0.9875
"5899",2024-03-25,"24 - 1150",283,287,283,0,4,1
"5900",2024-03-25,"24 - 1153",420,420,420,0,0,1
"5901",2024-03-26,"62 - 1011",116,116,116,0,0,1
"5902",2024-03-26,"3 - 1008",347,354,342,5,7,0.985590778097983
"5903",2024-03-26,"16 - 1022",80,81,79,1,1,0.9875
"5904",2024-03-26,"24 - 1150",283,287,283,0,4,1
"5905",2024-03-26,"24 - 1153",420,420,420,0,0,1
"5906",2024-03-27,"62 - 1011",116,116,116,0,0,1
"5907",2024-03-27,"3 - 1008",347,354,343,4,7,0.988472622478386
"5908",2024-03-27,"16 - 1022",81,81,80,1,0,0.987654320987654
"5909",2024-03-27,"24 - 1150",283,287,282,1,4,0.996466431095406
"5910",2024-03-27,"24 - 1153",420,420,419,1,0,0.997619047619048
"5911",2024-03-28,"62 - 1011",116,116,116,0,0,1
"5912",2024-03-28,"3 - 1008",347,354,344,3,7,0.99135446685879
"5913",2024-03-28,"16 - 1022",81,81,80,1,0,0.987654320987654
"5914",2024-03-28,"24 - 1150",284,287,283,1,3,0.996478873239437
"5915",2024-03-28,"24 - 1153",420,420,420,0,0,1
"5916",2024-03-29,"62 - 1011",116,116,116,0,0,1
"5917",2024-03-29,"3 - 1008",347,354,343,4,7,0.988472622478386
"5918",2024-03-29,"16 - 1022",81,81,76,5,0,0.938271604938272
"5919",2024-03-29,"24 - 1150",284,287,284,0,3,1
"5920",2024-03-29,"24 - 1153",420,420,420,0,0,1
"5921",2024-03-30,"62 - 1011",116,116,115,1,0,0.991379310344828
"5922",2024-03-30,"3 - 1008",347,354,342,5,7,0.985590778097983
"5923",2024-03-30,"16 - 1022",81,81,76,5,0,0.938271604938272
"5924",2024-03-30,"24 - 1150",284,287,284,0,3,1
"5925",2024-03-30,"24 - 1153",420,420,420,0,0,1
"5926",2024-03-31,"62 - 1011",116,116,114,2,0,0.982758620689655
"5927",2024-03-31,"3 - 1008",347,354,343,4,7,0.988472622478386
"5928",2024-03-31,"16 - 1022",81,81,76,5,0,0.938271604938272
"5929",2024-03-31,"24 - 1150",284,287,284,0,3,1
"5930",2024-03-31,"24 - 1153",420,420,420,0,0,1
"5931",2024-04-01,"62 - 1011",116,116,115,1,0,0.991379310344828
"5932",2024-04-01,"3 - 1008",347,354,342,5,7,0.985590778097983
"5933",2024-04-01,"16 - 1022",81,81,78,3,0,0.962962962962963
"5934",2024-04-01,"24 - 1150",284,287,284,0,3,1
"5935",2024-04-01,"24 - 1153",419,420,419,0,1,1
"5936",2024-04-02,"62 - 1011",116,116,116,0,0,1
"5937",2024-04-02,"3 - 1008",347,354,343,4,7,0.988472622478386
"5938",2024-04-02,"16 - 1022",81,81,80,1,0,0.987654320987654
"5939",2024-04-02,"24 - 1150",282,287,282,0,5,1
"5940",2024-04-02,"24 - 1153",420,420,420,0,0,1
"5941",2024-04-03,"62 - 1011",116,116,113,3,0,0.974137931034483
"5942",2024-04-03,"3 - 1008",349,354,343,6,5,0.982808022922636
"5943",2024-04-03,"16 - 1022",81,81,80,1,0,0.987654320987654
"5944",2024-04-03,"24 - 1150",278,287,278,0,9,1
"5945",2024-04-03,"24 - 1153",420,420,420,0,0,1
"5946",2024-04-04,"62 - 1011",116,116,116,0,0,1
"5947",2024-04-04,"3 - 1008",349,354,343,6,5,0.982808022922636
"5948",2024-04-04,"16 - 1022",81,81,80,1,0,0.987654320987654
"5949",2024-04-04,"24 - 1150",278,287,278,0,9,1
"5950",2024-04-04,"24 - 1153",420,420,419,1,0,0.997619047619048
"5951",2024-04-05,"62 - 1011",116,116,116,0,0,1
"5952",2024-04-05,"3 - 1008",349,354,344,5,5,0.98567335243553
"5953",2024-04-05,"16 - 1022",81,81,80,1,0,0.987654320987654
"5954",2024-04-05,"24 - 1150",274,287,273,1,13,0.996350364963504
"5955",2024-04-05,"24 - 1153",419,420,419,0,1,1
"5956",2024-04-06,"62 - 1011",116,116,116,0,0,1
"5957",2024-04-06,"3 - 1008",349,354,344,5,5,0.98567335243553
"5958",2024-04-06,"16 - 1022",81,81,80,1,0,0.987654320987654
"5959",2024-04-06,"24 - 1150",273,287,273,0,14,1
"5960",2024-04-06,"24 - 1153",419,420,419,0,1,1
"5961",2024-04-07,"62 - 1011",116,116,116,0,0,1
"5962",2024-04-07,"3 - 1008",349,354,344,5,5,0.98567335243553
"5963",2024-04-07,"16 - 1022",81,81,80,1,0,0.987654320987654
"5964",2024-04-07,"24 - 1150",273,287,273,0,14,1
"5965",2024-04-07,"24 - 1153",419,420,419,0,1,1
"5966",2024-04-08,"62 - 1011",116,116,116,0,0,1
"5967",2024-04-08,"3 - 1008",348,354,342,6,6,0.982758620689655
"5968",2024-04-08,"16 - 1022",81,81,79,2,0,0.975308641975309
"5969",2024-04-08,"24 - 1150",267,287,267,0,20,1
"5970",2024-04-08,"24 - 1153",419,420,419,0,1,1
"5971",2024-04-09,"62 - 1011",116,116,116,0,0,1
"5972",2024-04-09,"3 - 1008",347,354,343,4,7,0.988472622478386
"5973",2024-04-09,"16 - 1022",81,81,80,1,0,0.987654320987654
"5974",2024-04-09,"24 - 1150",259,287,258,1,28,0.996138996138996
"5975",2024-04-09,"24 - 1153",419,420,419,0,1,1
"5976",2024-04-10,"62 - 1011",116,116,115,1,0,0.991379310344828
"5977",2024-04-10,"3 - 1008",347,354,341,6,7,0.982708933717579
"5978",2024-04-10,"16 - 1022",81,81,80,1,0,0.987654320987654
"5979",2024-04-10,"24 - 1150",248,287,248,0,39,1
"5980",2024-04-10,"24 - 1153",420,420,420,0,0,1
"5981",2024-04-11,"62 - 1011",116,116,116,0,0,1
"5982",2024-04-11,"3 - 1008",345,354,339,6,9,0.982608695652174
"5983",2024-04-11,"16 - 1022",81,81,80,1,0,0.987654320987654
"5984",2024-04-11,"24 - 1150",246,287,246,0,41,1
"5985",2024-04-11,"24 - 1153",419,420,419,0,1,1
"5986",2024-04-12,"62 - 1011",116,116,115,1,0,0.991379310344828
"5987",2024-04-12,"3 - 1008",344,354,338,6,10,0.982558139534884
"5988",2024-04-12,"16 - 1022",81,81,80,1,0,0.987654320987654
"5989",2024-04-12,"24 - 1150",253,287,253,0,34,1
"5990",2024-04-12,"24 - 1153",417,420,416,1,3,0.997601918465228
"5991",2024-04-13,"62 - 1011",116,116,115,1,0,0.991379310344828
"5992",2024-04-13,"3 - 1008",344,354,338,6,10,0.982558139534884
"5993",2024-04-13,"16 - 1022",81,81,80,1,0,0.987654320987654
"5994",2024-04-13,"24 - 1150",255,287,255,0,32,1
"5995",2024-04-13,"24 - 1153",417,420,417,0,3,1
"5996",2024-04-14,"62 - 1011",116,116,115,1,0,0.991379310344828
"5997",2024-04-14,"3 - 1008",344,354,338,6,10,0.982558139534884
"5998",2024-04-14,"16 - 1022",81,81,80,1,0,0.987654320987654
"5999",2024-04-14,"24 - 1150",254,287,254,0,33,1
"6000",2024-04-14,"24 - 1153",417,420,417,0,3,1
"6001",2024-04-15,"62 - 1011",116,116,116,0,0,1
"6002",2024-04-15,"3 - 1008",346,354,339,7,8,0.979768786127168
"6003",2024-04-15,"16 - 1022",81,81,79,2,0,0.975308641975309
"6004",2024-04-15,"24 - 1150",256,287,256,0,31,1
"6005",2024-04-15,"24 - 1153",419,420,419,0,1,1
"6006",2024-04-16,"62 - 1011",116,116,115,1,0,0.991379310344828
"6007",2024-04-16,"3 - 1008",346,354,341,5,8,0.985549132947977
"6008",2024-04-16,"16 - 1022",81,81,79,2,0,0.975308641975309
"6009",2024-04-16,"24 - 1150",255,287,255,0,32,1
"6010",2024-04-16,"24 - 1153",420,420,420,0,0,1
"6011",2024-04-17,"62 - 1011",116,116,115,1,0,0.991379310344828
"6012",2024-04-17,"3 - 1008",346,354,340,6,8,0.982658959537572
"6013",2024-04-17,"16 - 1022",81,81,78,3,0,0.962962962962963
"6014",2024-04-17,"24 - 1150",250,287,250,0,37,1
"6015",2024-04-17,"24 - 1153",419,420,418,1,1,0.997613365155131
"6016",2024-04-18,"62 - 1011",116,116,116,0,0,1
"6017",2024-04-18,"3 - 1008",347,354,342,5,7,0.985590778097983
"6018",2024-04-18,"16 - 1022",81,81,79,2,0,0.975308641975309
"6019",2024-04-18,"24 - 1150",249,287,249,0,38,1
"6020",2024-04-18,"24 - 1153",417,420,417,0,3,1
"6021",2024-04-19,"62 - 1011",116,116,116,0,0,1
"6022",2024-04-19,"3 - 1008",347,354,343,4,7,0.988472622478386
"6023",2024-04-19,"16 - 1022",81,81,80,1,0,0.987654320987654
"6024",2024-04-19,"24 - 1150",254,287,250,4,33,0.984251968503937
"6025",2024-04-19,"24 - 1153",415,420,415,0,5,1
"6026",2024-04-20,"62 - 1011",116,116,116,0,0,1
"6027",2024-04-20,"3 - 1008",348,354,344,4,6,0.988505747126437
"6028",2024-04-20,"16 - 1022",81,81,80,1,0,0.987654320987654
"6029",2024-04-20,"24 - 1150",252,287,252,0,35,1
"6030",2024-04-20,"24 - 1153",415,420,415,0,5,1
"6031",2024-04-21,"62 - 1011",116,116,116,0,0,1
"6032",2024-04-21,"3 - 1008",350,354,347,3,4,0.991428571428571
"6033",2024-04-21,"16 - 1022",81,81,80,1,0,0.987654320987654
"6034",2024-04-21,"24 - 1150",252,287,252,0,35,1
"6035",2024-04-21,"24 - 1153",415,420,415,0,5,1
"6036",2024-04-22,"62 - 1011",116,116,116,0,0,1
"6037",2024-04-22,"3 - 1008",351,354,347,4,3,0.988603988603989
"6038",2024-04-22,"16 - 1022",81,81,80,1,0,0.987654320987654
"6039",2024-04-22,"24 - 1150",258,287,256,2,29,0.992248062015504
"6040",2024-04-22,"24 - 1153",412,416,412,0,4,1
"6041",2024-04-23,"62 - 1011",116,116,116,0,0,1
"6042",2024-04-23,"3 - 1008",350,354,348,2,4,0.994285714285714
"6043",2024-04-23,"16 - 1022",81,81,79,2,0,0.975308641975309
"6044",2024-04-23,"24 - 1150",260,287,255,5,27,0.980769230769231
"6045",2024-04-23,"24 - 1153",412,416,412,0,4,1
"6046",2024-04-24,"62 - 1011",116,116,116,0,0,1
"6047",2024-04-24,"3 - 1008",351,354,348,3,3,0.991452991452991
"6048",2024-04-24,"16 - 1022",81,81,79,2,0,0.975308641975309
"6049",2024-04-24,"24 - 1150",261,287,261,0,26,1
"6050",2024-04-24,"24 - 1153",415,420,415,0,5,1
"6051",2024-04-25,"62 - 1011",116,116,116,0,0,1
"6052",2024-04-25,"3 - 1008",347,354,345,2,7,0.994236311239193
"6053",2024-04-25,"16 - 1022",81,81,80,1,0,0.987654320987654
"6054",2024-04-25,"24 - 1150",263,287,259,4,24,0.984790874524715
"6055",2024-04-25,"24 - 1153",417,420,417,0,3,1
"6056",2024-04-26,"62 - 1011",116,116,116,0,0,1
"6057",2024-04-26,"3 - 1008",346,354,343,3,8,0.991329479768786
"6058",2024-04-26,"16 - 1022",81,81,80,1,0,0.987654320987654
"6059",2024-04-26,"24 - 1150",268,287,267,1,19,0.996268656716418
"6060",2024-04-26,"24 - 1153",417,420,417,0,3,1
"6061",2024-04-27,"62 - 1011",116,116,115,1,0,0.991379310344828
"6062",2024-04-27,"3 - 1008",346,354,340,6,8,0.982658959537572
"6063",2024-04-27,"16 - 1022",81,81,80,1,0,0.987654320987654
"6064",2024-04-27,"24 - 1150",267,287,267,0,20,1
"6065",2024-04-27,"24 - 1153",417,420,417,0,3,1
"6066",2024-04-28,"62 - 1011",116,116,116,0,0,1
"6067",2024-04-28,"3 - 1008",346,354,339,7,8,0.979768786127168
"6068",2024-04-28,"16 - 1022",81,81,78,3,0,0.962962962962963
"6069",2024-04-28,"24 - 1150",267,287,265,2,20,0.99250936329588
"6070",2024-04-28,"24 - 1153",417,420,417,0,3,1
"6071",2024-04-29,"62 - 1011",116,116,116,0,0,1
"6072",2024-04-29,"3 - 1008",341,354,335,6,13,0.982404692082111
"6073",2024-04-29,"16 - 1022",81,81,81,0,0,1
"6074",2024-04-29,"24 - 1150",272,287,271,1,15,0.996323529411765
"6075",2024-04-29,"24 - 1153",416,420,416,0,4,1
"6076",2024-04-30,"62 - 1011",116,116,116,0,0,1
"6077",2024-04-30,"3 - 1008",338,354,333,5,16,0.985207100591716
"6078",2024-04-30,"16 - 1022",81,81,81,0,0,1
"6079",2024-04-30,"24 - 1150",275,287,275,0,12,1
"6080",2024-04-30,"24 - 1153",417,420,417,0,3,1
"6081",2024-05-01,"62 - 1011",116,116,116,0,0,1
"6082",2024-05-01,"3 - 1008",336,354,330,6,18,0.982142857142857
"6083",2024-05-01,"16 - 1022",81,81,80,1,0,0.987654320987654
"6084",2024-05-01,"24 - 1150",276,287,276,0,11,1
"6085",2024-05-01,"24 - 1153",417,420,417,0,3,1
"6086",2024-05-02,"62 - 1011",116,116,115,1,0,0.991379310344828
"6087",2024-05-02,"3 - 1008",335,354,330,5,19,0.985074626865672
"6088",2024-05-02,"16 - 1022",81,81,80,1,0,0.987654320987654
"6089",2024-05-02,"24 - 1150",276,287,276,0,11,1
"6090",2024-05-02,"24 - 1153",417,420,417,0,3,1
"6091",2024-05-03,"62 - 1011",116,116,116,0,0,1
"6092",2024-05-03,"3 - 1008",332,354,328,4,22,0.987951807228916
"6093",2024-05-03,"16 - 1022",81,81,80,1,0,0.987654320987654
"6094",2024-05-03,"24 - 1150",276,287,276,0,11,1
"6095",2024-05-03,"24 - 1153",418,420,418,0,2,1
"6096",2024-05-04,"62 - 1011",116,116,116,0,0,1
"6097",2024-05-04,"3 - 1008",332,354,328,4,22,0.987951807228916
"6098",2024-05-04,"16 - 1022",81,81,80,1,0,0.987654320987654
"6099",2024-05-04,"24 - 1150",274,287,273,1,13,0.996350364963504
"6100",2024-05-04,"24 - 1153",418,420,418,0,2,1
"6101",2024-05-05,"62 - 1011",116,116,116,0,0,1
"6102",2024-05-05,"3 - 1008",332,354,328,4,22,0.987951807228916
"6103",2024-05-05,"16 - 1022",81,81,80,1,0,0.987654320987654
"6104",2024-05-05,"24 - 1150",277,287,277,0,10,1
"6105",2024-05-05,"24 - 1153",418,420,418,0,2,1
"6106",2024-05-06,"62 - 1011",116,116,116,0,0,1
"6107",2024-05-06,"3 - 1008",331,354,328,3,23,0.990936555891239
"6108",2024-05-06,"16 - 1022",81,81,78,3,0,0.962962962962963
"6109",2024-05-06,"24 - 1150",277,287,275,2,10,0.992779783393502
"6110",2024-05-06,"24 - 1153",417,420,417,0,3,1
"6111",2024-05-07,"62 - 1011",116,116,116,0,0,1
"6112",2024-05-07,"3 - 1008",328,354,325,3,26,0.990853658536585
"6113",2024-05-07,"16 - 1022",81,81,78,3,0,0.962962962962963
"6114",2024-05-07,"24 - 1150",276,287,276,0,11,1
"6115",2024-05-07,"24 - 1153",415,420,415,0,5,1
"6116",2024-05-08,"62 - 1011",116,116,113,3,0,0.974137931034483
"6117",2024-05-08,"3 - 1008",328,354,325,3,26,0.990853658536585
"6118",2024-05-08,"16 - 1022",81,81,79,2,0,0.975308641975309
"6119",2024-05-08,"24 - 1150",276,287,276,0,11,1
"6120",2024-05-08,"24 - 1153",414,420,414,0,6,1
"6121",2024-05-09,"62 - 1011",116,116,115,1,0,0.991379310344828
"6122",2024-05-09,"3 - 1008",328,354,325,3,26,0.990853658536585
"6123",2024-05-09,"16 - 1022",81,81,78,3,0,0.962962962962963
"6124",2024-05-09,"24 - 1150",275,287,272,3,12,0.989090909090909
"6125",2024-05-09,"24 - 1153",415,420,415,0,5,1
"6126",2024-05-10,"62 - 1011",116,116,116,0,0,1
"6127",2024-05-10,"3 - 1008",327,354,324,3,27,0.990825688073395
"6128",2024-05-10,"16 - 1022",81,81,78,3,0,0.962962962962963
"6129",2024-05-10,"24 - 1150",278,287,278,0,9,1
"6130",2024-05-10,"24 - 1153",415,420,415,0,5,1
"6131",2024-05-11,"62 - 1011",116,116,116,0,0,1
"6132",2024-05-11,"3 - 1008",327,354,324,3,27,0.990825688073395
"6133",2024-05-11,"16 - 1022",81,81,78,3,0,0.962962962962963
"6134",2024-05-11,"24 - 1150",280,287,280,0,7,1
"6135",2024-05-11,"24 - 1153",415,420,415,0,5,1
"6136",2024-05-12,"62 - 1011",116,116,116,0,0,1
"6137",2024-05-12,"3 - 1008",327,354,323,4,27,0.987767584097859
"6138",2024-05-12,"16 - 1022",81,81,78,3,0,0.962962962962963
"6139",2024-05-12,"24 - 1150",280,287,280,0,7,1
"6140",2024-05-12,"24 - 1153",415,420,415,0,5,1
"6141",2024-05-13,"62 - 1011",116,116,116,0,0,1
"6142",2024-05-13,"3 - 1008",325,354,321,4,29,0.987692307692308
"6143",2024-05-13,"16 - 1022",81,81,78,3,0,0.962962962962963
"6144",2024-05-13,"24 - 1150",284,287,283,1,3,0.996478873239437
"6145",2024-05-13,"24 - 1153",413,416,413,0,3,1
"6146",2024-05-14,"62 - 1011",116,116,116,0,0,1
"6147",2024-05-14,"3 - 1008",324,354,320,4,30,0.987654320987654
"6148",2024-05-14,"16 - 1022",81,81,76,5,0,0.938271604938272
"6149",2024-05-14,"24 - 1150",283,287,283,0,4,1
"6150",2024-05-14,"24 - 1153",414,416,414,0,2,1
"6151",2024-05-15,"62 - 1011",116,116,116,0,0,1
"6152",2024-05-15,"3 - 1008",323,354,319,4,31,0.987616099071207
"6153",2024-05-15,"16 - 1022",81,81,78,3,0,0.962962962962963
"6154",2024-05-15,"24 - 1150",284,287,284,0,3,1
"6155",2024-05-15,"24 - 1153",412,416,412,0,4,1
"6156",2024-05-16,"62 - 1011",116,116,116,0,0,1
"6157",2024-05-16,"3 - 1008",323,354,320,3,31,0.990712074303406
"6158",2024-05-16,"16 - 1022",81,81,78,3,0,0.962962962962963
"6159",2024-05-16,"24 - 1150",283,287,283,0,4,1
"6160",2024-05-16,"24 - 1153",412,416,412,0,4,1
"6161",2024-05-17,"62 - 1011",116,116,116,0,0,1
"6162",2024-05-17,"3 - 1008",321,354,317,4,33,0.987538940809969
"6163",2024-05-17,"16 - 1022",81,81,78,3,0,0.962962962962963
"6164",2024-05-17,"24 - 1150",283,287,283,0,4,1
"6165",2024-05-17,"24 - 1153",413,420,413,0,7,1
"6166",2024-05-18,"62 - 1011",116,116,116,0,0,1
"6167",2024-05-18,"3 - 1008",321,354,317,4,33,0.987538940809969
"6168",2024-05-18,"16 - 1022",81,81,79,2,0,0.975308641975309
"6169",2024-05-18,"24 - 1150",283,287,283,0,4,1
"6170",2024-05-18,"24 - 1153",412,416,412,0,4,1
"6171",2024-05-19,"62 - 1011",116,116,116,0,0,1
"6172",2024-05-19,"3 - 1008",321,354,316,5,33,0.984423676012461
"6173",2024-05-19,"16 - 1022",81,81,79,2,0,0.975308641975309
"6174",2024-05-19,"24 - 1150",283,287,283,0,4,1
"6175",2024-05-19,"24 - 1153",411,416,411,0,5,1
"6176",2024-05-20,"62 - 1011",116,116,115,1,0,0.991379310344828
"6177",2024-05-20,"3 - 1008",320,354,316,4,34,0.9875
"6178",2024-05-20,"16 - 1022",81,81,79,2,0,0.975308641975309
"6179",2024-05-20,"24 - 1150",283,287,283,0,4,1
"6180",2024-05-20,"24 - 1153",410,416,410,0,6,1
"6181",2024-05-21,"62 - 1011",116,116,113,3,0,0.974137931034483
"6182",2024-05-21,"3 - 1008",317,333,313,4,16,0.987381703470032
"6183",2024-05-21,"16 - 1022",81,81,81,0,0,1
"6184",2024-05-21,"24 - 1150",284,287,284,0,3,1
"6185",2024-05-21,"24 - 1153",410,416,410,0,6,1
"6186",2024-05-22,"62 - 1011",116,116,113,3,0,0.974137931034483
"6187",2024-05-22,"3 - 1008",316,333,313,3,17,0.990506329113924
"6188",2024-05-22,"16 - 1022",81,81,81,0,0,1
"6189",2024-05-22,"24 - 1150",284,287,283,1,3,0.996478873239437
"6190",2024-05-22,"24 - 1153",410,416,410,0,6,1
"6191",2024-05-23,"62 - 1011",116,116,116,0,0,1
"6192",2024-05-23,"3 - 1008",316,333,313,3,17,0.990506329113924
"6193",2024-05-23,"16 - 1022",81,81,78,3,0,0.962962962962963
"6194",2024-05-23,"24 - 1150",284,287,284,0,3,1
"6195",2024-05-23,"24 - 1153",417,420,417,0,3,1
"6196",2024-05-24,"62 - 1011",116,116,114,2,0,0.982758620689655
"6197",2024-05-24,"3 - 1008",316,333,312,4,17,0.987341772151899
"6198",2024-05-24,"16 - 1022",81,81,80,1,0,0.987654320987654
"6199",2024-05-24,"24 - 1150",284,287,284,0,3,1
"6200",2024-05-24,"24 - 1153",417,420,417,0,3,1
"6201",2024-05-25,"62 - 1011",116,116,114,2,0,0.982758620689655
"6202",2024-05-25,"3 - 1008",315,333,313,2,18,0.993650793650794
"6203",2024-05-25,"16 - 1022",81,81,80,1,0,0.987654320987654
"6204",2024-05-25,"24 - 1150",279,287,279,0,8,1
"6205",2024-05-25,"24 - 1153",417,420,417,0,3,1
"6206",2024-05-26,"62 - 1011",116,116,114,2,0,0.982758620689655
"6207",2024-05-26,"3 - 1008",315,333,313,2,18,0.993650793650794
"6208",2024-05-26,"16 - 1022",81,81,80,1,0,0.987654320987654
"6209",2024-05-26,"24 - 1150",279,287,279,0,8,1
"6210",2024-05-26,"24 - 1153",417,420,414,3,3,0.992805755395683
"6211",2024-05-27,"62 - 1011",116,116,116,0,0,1
"6212",2024-05-27,"3 - 1008",316,333,313,3,17,0.990506329113924
"6213",2024-05-27,"16 - 1022",81,81,80,1,0,0.987654320987654
"6214",2024-05-27,"24 - 1150",276,287,276,0,11,1
"6215",2024-05-27,"24 - 1153",417,420,417,0,3,1
"6216",2024-05-28,"62 - 1011",116,116,116,0,0,1
"6217",2024-05-28,"3 - 1008",315,333,312,3,18,0.99047619047619
"6218",2024-05-28,"16 - 1022",81,81,80,1,0,0.987654320987654
"6219",2024-05-28,"24 - 1150",274,287,274,0,13,1
"6220",2024-05-28,"24 - 1153",416,420,416,0,4,1
"6221",2024-05-29,"62 - 1011",116,116,116,0,0,1
"6222",2024-05-29,"3 - 1008",315,333,312,3,18,0.99047619047619
"6223",2024-05-29,"16 - 1022",81,81,79,2,0,0.975308641975309
"6224",2024-05-29,"24 - 1150",267,287,267,0,20,1
"6225",2024-05-29,"24 - 1153",416,420,416,0,4,1
"6226",2024-05-30,"62 - 1011",116,116,116,0,0,1
"6227",2024-05-30,"3 - 1008",313,333,311,2,20,0.993610223642173
"6228",2024-05-30,"16 - 1022",81,81,80,1,0,0.987654320987654
"6229",2024-05-30,"24 - 1150",262,287,262,0,25,1
"6230",2024-05-30,"24 - 1153",416,420,416,0,4,1
"6231",2024-05-31,"62 - 1011",116,116,116,0,0,1
"6232",2024-05-31,"3 - 1008",312,333,307,5,21,0.983974358974359
"6233",2024-05-31,"16 - 1022",81,81,80,1,0,0.987654320987654
"6234",2024-05-31,"24 - 1150",262,287,262,0,25,1
"6235",2024-05-31,"24 - 1153",414,420,414,0,6,1
"6236",2024-06-01,"62 - 1011",116,116,116,0,0,1
"6237",2024-06-01,"3 - 1008",311,333,308,3,22,0.990353697749196
"6238",2024-06-01,"16 - 1022",81,81,80,1,0,0.987654320987654
"6239",2024-06-01,"24 - 1150",260,287,260,0,27,1
"6240",2024-06-01,"24 - 1153",414,420,414,0,6,1
"6241",2024-06-02,"62 - 1011",115,116,115,0,1,1
"6242",2024-06-02,"3 - 1008",311,333,307,4,22,0.987138263665595
"6243",2024-06-02,"16 - 1022",81,81,80,1,0,0.987654320987654
"6244",2024-06-02,"24 - 1150",257,287,257,0,30,1
"6245",2024-06-02,"24 - 1153",414,420,414,0,6,1
"6246",2024-06-03,"62 - 1011",115,116,115,0,1,1
"6247",2024-06-03,"3 - 1008",310,333,305,5,23,0.983870967741935
"6248",2024-06-03,"16 - 1022",81,81,79,2,0,0.975308641975309
"6249",2024-06-03,"24 - 1150",256,287,256,0,31,1
"6250",2024-06-03,"24 - 1153",414,420,414,0,6,1
"6251",2024-06-04,"62 - 1011",115,116,115,0,1,1
"6252",2024-06-04,"3 - 1008",306,333,300,6,27,0.980392156862745
"6253",2024-06-04,"16 - 1022",81,81,78,3,0,0.962962962962963
"6254",2024-06-04,"24 - 1150",259,287,259,0,28,1
"6255",2024-06-04,"24 - 1153",412,420,412,0,8,1
"6256",2024-06-05,"62 - 1011",115,116,115,0,1,1
"6257",2024-06-05,"3 - 1008",303,333,301,2,30,0.993399339933993
"6258",2024-06-05,"16 - 1022",81,81,78,3,0,0.962962962962963
"6259",2024-06-05,"24 - 1150",260,287,260,0,27,1
"6260",2024-06-05,"24 - 1153",412,420,412,0,8,1
"6261",2024-06-06,"62 - 1011",115,116,115,0,1,1
"6262",2024-06-06,"3 - 1008",302,333,300,2,31,0.993377483443709
"6263",2024-06-06,"16 - 1022",81,81,80,1,0,0.987654320987654
"6264",2024-06-06,"24 - 1150",260,287,260,0,27,1
"6265",2024-06-06,"24 - 1153",411,414,411,0,3,1
"6266",2024-06-07,"62 - 1011",115,116,115,0,1,1
"6267",2024-06-07,"3 - 1008",301,333,299,2,32,0.993355481727575
"6268",2024-06-07,"16 - 1022",81,81,80,1,0,0.987654320987654
"6269",2024-06-07,"24 - 1150",257,287,257,0,30,1
"6270",2024-06-07,"24 - 1153",411,414,411,0,3,1
"6271",2024-06-08,"62 - 1011",115,116,115,0,1,1
"6272",2024-06-08,"3 - 1008",301,333,298,3,32,0.990033222591362
"6273",2024-06-08,"16 - 1022",81,81,80,1,0,0.987654320987654
"6274",2024-06-08,"24 - 1150",256,287,256,0,31,1
"6275",2024-06-08,"24 - 1153",411,414,411,0,3,1
"6276",2024-06-09,"62 - 1011",115,116,115,0,1,1
"6277",2024-06-09,"3 - 1008",300,333,298,2,33,0.993333333333333
"6278",2024-06-09,"16 - 1022",81,81,79,2,0,0.975308641975309
"6279",2024-06-09,"24 - 1150",255,287,255,0,32,1
"6280",2024-06-09,"24 - 1153",411,414,411,0,3,1
"6281",2024-06-10,"62 - 1011",115,116,115,0,1,1
"6282",2024-06-10,"3 - 1008",300,333,298,2,33,0.993333333333333
"6283",2024-06-10,"16 - 1022",80,81,78,2,1,0.975
"6284",2024-06-10,"24 - 1150",258,287,258,0,29,1
"6285",2024-06-10,"24 - 1153",411,414,411,0,3,1
"6286",2024-06-11,"62 - 1011",115,116,115,0,1,1
"6287",2024-06-11,"3 - 1008",300,333,297,3,33,0.99
"6288",2024-06-11,"16 - 1022",80,81,78,2,1,0.975
"6289",2024-06-11,"24 - 1150",259,287,259,0,28,1
"6290",2024-06-11,"24 - 1153",419,420,418,1,1,0.997613365155131
"6291",2024-06-12,"62 - 1011",116,116,116,0,0,1
"6292",2024-06-12,"3 - 1008",299,333,297,2,34,0.993311036789298
"6293",2024-06-12,"16 - 1022",80,81,78,2,1,0.975
"6294",2024-06-12,"24 - 1150",259,287,259,0,28,1
"6295",2024-06-12,"24 - 1153",419,420,419,0,1,1
"6296",2024-06-13,"62 - 1011",116,116,115,1,0,0.991379310344828
"6297",2024-06-13,"3 - 1008",296,333,296,0,37,1
"6298",2024-06-13,"16 - 1022",80,81,78,2,1,0.975
"6299",2024-06-13,"24 - 1150",260,287,260,0,27,1
"6300",2024-06-13,"24 - 1153",419,420,419,0,1,1
"6301",2024-06-14,"62 - 1011",116,116,116,0,0,1
"6302",2024-06-14,"3 - 1008",295,333,295,0,38,1
"6303",2024-06-14,"16 - 1022",80,81,78,2,1,0.975
"6304",2024-06-14,"24 - 1150",261,287,261,0,26,1
"6305",2024-06-14,"24 - 1153",417,420,417,0,3,1
"6306",2024-06-15,"62 - 1011",116,116,116,0,0,1
"6307",2024-06-15,"3 - 1008",295,333,295,0,38,1
"6308",2024-06-15,"16 - 1022",80,81,78,2,1,0.975
"6309",2024-06-15,"24 - 1150",260,287,260,0,27,1
"6310",2024-06-15,"24 - 1153",418,420,417,1,2,0.997607655502392
"6311",2024-06-16,"62 - 1011",116,116,116,0,0,1
"6312",2024-06-16,"3 - 1008",295,333,295,0,38,1
"6313",2024-06-16,"16 - 1022",80,81,78,2,1,0.975
"6314",2024-06-16,"24 - 1150",260,287,260,0,27,1
"6315",2024-06-16,"24 - 1153",417,420,417,0,3,1
"6316",2024-06-17,"62 - 1011",116,116,115,1,0,0.991379310344828
"6317",2024-06-17,"3 - 1008",295,333,295,0,38,1
"6318",2024-06-17,"16 - 1022",80,81,78,2,1,0.975
"6319",2024-06-17,"24 - 1150",259,287,259,0,28,1
"6320",2024-06-17,"24 - 1153",417,420,417,0,3,1
"6321",2024-06-18,"62 - 1011",116,116,116,0,0,1
"6322",2024-06-18,"3 - 1008",295,333,295,0,38,1
"6323",2024-06-18,"16 - 1022",81,81,78,3,0,0.962962962962963
"6324",2024-06-18,"24 - 1150",259,287,259,0,28,1
"6325",2024-06-18,"24 - 1153",417,420,417,0,3,1
"6326",2024-06-19,"62 - 1011",116,116,115,1,0,0.991379310344828
"6327",2024-06-19,"3 - 1008",295,333,295,0,38,1
"6328",2024-06-19,"16 - 1022",81,81,79,2,0,0.975308641975309
"6329",2024-06-19,"24 - 1150",259,287,259,0,28,1
"6330",2024-06-19,"24 - 1153",420,420,420,0,0,1
"6331",2024-06-20,"62 - 1011",116,116,115,1,0,0.991379310344828
"6332",2024-06-20,"3 - 1008",295,333,293,2,38,0.993220338983051
"6333",2024-06-20,"16 - 1022",81,81,80,1,0,0.987654320987654
"6334",2024-06-20,"24 - 1150",256,287,256,0,31,1
"6335",2024-06-20,"24 - 1153",420,420,420,0,0,1
"6336",2024-06-21,"62 - 1011",116,116,115,1,0,0.991379310344828
"6337",2024-06-21,"3 - 1008",294,333,294,0,39,1
"6338",2024-06-21,"16 - 1022",81,81,80,1,0,0.987654320987654
"6339",2024-06-21,"24 - 1150",257,287,257,0,30,1
"6340",2024-06-21,"24 - 1153",420,420,419,1,0,0.997619047619048
"6341",2024-06-22,"62 - 1011",116,116,116,0,0,1
"6342",2024-06-22,"3 - 1008",294,333,294,0,39,1
"6343",2024-06-22,"16 - 1022",81,81,80,1,0,0.987654320987654
"6344",2024-06-22,"24 - 1150",259,287,259,0,28,1
"6345",2024-06-22,"24 - 1153",419,420,419,0,1,1
"6346",2024-06-23,"62 - 1011",116,116,116,0,0,1
"6347",2024-06-23,"3 - 1008",294,333,294,0,39,1
"6348",2024-06-23,"16 - 1022",81,81,79,2,0,0.975308641975309
"6349",2024-06-23,"24 - 1150",256,287,256,0,31,1
"6350",2024-06-23,"24 - 1153",418,420,418,0,2,1
"6351",2024-06-24,"62 - 1011",116,116,116,0,0,1
"6352",2024-06-24,"3 - 1008",294,333,293,1,39,0.996598639455782
"6353",2024-06-24,"16 - 1022",81,81,79,2,0,0.975308641975309
"6354",2024-06-24,"24 - 1150",254,287,254,0,33,1
"6355",2024-06-24,"24 - 1153",418,420,418,0,2,1
"6356",2024-06-25,"62 - 1011",116,116,116,0,0,1
"6357",2024-06-25,"3 - 1008",294,333,293,1,39,0.996598639455782
"6358",2024-06-25,"16 - 1022",81,81,79,2,0,0.975308641975309
"6359",2024-06-25,"24 - 1150",251,287,251,0,36,1
"6360",2024-06-25,"24 - 1153",418,420,418,0,2,1
"6361",2024-06-26,"62 - 1011",116,116,116,0,0,1
"6362",2024-06-26,"3 - 1008",291,333,291,0,42,1
"6363",2024-06-26,"16 - 1022",81,81,79,2,0,0.975308641975309
"6364",2024-06-26,"24 - 1150",250,287,249,1,37,0.996
"6365",2024-06-26,"24 - 1153",419,420,419,0,1,1
"6366",2024-06-27,"62 - 1011",116,116,115,1,0,0.991379310344828
"6367",2024-06-27,"3 - 1008",291,333,291,0,42,1
"6368",2024-06-27,"16 - 1022",81,81,80,1,0,0.987654320987654
"6369",2024-06-27,"24 - 1150",249,287,249,0,38,1
"6370",2024-06-27,"24 - 1153",420,420,419,1,0,0.997619047619048
"6371",2024-06-28,"62 - 1011",116,116,116,0,0,1
"6372",2024-06-28,"3 - 1008",292,333,290,2,41,0.993150684931507
"6373",2024-06-28,"16 - 1022",81,81,79,2,0,0.975308641975309
"6374",2024-06-28,"24 - 1150",247,287,247,0,40,1
"6375",2024-06-28,"24 - 1153",420,420,419,1,0,0.997619047619048
"6376",2024-06-29,"62 - 1011",116,116,116,0,0,1
"6377",2024-06-29,"3 - 1008",289,333,289,0,44,1
"6378",2024-06-29,"16 - 1022",81,81,79,2,0,0.975308641975309
"6379",2024-06-29,"24 - 1150",247,287,247,0,40,1
"6380",2024-06-29,"24 - 1153",420,420,420,0,0,1
"6381",2024-06-30,"62 - 1011",116,116,115,1,0,0.991379310344828
"6382",2024-06-30,"3 - 1008",288,333,287,1,45,0.996527777777778
"6383",2024-06-30,"16 - 1022",81,81,79,2,0,0.975308641975309
"6384",2024-06-30,"24 - 1150",246,287,246,0,41,1
"6385",2024-06-30,"24 - 1153",420,420,420,0,0,1
"6386",2024-07-01,"62 - 1011",116,116,116,0,0,1
"6387",2024-07-01,"3 - 1008",288,333,288,0,45,1
"6388",2024-07-01,"16 - 1022",81,81,79,2,0,0.975308641975309
"6389",2024-07-01,"24 - 1150",245,287,245,0,42,1
"6390",2024-07-01,"24 - 1153",419,420,419,0,1,1
"6391",2024-07-02,"62 - 1011",116,116,116,0,0,1
"6392",2024-07-02,"3 - 1008",287,333,285,2,46,0.993031358885017
"6393",2024-07-02,"16 - 1022",81,81,79,2,0,0.975308641975309
"6394",2024-07-02,"24 - 1150",246,287,246,0,41,1
"6395",2024-07-02,"24 - 1153",420,420,420,0,0,1
"6396",2024-07-03,"62 - 1011",116,116,115,1,0,0.991379310344828
"6397",2024-07-03,"3 - 1008",287,333,284,3,46,0.989547038327526
"6398",2024-07-03,"16 - 1022",81,81,80,1,0,0.987654320987654
"6399",2024-07-03,"24 - 1150",247,287,247,0,40,1
"6400",2024-07-03,"24 - 1153",420,420,418,2,0,0.995238095238095
"6401",2024-07-04,"62 - 1011",116,116,115,1,0,0.991379310344828
"6402",2024-07-04,"3 - 1008",285,333,282,3,48,0.989473684210526
"6403",2024-07-04,"16 - 1022",81,81,81,0,0,1
"6404",2024-07-04,"24 - 1150",245,287,245,0,42,1
"6405",2024-07-04,"24 - 1153",419,420,416,3,1,0.992840095465394
"6406",2024-07-05,"62 - 1011",116,116,115,1,0,0.991379310344828
"6407",2024-07-05,"3 - 1008",280,333,278,2,53,0.992857142857143
"6408",2024-07-05,"16 - 1022",81,81,80,1,0,0.987654320987654
"6409",2024-07-05,"24 - 1150",252,287,245,7,35,0.972222222222222
"6410",2024-07-05,"24 - 1153",418,420,418,0,2,1
"6411",2024-07-06,"62 - 1011",116,116,116,0,0,1
"6412",2024-07-06,"3 - 1008",279,333,277,2,54,0.992831541218638
"6413",2024-07-06,"16 - 1022",81,81,79,2,0,0.975308641975309
"6414",2024-07-06,"24 - 1150",253,287,249,4,34,0.984189723320158
"6415",2024-07-06,"24 - 1153",419,420,419,0,1,1
"6416",2024-07-07,"62 - 1011",116,116,116,0,0,1
"6417",2024-07-07,"3 - 1008",279,333,277,2,54,0.992831541218638
"6418",2024-07-07,"16 - 1022",81,81,79,2,0,0.975308641975309
"6419",2024-07-07,"24 - 1150",253,287,247,6,34,0.976284584980237
"6420",2024-07-07,"24 - 1153",419,420,419,0,1,1
"6421",2024-07-08,"62 - 1011",116,116,116,0,0,1
"6422",2024-07-08,"3 - 1008",279,333,276,3,54,0.989247311827957
"6423",2024-07-08,"16 - 1022",81,81,80,1,0,0.987654320987654
"6424",2024-07-08,"24 - 1150",254,287,252,2,33,0.992125984251969
"6425",2024-07-08,"24 - 1153",419,420,419,0,1,1
"6426",2024-07-09,"62 - 1011",116,116,116,0,0,1
"6427",2024-07-09,"3 - 1008",277,333,275,2,56,0.992779783393502
"6428",2024-07-09,"16 - 1022",81,81,81,0,0,1
"6429",2024-07-09,"24 - 1150",258,287,252,6,29,0.976744186046512
"6430",2024-07-09,"24 - 1153",417,420,417,0,3,1
"6431",2024-07-10,"62 - 1011",116,116,116,0,0,1
"6432",2024-07-10,"3 - 1008",276,333,276,0,57,1
"6433",2024-07-10,"16 - 1022",81,81,81,0,0,1
"6434",2024-07-10,"24 - 1150",257,287,253,4,30,0.98443579766537
"6435",2024-07-10,"24 - 1153",419,420,417,2,1,0.995226730310263
"6436",2024-07-11,"62 - 1011",116,116,116,0,0,1
"6437",2024-07-11,"3 - 1008",276,333,276,0,57,1
"6438",2024-07-11,"16 - 1022",81,81,81,0,0,1
"6439",2024-07-11,"24 - 1150",263,287,250,13,24,0.950570342205323
"6440",2024-07-11,"24 - 1153",419,420,419,0,1,1
"6441",2024-07-12,"62 - 1011",116,116,116,0,0,1
"6442",2024-07-12,"3 - 1008",276,333,276,0,57,1
"6443",2024-07-12,"16 - 1022",81,81,81,0,0,1
"6444",2024-07-12,"24 - 1150",259,287,249,10,28,0.961389961389961
"6445",2024-07-12,"24 - 1153",419,420,419,0,1,1
"6446",2024-07-13,"62 - 1011",116,116,116,0,0,1
"6447",2024-07-13,"3 - 1008",276,333,276,0,57,1
"6448",2024-07-13,"16 - 1022",81,81,81,0,0,1
"6449",2024-07-13,"24 - 1150",248,287,248,0,39,1
"6450",2024-07-13,"24 - 1153",419,420,419,0,1,1
"6451",2024-07-14,"62 - 1011",116,116,116,0,0,1
"6452",2024-07-14,"3 - 1008",276,333,276,0,57,1
"6453",2024-07-14,"16 - 1022",81,81,81,0,0,1
"6454",2024-07-14,"24 - 1150",244,287,244,0,43,1
"6455",2024-07-14,"24 - 1153",418,420,418,0,2,1
"6456",2024-07-15,"62 - 1011",116,116,116,0,0,1
"6457",2024-07-15,"3 - 1008",276,333,276,0,57,1
"6458",2024-07-15,"16 - 1022",81,81,81,0,0,1
"6459",2024-07-15,"24 - 1150",253,287,247,6,34,0.976284584980237
"6460",2024-07-15,"24 - 1153",418,420,418,0,2,1
"6461",2024-07-16,"62 - 1011",116,116,115,1,0,0.991379310344828
"6462",2024-07-16,"3 - 1008",275,333,275,0,58,1
"6463",2024-07-16,"16 - 1022",81,81,81,0,0,1
"6464",2024-07-16,"24 - 1150",255,287,249,6,32,0.976470588235294
"6465",2024-07-16,"24 - 1153",418,420,418,0,2,1
"6466",2024-07-17,"62 - 1011",116,116,116,0,0,1
"6467",2024-07-17,"3 - 1008",275,333,274,1,58,0.996363636363636
"6468",2024-07-17,"16 - 1022",81,81,80,1,0,0.987654320987654
"6469",2024-07-17,"24 - 1150",260,287,254,6,27,0.976923076923077
"6470",2024-07-17,"24 - 1153",419,420,419,0,1,1
"6471",2024-07-18,"62 - 1011",116,116,116,0,0,1
"6472",2024-07-18,"3 - 1008",275,333,275,0,58,1
"6473",2024-07-18,"16 - 1022",81,81,81,0,0,1
"6474",2024-07-18,"24 - 1150",262,287,260,2,25,0.99236641221374
"6475",2024-07-18,"24 - 1153",419,420,419,0,1,1
"6476",2024-07-19,"62 - 1011",116,116,116,0,0,1
"6477",2024-07-19,"3 - 1008",275,333,275,0,58,1
"6478",2024-07-19,"16 - 1022",81,81,81,0,0,1
"6479",2024-07-19,"24 - 1150",260,287,257,3,27,0.988461538461539
"6480",2024-07-19,"24 - 1153",419,420,419,0,1,1
"6481",2024-07-20,"62 - 1011",116,116,116,0,0,1
"6482",2024-07-20,"3 - 1008",275,333,275,0,58,1
"6483",2024-07-20,"16 - 1022",81,81,80,1,0,0.987654320987654
"6484",2024-07-20,"24 - 1150",259,287,259,0,28,1
"6485",2024-07-20,"24 - 1153",419,420,419,0,1,1
"6486",2024-07-21,"62 - 1011",116,116,116,0,0,1
"6487",2024-07-21,"3 - 1008",275,333,274,1,58,0.996363636363636
"6488",2024-07-21,"16 - 1022",81,81,80,1,0,0.987654320987654
"6489",2024-07-21,"24 - 1150",258,287,258,0,29,1
"6490",2024-07-21,"24 - 1153",419,420,419,0,1,1
"6491",2024-07-22,"62 - 1011",116,116,116,0,0,1
"6492",2024-07-22,"3 - 1008",276,333,274,2,57,0.992753623188406
"6493",2024-07-22,"16 - 1022",80,81,80,0,1,1
"6494",2024-07-22,"24 - 1150",268,287,260,8,19,0.970149253731343
"6495",2024-07-22,"24 - 1153",419,420,419,0,1,1
"6496",2024-07-23,"62 - 1011",116,116,116,0,0,1
"6497",2024-07-23,"3 - 1008",276,333,276,0,57,1
"6498",2024-07-23,"16 - 1022",81,81,80,1,0,0.987654320987654
"6499",2024-07-23,"24 - 1150",270,287,259,11,17,0.959259259259259
"6500",2024-07-23,"24 - 1153",419,420,419,0,1,1
"6501",2024-07-24,"62 - 1011",116,116,116,0,0,1
"6502",2024-07-24,"3 - 1008",276,333,275,1,57,0.996376811594203
"6503",2024-07-24,"16 - 1022",81,81,80,1,0,0.987654320987654
"6504",2024-07-24,"24 - 1150",265,287,263,2,22,0.992452830188679
"6505",2024-07-24,"24 - 1153",419,420,419,0,1,1
"6506",2024-07-25,"62 - 1011",116,116,116,0,0,1
"6507",2024-07-25,"3 - 1008",276,333,275,1,57,0.996376811594203
"6508",2024-07-25,"16 - 1022",81,81,80,1,0,0.987654320987654
"6509",2024-07-25,"24 - 1150",266,287,266,0,21,1
"6510",2024-07-25,"24 - 1153",419,420,419,0,1,1
"6511",2024-07-26,"62 - 1011",116,116,116,0,0,1
"6512",2024-07-26,"3 - 1008",275,333,274,1,58,0.996363636363636
"6513",2024-07-26,"16 - 1022",81,81,81,0,0,1
"6514",2024-07-26,"24 - 1150",259,287,258,1,28,0.996138996138996
"6515",2024-07-26,"24 - 1153",417,420,417,0,3,1
"6516",2024-07-27,"62 - 1011",116,116,116,0,0,1
"6517",2024-07-27,"3 - 1008",276,333,275,1,57,0.996376811594203
"6518",2024-07-27,"16 - 1022",81,81,80,1,0,0.987654320987654
"6519",2024-07-27,"24 - 1150",270,287,260,10,17,0.962962962962963
"6520",2024-07-27,"24 - 1153",417,420,417,0,3,1
"6521",2024-07-28,"62 - 1011",116,116,116,0,0,1
"6522",2024-07-28,"3 - 1008",276,333,275,1,57,0.996376811594203
"6523",2024-07-28,"16 - 1022",81,81,80,1,0,0.987654320987654
"6524",2024-07-28,"24 - 1150",267,287,265,2,20,0.99250936329588
"6525",2024-07-28,"24 - 1153",417,420,417,0,3,1
"6526",2024-07-29,"62 - 1011",116,116,116,0,0,1
"6527",2024-07-29,"3 - 1008",276,333,274,2,57,0.992753623188406
"6528",2024-07-29,"16 - 1022",81,81,81,0,0,1
"6529",2024-07-29,"24 - 1150",263,287,263,0,24,1
"6530",2024-07-29,"24 - 1153",418,420,418,0,2,1
"6531",2024-07-30,"62 - 1011",116,116,116,0,0,1
"6532",2024-07-30,"3 - 1008",274,333,273,1,59,0.996350364963504
"6533",2024-07-30,"16 - 1022",81,81,81,0,0,1
"6534",2024-07-30,"24 - 1150",263,287,263,0,24,1
"6535",2024-07-30,"24 - 1153",418,420,418,0,2,1
"6536",2024-07-31,"62 - 1011",116,116,116,0,0,1
"6537",2024-07-31,"3 - 1008",273,333,272,1,60,0.996336996336996
"6538",2024-07-31,"16 - 1022",80,81,79,1,1,0.9875
"6539",2024-07-31,"24 - 1150",262,287,262,0,25,1
"6540",2024-07-31,"24 - 1153",418,420,418,0,2,1
"6541",2024-08-01,"62 - 1011",116,116,116,0,0,1
"6542",2024-08-01,"3 - 1008",272,333,271,1,61,0.996323529411765
"6543",2024-08-01,"16 - 1022",81,81,76,5,0,0.938271604938272
"6544",2024-08-01,"24 - 1150",252,287,250,2,35,0.992063492063492
"6545",2024-08-01,"24 - 1153",419,420,419,0,1,1
"6546",2024-08-02,"62 - 1011",116,116,116,0,0,1
"6547",2024-08-02,"3 - 1008",269,333,268,1,64,0.996282527881041
"6548",2024-08-02,"16 - 1022",81,81,75,6,0,0.925925925925926
"6549",2024-08-02,"24 - 1150",245,287,245,0,42,1
"6550",2024-08-02,"24 - 1153",418,420,418,0,2,1
"6551",2024-08-03,"62 - 1011",116,116,116,0,0,1
"6552",2024-08-03,"3 - 1008",269,333,269,0,64,1
"6553",2024-08-03,"16 - 1022",81,81,74,7,0,0.91358024691358
"6554",2024-08-03,"24 - 1150",243,287,243,0,44,1
"6555",2024-08-03,"24 - 1153",418,420,418,0,2,1
"6556",2024-08-04,"62 - 1011",116,116,116,0,0,1
"6557",2024-08-04,"3 - 1008",270,333,270,0,63,1
"6558",2024-08-04,"16 - 1022",81,81,74,7,0,0.91358024691358
"6559",2024-08-04,"24 - 1150",243,287,243,0,44,1
"6560",2024-08-04,"24 - 1153",417,420,417,0,3,1
"6561",2024-08-05,"62 - 1011",116,116,116,0,0,1
"6562",2024-08-05,"3 - 1008",269,333,269,0,64,1
"6563",2024-08-05,"16 - 1022",81,81,74,7,0,0.91358024691358
"6564",2024-08-05,"24 - 1150",241,287,241,0,46,1
"6565",2024-08-05,"24 - 1153",417,420,417,0,3,1
"6566",2024-08-06,"62 - 1011",116,116,115,1,0,0.991379310344828
"6567",2024-08-06,"3 - 1008",269,333,269,0,64,1
"6568",2024-08-06,"16 - 1022",81,81,78,3,0,0.962962962962963
"6569",2024-08-06,"24 - 1150",244,287,244,0,43,1
"6570",2024-08-06,"24 - 1153",418,420,418,0,2,1
"6571",2024-08-07,"62 - 1011",116,116,115,1,0,0.991379310344828
"6572",2024-08-07,"3 - 1008",268,333,267,1,65,0.996268656716418
"6573",2024-08-07,"16 - 1022",81,81,79,2,0,0.975308641975309
"6574",2024-08-07,"24 - 1150",251,287,247,4,36,0.98406374501992
"6575",2024-08-07,"24 - 1153",418,420,418,0,2,1
"6576",2024-08-08,"62 - 1011",116,116,116,0,0,1
"6577",2024-08-08,"3 - 1008",266,333,266,0,67,1
"6578",2024-08-08,"16 - 1022",81,81,79,2,0,0.975308641975309
"6579",2024-08-08,"24 - 1150",254,287,253,1,33,0.996062992125984
"6580",2024-08-08,"24 - 1153",416,420,416,0,4,1
"6581",2024-08-09,"62 - 1011",116,116,116,0,0,1
"6582",2024-08-09,"3 - 1008",264,333,264,0,69,1
"6583",2024-08-09,"16 - 1022",81,81,79,2,0,0.975308641975309
"6584",2024-08-09,"24 - 1150",253,287,254,-1,34,1.00395256916996
"6585",2024-08-09,"24 - 1153",419,420,417,2,1,0.995226730310263
"6586",2024-08-10,"62 - 1011",116,116,116,0,0,1
"6587",2024-08-10,"3 - 1008",264,333,263,1,69,0.996212121212121
"6588",2024-08-10,"16 - 1022",81,81,78,3,0,0.962962962962963
"6589",2024-08-10,"24 - 1150",253,287,254,-1,34,1.00395256916996
"6590",2024-08-10,"24 - 1153",419,420,419,0,1,1
"6591",2024-08-11,"62 - 1011",116,116,116,0,0,1
"6592",2024-08-11,"3 - 1008",265,333,264,1,68,0.99622641509434
"6593",2024-08-11,"16 - 1022",81,81,78,3,0,0.962962962962963
"6594",2024-08-11,"24 - 1150",252,287,253,-1,35,1.00396825396825
"6595",2024-08-11,"24 - 1153",419,420,419,0,1,1
"6596",2024-08-12,"62 - 1011",116,116,115,1,0,0.991379310344828
"6597",2024-08-12,"3 - 1008",264,333,264,0,69,1
"6598",2024-08-12,"16 - 1022",81,81,79,2,0,0.975308641975309
"6599",2024-08-12,"24 - 1150",255,287,252,3,32,0.988235294117647
"6600",2024-08-12,"24 - 1153",418,420,418,0,2,1
"6601",2024-08-13,"62 - 1011",116,116,116,0,0,1
"6602",2024-08-13,"3 - 1008",264,333,264,0,69,1
"6603",2024-08-13,"16 - 1022",81,81,79,2,0,0.975308641975309
"6604",2024-08-13,"24 - 1150",265,287,256,9,22,0.966037735849057
"6605",2024-08-13,"24 - 1153",418,420,418,0,2,1
"6606",2024-08-14,"62 - 1011",116,116,116,0,0,1
"6607",2024-08-14,"3 - 1008",263,333,261,2,70,0.992395437262357
"6608",2024-08-14,"16 - 1022",81,81,79,2,0,0.975308641975309
"6609",2024-08-14,"24 - 1150",270,287,262,8,17,0.97037037037037
"6610",2024-08-14,"24 - 1153",418,420,417,1,2,0.997607655502392
"6611",2024-08-15,"62 - 1011",116,116,116,0,0,1
"6612",2024-08-15,"3 - 1008",262,333,260,2,71,0.99236641221374
"6613",2024-08-15,"16 - 1022",81,81,77,4,0,0.950617283950617
"6614",2024-08-15,"24 - 1150",263,287,263,0,24,1
"6615",2024-08-15,"24 - 1153",418,420,418,0,2,1
"6616",2024-08-16,"62 - 1011",116,116,116,0,0,1
"6617",2024-08-16,"3 - 1008",260,333,259,1,73,0.996153846153846
"6618",2024-08-16,"16 - 1022",81,81,79,2,0,0.975308641975309
"6619",2024-08-16,"24 - 1150",267,287,267,0,20,1
"6620",2024-08-16,"24 - 1153",418,420,418,0,2,1
"6621",2024-08-17,"62 - 1011",116,116,116,0,0,1
"6622",2024-08-17,"3 - 1008",259,333,258,1,74,0.996138996138996
"6623",2024-08-17,"16 - 1022",81,81,79,2,0,0.975308641975309
"6624",2024-08-17,"24 - 1150",264,287,264,0,23,1
"6625",2024-08-17,"24 - 1153",418,420,418,0,2,1
"6626",2024-08-18,"62 - 1011",116,116,116,0,0,1
"6627",2024-08-18,"3 - 1008",258,333,256,2,75,0.992248062015504
"6628",2024-08-18,"16 - 1022",81,81,79,2,0,0.975308641975309
"6629",2024-08-18,"24 - 1150",263,287,263,0,24,1
"6630",2024-08-18,"24 - 1153",418,420,418,0,2,1
"6631",2024-08-19,"62 - 1011",116,116,116,0,0,1
"6632",2024-08-19,"3 - 1008",258,333,256,2,75,0.992248062015504
"6633",2024-08-19,"16 - 1022",81,81,77,4,0,0.950617283950617
"6634",2024-08-19,"24 - 1150",265,287,265,0,22,1
"6635",2024-08-19,"24 - 1153",418,420,418,0,2,1
"6636",2024-08-20,"62 - 1011",116,116,116,0,0,1
"6637",2024-08-20,"3 - 1008",257,333,254,3,76,0.988326848249027
"6638",2024-08-20,"16 - 1022",81,81,79,2,0,0.975308641975309
"6639",2024-08-20,"24 - 1150",275,287,268,7,12,0.974545454545454
"6640",2024-08-20,"24 - 1153",418,420,418,0,2,1
"6641",2024-08-21,"62 - 1011",116,116,116,0,0,1
"6642",2024-08-21,"3 - 1008",256,333,254,2,77,0.9921875
"6643",2024-08-21,"16 - 1022",81,81,80,1,0,0.987654320987654
"6644",2024-08-21,"24 - 1150",275,287,265,10,12,0.963636363636364
"6645",2024-08-21,"24 - 1153",418,420,418,0,2,1
"6646",2024-08-22,"62 - 1011",116,116,116,0,0,1
"6647",2024-08-22,"3 - 1008",256,333,255,1,77,0.99609375
"6648",2024-08-22,"16 - 1022",81,81,79,2,0,0.975308641975309
"6649",2024-08-22,"24 - 1150",275,287,265,10,12,0.963636363636364
"6650",2024-08-22,"24 - 1153",417,420,417,0,3,1
"6651",2024-08-23,"62 - 1011",116,116,116,0,0,1
"6652",2024-08-23,"3 - 1008",255,333,255,0,78,1
"6653",2024-08-23,"16 - 1022",81,81,78,3,0,0.962962962962963
"6654",2024-08-23,"24 - 1150",274,287,266,8,13,0.970802919708029
"6655",2024-08-23,"24 - 1153",416,420,416,0,4,1
"6656",2024-08-24,"62 - 1011",116,116,115,1,0,0.991379310344828
"6657",2024-08-24,"3 - 1008",255,333,255,0,78,1
"6658",2024-08-24,"16 - 1022",81,81,78,3,0,0.962962962962963
"6659",2024-08-24,"24 - 1150",270,287,262,8,17,0.97037037037037
"6660",2024-08-24,"24 - 1153",416,420,416,0,4,1
"6661",2024-08-25,"62 - 1011",116,116,115,1,0,0.991379310344828
"6662",2024-08-25,"3 - 1008",255,333,255,0,78,1
"6663",2024-08-25,"16 - 1022",81,81,78,3,0,0.962962962962963
"6664",2024-08-25,"24 - 1150",269,287,267,2,18,0.992565055762082
"6665",2024-08-25,"24 - 1153",416,420,416,0,4,1
"6666",2024-08-26,"62 - 1011",116,116,116,0,0,1
"6667",2024-08-26,"3 - 1008",255,333,255,0,78,1
"6668",2024-08-26,"16 - 1022",81,81,78,3,0,0.962962962962963
"6669",2024-08-26,"24 - 1150",274,287,272,2,13,0.992700729927007
"6670",2024-08-26,"24 - 1153",415,420,415,0,5,1
"6671",2024-08-27,"62 - 1011",116,116,116,0,0,1
"6672",2024-08-27,"3 - 1008",254,333,253,1,79,0.996062992125984
"6673",2024-08-27,"16 - 1022",81,81,79,2,0,0.975308641975309
"6674",2024-08-27,"24 - 1150",276,287,275,1,11,0.996376811594203
"6675",2024-08-27,"24 - 1153",418,420,418,0,2,1
"6676",2024-08-28,"62 - 1011",116,116,116,0,0,1
"6677",2024-08-28,"3 - 1008",253,333,253,0,80,1
"6678",2024-08-28,"16 - 1022",81,81,79,2,0,0.975308641975309
"6679",2024-08-28,"24 - 1150",273,287,270,3,14,0.989010989010989
"6680",2024-08-28,"24 - 1153",416,420,416,0,4,1
"6681",2024-08-29,"62 - 1011",116,116,116,0,0,1
"6682",2024-08-29,"3 - 1008",253,333,253,0,80,1
"6683",2024-08-29,"16 - 1022",81,81,80,1,0,0.987654320987654
"6684",2024-08-29,"24 - 1150",271,287,271,0,16,1
"6685",2024-08-29,"24 - 1153",417,420,417,0,3,1
"6686",2024-08-30,"62 - 1011",116,116,116,0,0,1
"6687",2024-08-30,"3 - 1008",253,333,252,1,80,0.99604743083004
"6688",2024-08-30,"16 - 1022",81,81,80,1,0,0.987654320987654
"6689",2024-08-30,"24 - 1150",271,287,271,0,16,1
"6690",2024-08-30,"24 - 1153",417,420,417,0,3,1
"6691",2024-08-31,"62 - 1011",116,116,116,0,0,1
"6692",2024-08-31,"3 - 1008",251,333,251,0,82,1
"6693",2024-08-31,"16 - 1022",81,81,79,2,0,0.975308641975309
"6694",2024-08-31,"24 - 1150",268,287,268,0,19,1
"6695",2024-08-31,"24 - 1153",416,420,415,1,4,0.997596153846154
"6696",2024-09-01,"62 - 1011",116,116,116,0,0,1
"6697",2024-09-01,"3 - 1008",251,333,251,0,82,1
"6698",2024-09-01,"16 - 1022",81,81,79,2,0,0.975308641975309
"6699",2024-09-01,"24 - 1150",262,287,262,0,25,1
"6700",2024-09-01,"24 - 1153",415,420,415,0,5,1
"6701",2024-09-02,"62 - 1011",116,116,116,0,0,1
"6702",2024-09-02,"3 - 1008",251,333,250,1,82,0.99601593625498
"6703",2024-09-02,"16 - 1022",81,81,79,2,0,0.975308641975309
"6704",2024-09-02,"24 - 1150",261,287,261,0,26,1
"6705",2024-09-02,"24 - 1153",413,414,413,0,1,1
"6706",2024-09-03,"62 - 1011",116,116,116,0,0,1
"6707",2024-09-03,"3 - 1008",251,333,248,3,82,0.98804780876494
"6708",2024-09-03,"16 - 1022",81,81,79,2,0,0.975308641975309
"6709",2024-09-03,"24 - 1150",265,287,260,5,22,0.981132075471698
"6710",2024-09-03,"24 - 1153",411,414,411,0,3,1
"6711",2024-09-04,"62 - 1011",116,116,115,1,0,0.991379310344828
"6712",2024-09-04,"3 - 1008",251,333,245,6,82,0.97609561752988
"6713",2024-09-04,"16 - 1022",81,81,78,3,0,0.962962962962963
"6714",2024-09-04,"24 - 1150",265,287,265,0,22,1
"6715",2024-09-04,"24 - 1153",419,420,419,0,1,1
"6716",2024-09-05,"62 - 1011",116,116,115,1,0,0.991379310344828
"6717",2024-09-05,"3 - 1008",245,333,245,0,88,1
"6718",2024-09-05,"16 - 1022",81,81,80,1,0,0.987654320987654
"6719",2024-09-05,"24 - 1150",263,287,262,1,24,0.996197718631179
"6720",2024-09-05,"24 - 1153",418,420,418,0,2,1
"6721",2024-09-06,"62 - 1011",116,116,115,1,0,0.991379310344828
"6722",2024-09-06,"3 - 1008",245,333,245,0,88,1
"6723",2024-09-06,"16 - 1022",81,81,80,1,0,0.987654320987654
"6724",2024-09-06,"24 - 1150",263,287,262,1,24,0.996197718631179
"6725",2024-09-06,"24 - 1153",417,420,417,0,3,1
"6726",2024-09-07,"62 - 1011",116,116,116,0,0,1
"6727",2024-09-07,"3 - 1008",244,333,244,0,89,1
"6728",2024-09-07,"16 - 1022",81,81,79,2,0,0.975308641975309
"6729",2024-09-07,"24 - 1150",261,287,261,0,26,1
"6730",2024-09-07,"24 - 1153",414,420,414,0,6,1
"6731",2024-09-08,"62 - 1011",116,116,116,0,0,1
"6732",2024-09-08,"3 - 1008",244,333,244,0,89,1
"6733",2024-09-08,"16 - 1022",81,81,79,2,0,0.975308641975309
"6734",2024-09-08,"24 - 1150",255,287,255,0,32,1
"6735",2024-09-08,"24 - 1153",412,416,412,0,4,1
"6736",2024-09-09,"62 - 1011",116,116,116,0,0,1
"6737",2024-09-09,"3 - 1008",243,333,241,2,90,0.991769547325103
"6738",2024-09-09,"16 - 1022",81,81,80,1,0,0.987654320987654
"6739",2024-09-09,"24 - 1150",256,287,256,0,31,1
"6740",2024-09-09,"24 - 1153",411,416,411,0,5,1
"6741",2024-09-10,"62 - 1011",116,116,116,0,0,1
"6742",2024-09-10,"3 - 1008",242,333,241,1,91,0.995867768595041
"6743",2024-09-10,"16 - 1022",81,81,81,0,0,1
"6744",2024-09-10,"24 - 1150",260,287,259,1,27,0.996153846153846
"6745",2024-09-10,"24 - 1153",409,410,409,0,1,1
"6746",2024-09-11,"62 - 1011",116,116,115,1,0,0.991379310344828
"6747",2024-09-11,"3 - 1008",241,333,241,0,92,1
"6748",2024-09-11,"16 - 1022",81,81,81,0,0,1
"6749",2024-09-11,"24 - 1150",268,287,262,6,19,0.977611940298508
"6750",2024-09-11,"24 - 1153",415,420,415,0,5,1
"6751",2024-09-12,"62 - 1011",116,116,115,1,0,0.991379310344828
"6752",2024-09-12,"3 - 1008",241,333,241,0,92,1
"6753",2024-09-12,"16 - 1022",81,81,81,0,0,1
"6754",2024-09-12,"24 - 1150",269,287,266,3,18,0.988847583643123
"6755",2024-09-12,"24 - 1153",420,420,420,0,0,1
"6756",2024-09-13,"62 - 1011",116,116,115,1,0,0.991379310344828
"6757",2024-09-13,"3 - 1008",241,333,241,0,92,1
"6758",2024-09-13,"16 - 1022",81,81,80,1,0,0.987654320987654
"6759",2024-09-13,"24 - 1150",269,287,267,2,18,0.992565055762082
"6760",2024-09-13,"24 - 1153",420,420,420,0,0,1
"6761",2024-09-14,"62 - 1011",116,116,115,1,0,0.991379310344828
"6762",2024-09-14,"3 - 1008",241,333,241,0,92,1
"6763",2024-09-14,"16 - 1022",81,81,79,2,0,0.975308641975309
"6764",2024-09-14,"24 - 1150",269,287,269,0,18,1
"6765",2024-09-14,"24 - 1153",419,420,419,0,1,1
"6766",2024-09-15,"62 - 1011",116,116,116,0,0,1
"6767",2024-09-15,"3 - 1008",240,333,240,0,93,1
"6768",2024-09-15,"16 - 1022",81,81,79,2,0,0.975308641975309
"6769",2024-09-15,"24 - 1150",269,287,269,0,18,1
"6770",2024-09-15,"24 - 1153",419,420,419,0,1,1
"6771",2024-09-16,"62 - 1011",116,116,116,0,0,1
"6772",2024-09-16,"3 - 1008",240,333,239,1,93,0.995833333333333
"6773",2024-09-16,"16 - 1022",81,81,79,2,0,0.975308641975309
"6774",2024-09-16,"24 - 1150",268,287,268,0,19,1
"6775",2024-09-16,"24 - 1153",417,420,417,0,3,1
"6776",2024-09-17,"62 - 1011",116,116,115,1,0,0.991379310344828
"6777",2024-09-17,"3 - 1008",240,333,238,2,93,0.991666666666667
"6778",2024-09-17,"16 - 1022",81,81,80,1,0,0.987654320987654
"6779",2024-09-17,"24 - 1150",264,287,264,0,23,1
"6780",2024-09-17,"24 - 1153",415,420,415,0,5,1
"6781",2024-09-18,"62 - 1011",116,116,116,0,0,1
"6782",2024-09-18,"3 - 1008",240,333,238,2,93,0.991666666666667
"6783",2024-09-18,"16 - 1022",81,81,80,1,0,0.987654320987654
"6784",2024-09-18,"24 - 1150",264,287,264,0,23,1
"6785",2024-09-18,"24 - 1153",415,420,415,0,5,1
"6786",2024-09-19,"62 - 1011",116,116,116,0,0,1
"6787",2024-09-19,"3 - 1008",238,333,237,1,95,0.995798319327731
"6788",2024-09-19,"16 - 1022",81,81,81,0,0,1
"6789",2024-09-19,"24 - 1150",269,287,263,6,18,0.977695167286245
"6790",2024-09-19,"24 - 1153",418,420,418,0,2,1
"6791",2024-09-20,"62 - 1011",116,116,116,0,0,1
"6792",2024-09-20,"3 - 1008",237,333,237,0,96,1
"6793",2024-09-20,"16 - 1022",81,81,80,1,0,0.987654320987654
"6794",2024-09-20,"24 - 1150",268,287,263,5,19,0.98134328358209
"6795",2024-09-20,"24 - 1153",418,420,418,0,2,1
"6796",2024-09-21,"62 - 1011",116,116,116,0,0,1
"6797",2024-09-21,"3 - 1008",237,333,237,0,96,1
"6798",2024-09-21,"16 - 1022",81,81,80,1,0,0.987654320987654
"6799",2024-09-21,"24 - 1150",263,287,258,5,24,0.980988593155893
"6800",2024-09-21,"24 - 1153",417,420,417,0,3,1
"6801",2024-09-22,"62 - 1011",116,116,116,0,0,1
"6802",2024-09-22,"3 - 1008",237,333,237,0,96,1
"6803",2024-09-22,"16 - 1022",81,81,79,2,0,0.975308641975309
"6804",2024-09-22,"24 - 1150",262,287,260,2,25,0.99236641221374
"6805",2024-09-22,"24 - 1153",417,420,417,0,3,1
"6806",2024-09-23,"62 - 1011",116,116,116,0,0,1
"6807",2024-09-23,"3 - 1008",236,333,236,0,97,1
"6808",2024-09-23,"16 - 1022",81,81,81,0,0,1
"6809",2024-09-23,"24 - 1150",259,287,259,0,28,1
"6810",2024-09-23,"24 - 1153",416,420,416,0,4,1
"6811",2024-09-24,"62 - 1011",116,116,114,2,0,0.982758620689655
"6812",2024-09-24,"3 - 1008",236,333,236,0,97,1
"6813",2024-09-24,"16 - 1022",81,81,81,0,0,1
"6814",2024-09-24,"24 - 1150",270,287,264,6,17,0.977777777777778
"6815",2024-09-24,"24 - 1153",419,420,419,0,1,1
"6816",2024-09-25,"62 - 1011",116,116,115,1,0,0.991379310344828
"6817",2024-09-25,"3 - 1008",236,333,236,0,97,1
"6818",2024-09-25,"16 - 1022",81,81,81,0,0,1
"6819",2024-09-25,"24 - 1150",269,287,261,8,18,0.970260223048327
"6820",2024-09-25,"24 - 1153",419,420,419,0,1,1
"6821",2024-09-26,"62 - 1011",116,116,115,1,0,0.991379310344828
"6822",2024-09-26,"3 - 1008",236,333,236,0,97,1
"6823",2024-09-26,"16 - 1022",81,81,81,0,0,1
"6824",2024-09-26,"24 - 1150",269,287,263,6,18,0.977695167286245
"6825",2024-09-26,"24 - 1153",419,420,419,0,1,1
"6826",2024-09-27,"62 - 1011",116,116,116,0,0,1
"6827",2024-09-27,"3 - 1008",236,333,236,0,97,1
"6828",2024-09-27,"16 - 1022",81,81,81,0,0,1
"6829",2024-09-27,"24 - 1150",265,287,259,6,22,0.977358490566038
"6830",2024-09-27,"24 - 1153",419,420,419,0,1,1
"6831",2024-09-28,"62 - 1011",116,116,116,0,0,1
"6832",2024-09-28,"3 - 1008",236,333,236,0,97,1
"6833",2024-09-28,"16 - 1022",81,81,77,4,0,0.950617283950617
"6834",2024-09-28,"24 - 1150",262,287,258,4,25,0.984732824427481
"6835",2024-09-28,"24 - 1153",419,420,419,0,1,1
"6836",2024-09-29,"62 - 1011",116,116,116,0,0,1
"6837",2024-09-29,"3 - 1008",236,333,236,0,97,1
"6838",2024-09-29,"16 - 1022",81,81,77,4,0,0.950617283950617
"6839",2024-09-29,"24 - 1150",261,287,259,2,26,0.992337164750958
"6840",2024-09-29,"24 - 1153",419,420,419,0,1,1
"6841",2024-09-30,"62 - 1011",116,116,116,0,0,1
"6842",2024-09-30,"3 - 1008",236,333,236,0,97,1
"6843",2024-09-30,"16 - 1022",81,81,77,4,0,0.950617283950617
"6844",2024-09-30,"24 - 1150",268,287,258,10,19,0.962686567164179
"6845",2024-09-30,"24 - 1153",419,420,419,0,1,1
"6846",2024-10-01,"62 - 1011",116,116,116,0,0,1
"6847",2024-10-01,"3 - 1008",236,333,236,0,97,1
"6848",2024-10-01,"16 - 1022",81,81,79,2,0,0.975308641975309
"6849",2024-10-01,"24 - 1150",269,287,259,10,18,0.962825278810409
"6850",2024-10-01,"24 - 1153",419,420,419,0,1,1
"6851",2024-10-02,"62 - 1011",116,116,115,1,0,0.991379310344828
"6852",2024-10-02,"3 - 1008",235,333,235,0,98,1
"6853",2024-10-02,"16 - 1022",81,81,79,2,0,0.975308641975309
"6854",2024-10-02,"24 - 1150",271,287,269,2,16,0.992619926199262
"6855",2024-10-02,"24 - 1153",417,420,417,0,3,1
"6856",2024-10-03,"62 - 1011",116,116,115,1,0,0.991379310344828
"6857",2024-10-03,"3 - 1008",235,241,234,1,6,0.995744680851064
"6858",2024-10-03,"16 - 1022",81,81,80,1,0,0.987654320987654
"6859",2024-10-03,"24 - 1150",269,287,269,0,18,1
"6860",2024-10-03,"24 - 1153",418,420,418,0,2,1
"6861",2024-10-04,"62 - 1011",116,116,115,1,0,0.991379310344828
"6862",2024-10-04,"3 - 1008",235,241,235,0,6,1
"6863",2024-10-04,"16 - 1022",81,81,81,0,0,1
"6864",2024-10-04,"24 - 1150",267,287,265,2,20,0.99250936329588
"6865",2024-10-04,"24 - 1153",417,420,417,0,3,1
"6866",2024-10-05,"62 - 1011",116,116,116,0,0,1
"6867",2024-10-05,"3 - 1008",235,241,235,0,6,1
"6868",2024-10-05,"16 - 1022",81,81,81,0,0,1
"6869",2024-10-05,"24 - 1150",267,287,263,4,20,0.98501872659176
"6870",2024-10-05,"24 - 1153",417,420,417,0,3,1
"6871",2024-10-06,"62 - 1011",116,116,114,2,0,0.982758620689655
"6872",2024-10-06,"3 - 1008",235,241,235,0,6,1
"6873",2024-10-06,"16 - 1022",81,81,81,0,0,1
"6874",2024-10-06,"24 - 1150",268,287,264,4,19,0.985074626865672
"6875",2024-10-06,"24 - 1153",414,420,414,0,6,1
"6876",2024-10-07,"62 - 1011",116,116,115,1,0,0.991379310344828
"6877",2024-10-07,"3 - 1008",235,241,232,3,6,0.987234042553191
"6878",2024-10-07,"16 - 1022",81,81,79,2,0,0.975308641975309
"6879",2024-10-07,"24 - 1150",262,287,260,2,25,0.99236641221374
"6880",2024-10-07,"24 - 1153",415,416,415,0,1,1
"6881",2024-10-08,"62 - 1011",116,116,115,1,0,0.991379310344828
"6882",2024-10-08,"3 - 1008",230,241,229,1,11,0.995652173913044
"6883",2024-10-08,"16 - 1022",81,81,79,2,0,0.975308641975309
"6884",2024-10-08,"24 - 1150",261,287,261,0,26,1
"6885",2024-10-08,"24 - 1153",417,420,417,0,3,1
"6886",2024-10-09,"62 - 1011",116,116,115,1,0,0.991379310344828
"6887",2024-10-09,"3 - 1008",231,241,231,0,10,1
"6888",2024-10-09,"16 - 1022",81,81,81,0,0,1
"6889",2024-10-09,"24 - 1150",257,287,255,2,30,0.992217898832685
"6890",2024-10-09,"24 - 1153",418,420,418,0,2,1
"6891",2024-10-10,"62 - 1011",116,116,115,1,0,0.991379310344828
"6892",2024-10-10,"3 - 1008",231,241,230,1,10,0.995670995670996
"6893",2024-10-10,"16 - 1022",81,81,81,0,0,1
"6894",2024-10-10,"24 - 1150",255,287,255,0,32,1
"6895",2024-10-10,"24 - 1153",418,420,418,0,2,1
"6896",2024-10-11,"62 - 1011",116,116,115,1,0,0.991379310344828
"6897",2024-10-11,"3 - 1008",229,241,229,0,12,1
"6898",2024-10-11,"16 - 1022",81,81,81,0,0,1
"6899",2024-10-11,"24 - 1150",264,287,259,5,23,0.981060606060606
"6900",2024-10-11,"24 - 1153",419,420,419,0,1,1
"6901",2024-10-12,"62 - 1011",116,116,116,0,0,1
"6902",2024-10-12,"3 - 1008",229,241,229,0,12,1
"6903",2024-10-12,"16 - 1022",81,81,80,1,0,0.987654320987654
"6904",2024-10-12,"24 - 1150",262,287,258,4,25,0.984732824427481
"6905",2024-10-12,"24 - 1153",419,420,419,0,1,1
"6906",2024-10-13,"62 - 1011",116,116,116,0,0,1
"6907",2024-10-13,"3 - 1008",229,241,229,0,12,1
"6908",2024-10-13,"16 - 1022",81,81,79,2,0,0.975308641975309
"6909",2024-10-13,"24 - 1150",257,287,257,0,30,1
"6910",2024-10-13,"24 - 1153",419,420,419,0,1,1
"6911",2024-10-14,"62 - 1011",116,116,116,0,0,1
"6912",2024-10-14,"3 - 1008",229,241,229,0,12,1
"6913",2024-10-14,"16 - 1022",81,81,79,2,0,0.975308641975309
"6914",2024-10-14,"24 - 1150",257,287,257,0,30,1
"6915",2024-10-14,"24 - 1153",418,420,418,0,2,1
"6916",2024-10-15,"62 - 1011",116,116,116,0,0,1
"6917",2024-10-15,"3 - 1008",229,241,228,1,12,0.995633187772926
"6918",2024-10-15,"16 - 1022",81,81,80,1,0,0.987654320987654
"6919",2024-10-15,"24 - 1150",263,287,262,1,24,0.996197718631179
"6920",2024-10-15,"24 - 1153",418,420,418,0,2,1
"6921",2024-10-16,"62 - 1011",116,116,116,0,0,1
"6922",2024-10-16,"3 - 1008",228,231,228,0,3,1
"6923",2024-10-16,"16 - 1022",81,81,81,0,0,1
"6924",2024-10-16,"24 - 1150",260,287,260,0,27,1
"6925",2024-10-16,"24 - 1153",417,420,417,0,3,1
"6926",2024-10-17,"62 - 1011",116,116,116,0,0,1
"6927",2024-10-17,"3 - 1008",228,231,228,0,3,1
"6928",2024-10-17,"16 - 1022",81,81,81,0,0,1
"6929",2024-10-17,"24 - 1150",256,287,256,0,31,1
"6930",2024-10-17,"24 - 1153",417,420,417,0,3,1
"6931",2024-10-18,"62 - 1011",116,116,116,0,0,1
"6932",2024-10-18,"3 - 1008",227,231,227,0,4,1
"6933",2024-10-18,"16 - 1022",81,81,78,3,0,0.962962962962963
"6934",2024-10-18,"24 - 1150",259,287,257,2,28,0.992277992277992
"6935",2024-10-18,"24 - 1153",418,420,418,0,2,1
"6936",2024-10-19,"62 - 1011",116,116,116,0,0,1
"6937",2024-10-19,"3 - 1008",227,231,227,0,4,1
"6938",2024-10-19,"16 - 1022",81,81,79,2,0,0.975308641975309
"6939",2024-10-19,"24 - 1150",259,287,257,2,28,0.992277992277992
"6940",2024-10-19,"24 - 1153",418,420,418,0,2,1
"6941",2024-10-20,"62 - 1011",116,116,116,0,0,1
"6942",2024-10-20,"3 - 1008",227,231,227,0,4,1
"6943",2024-10-20,"16 - 1022",81,81,79,2,0,0.975308641975309
"6944",2024-10-20,"24 - 1150",258,287,258,0,29,1
"6945",2024-10-20,"24 - 1153",418,420,418,0,2,1
"6946",2024-10-21,"62 - 1011",116,116,115,1,0,0.991379310344828
"6947",2024-10-21,"3 - 1008",227,231,227,0,4,1
"6948",2024-10-21,"16 - 1022",81,81,81,0,0,1
"6949",2024-10-21,"24 - 1150",269,287,258,11,18,0.95910780669145
"6950",2024-10-21,"24 - 1153",418,420,418,0,2,1
"6951",2024-10-22,"62 - 1011",116,116,116,0,0,1
"6952",2024-10-22,"3 - 1008",227,231,227,0,4,1
"6953",2024-10-22,"16 - 1022",81,81,80,1,0,0.987654320987654
"6954",2024-10-22,"24 - 1150",267,287,259,8,20,0.970037453183521
"6955",2024-10-22,"24 - 1153",418,420,418,0,2,1
"6956",2024-10-23,"62 - 1011",116,116,116,0,0,1
"6957",2024-10-23,"3 - 1008",227,231,227,0,4,1
"6958",2024-10-23,"16 - 1022",81,81,79,2,0,0.975308641975309
"6959",2024-10-23,"24 - 1150",267,287,263,4,20,0.98501872659176
"6960",2024-10-23,"24 - 1153",418,420,418,0,2,1
"6961",2024-10-24,"62 - 1011",116,116,114,2,0,0.982758620689655
"6962",2024-10-24,"3 - 1008",227,231,227,0,4,1
"6963",2024-10-24,"16 - 1022",81,81,79,2,0,0.975308641975309
"6964",2024-10-24,"24 - 1150",268,287,266,2,19,0.992537313432836
"6965",2024-10-24,"24 - 1153",418,420,418,0,2,1
"6966",2024-10-25,"62 - 1011",116,116,114,2,0,0.982758620689655
"6967",2024-10-25,"3 - 1008",227,231,227,0,4,1
"6968",2024-10-25,"16 - 1022",81,81,79,2,0,0.975308641975309
"6969",2024-10-25,"24 - 1150",269,287,267,2,18,0.992565055762082
"6970",2024-10-25,"24 - 1153",418,420,418,0,2,1
"6971",2024-10-26,"62 - 1011",116,116,115,1,0,0.991379310344828
"6972",2024-10-26,"3 - 1008",227,231,227,0,4,1
"6973",2024-10-26,"16 - 1022",81,81,79,2,0,0.975308641975309
"6974",2024-10-26,"24 - 1150",269,287,267,2,18,0.992565055762082
"6975",2024-10-26,"24 - 1153",417,420,417,0,3,1
"6976",2024-10-27,"62 - 1011",116,116,116,0,0,1
"6977",2024-10-27,"3 - 1008",227,231,227,0,4,1
"6978",2024-10-27,"16 - 1022",81,81,79,2,0,0.975308641975309
"6979",2024-10-27,"24 - 1150",269,287,268,1,18,0.996282527881041
"6980",2024-10-27,"24 - 1153",417,420,417,0,3,1
"6981",2024-10-28,"62 - 1011",116,116,116,0,0,1
"6982",2024-10-28,"3 - 1008",227,231,227,0,4,1
"6983",2024-10-28,"16 - 1022",81,81,79,2,0,0.975308641975309
"6984",2024-10-28,"24 - 1150",275,287,266,9,12,0.967272727272727
"6985",2024-10-28,"24 - 1153",419,420,419,0,1,1
"6986",2024-10-29,"62 - 1011",116,116,114,2,0,0.982758620689655
"6987",2024-10-29,"3 - 1008",227,231,224,3,4,0.986784140969163
"6988",2024-10-29,"16 - 1022",81,81,79,2,0,0.975308641975309
"6989",2024-10-29,"24 - 1150",271,287,267,4,16,0.985239852398524
"6990",2024-10-29,"24 - 1153",420,420,420,0,0,1
"6991",2024-10-30,"62 - 1011",116,116,113,3,0,0.974137931034483
"6992",2024-10-30,"3 - 1008",227,231,226,1,4,0.995594713656388
"6993",2024-10-30,"16 - 1022",81,81,81,0,0,1
"6994",2024-10-30,"24 - 1150",270,287,267,3,17,0.988888888888889
"6995",2024-10-30,"24 - 1153",419,420,419,0,1,1
"6996",2024-10-31,"62 - 1011",116,116,114,2,0,0.982758620689655
"6997",2024-10-31,"3 - 1008",225,226,225,0,1,1
"6998",2024-10-31,"16 - 1022",81,81,81,0,0,1
"6999",2024-10-31,"24 - 1150",271,287,265,6,16,0.977859778597786
"7000",2024-10-31,"24 - 1153",418,420,418,0,2,1
"7001",2024-11-01,"62 - 1011",116,116,115,1,0,0.991379310344828
"7002",2024-11-01,"3 - 1008",225,226,225,0,1,1
"7003",2024-11-01,"16 - 1022",81,81,81,0,0,1
"7004",2024-11-01,"24 - 1150",272,287,263,9,15,0.966911764705882
"7005",2024-11-01,"24 - 1153",417,420,417,0,3,1
"7006",2024-11-02,"62 - 1011",116,116,115,1,0,0.991379310344828
"7007",2024-11-02,"3 - 1008",225,226,225,0,1,1
"7008",2024-11-02,"16 - 1022",81,81,81,0,0,1
"7009",2024-11-02,"24 - 1150",270,287,266,4,17,0.985185185185185
"7010",2024-11-02,"24 - 1153",416,420,416,0,4,1
"7011",2024-11-03,"62 - 1011",116,116,114,2,0,0.982758620689655
"7012",2024-11-03,"3 - 1008",225,226,225,0,1,1
"7013",2024-11-03,"16 - 1022",81,81,81,0,0,1
"7014",2024-11-03,"24 - 1150",271,287,263,8,16,0.970479704797048
"7015",2024-11-03,"24 - 1153",413,414,413,0,1,1
"7016",2024-11-04,"62 - 1011",116,116,114,2,0,0.982758620689655
"7017",2024-11-04,"3 - 1008",225,231,225,0,6,1
"7018",2024-11-04,"16 - 1022",81,81,81,0,0,1
"7019",2024-11-04,"24 - 1150",269,287,268,1,18,0.996282527881041
"7020",2024-11-04,"24 - 1153",411,414,411,0,3,1
"7021",2024-11-05,"62 - 1011",116,116,114,2,0,0.982758620689655
"7022",2024-11-05,"3 - 1008",226,231,223,3,5,0.986725663716814
"7023",2024-11-05,"16 - 1022",81,81,81,0,0,1
"7024",2024-11-05,"24 - 1150",271,287,267,4,16,0.985239852398524
"7025",2024-11-05,"24 - 1153",415,420,415,0,5,1
"7026",2024-11-06,"62 - 1011",116,116,114,2,0,0.982758620689655
"7027",2024-11-06,"3 - 1008",225,226,223,2,1,0.991111111111111
"7028",2024-11-06,"16 - 1022",81,81,81,0,0,1
"7029",2024-11-06,"24 - 1150",275,287,273,2,12,0.992727272727273
"7030",2024-11-06,"24 - 1153",415,420,415,0,5,1
"7031",2024-11-07,"62 - 1011",116,116,114,2,0,0.982758620689655
"7032",2024-11-07,"3 - 1008",225,226,223,2,1,0.991111111111111
"7033",2024-11-07,"16 - 1022",81,81,81,0,0,1
"7034",2024-11-07,"24 - 1150",272,287,272,0,15,1
"7035",2024-11-07,"24 - 1153",413,420,413,0,7,1
"7036",2024-11-08,"62 - 1011",116,116,111,5,0,0.956896551724138
"7037",2024-11-08,"3 - 1008",225,226,224,1,1,0.995555555555556
"7038",2024-11-08,"16 - 1022",81,81,79,2,0,0.975308641975309
"7039",2024-11-08,"24 - 1150",271,287,271,0,16,1
"7040",2024-11-08,"24 - 1153",410,420,410,0,10,1
"7041",2024-11-09,"62 - 1011",116,116,112,4,0,0.96551724137931
"7042",2024-11-09,"3 - 1008",225,226,225,0,1,1
"7043",2024-11-09,"16 - 1022",81,81,79,2,0,0.975308641975309
"7044",2024-11-09,"24 - 1150",269,287,269,0,18,1
"7045",2024-11-09,"24 - 1153",409,414,409,0,5,1
"7046",2024-11-10,"62 - 1011",116,116,113,3,0,0.974137931034483
"7047",2024-11-10,"3 - 1008",225,226,224,1,1,0.995555555555556
"7048",2024-11-10,"16 - 1022",81,81,79,2,0,0.975308641975309
"7049",2024-11-10,"24 - 1150",265,287,263,2,22,0.992452830188679
"7050",2024-11-10,"24 - 1153",409,414,409,0,5,1
"7051",2024-11-11,"62 - 1011",116,116,112,4,0,0.96551724137931
"7052",2024-11-11,"3 - 1008",226,226,225,1,0,0.995575221238938
"7053",2024-11-11,"16 - 1022",81,81,79,2,0,0.975308641975309
"7054",2024-11-11,"24 - 1150",266,287,264,2,21,0.992481203007519
"7055",2024-11-11,"24 - 1153",412,414,412,0,2,1
"7056",2024-11-12,"62 - 1011",116,116,111,5,0,0.956896551724138
"7057",2024-11-12,"3 - 1008",226,226,225,1,0,0.995575221238938
"7058",2024-11-12,"16 - 1022",81,81,78,3,0,0.962962962962963
"7059",2024-11-12,"24 - 1150",261,287,261,0,26,1
"7060",2024-11-12,"24 - 1153",418,420,418,0,2,1
"7061",2024-11-13,"62 - 1011",116,116,111,5,0,0.956896551724138
"7062",2024-11-13,"3 - 1008",227,231,227,0,4,1
"7063",2024-11-13,"16 - 1022",81,81,78,3,0,0.962962962962963
"7064",2024-11-13,"24 - 1150",261,287,260,1,26,0.996168582375479
"7065",2024-11-13,"24 - 1153",418,420,418,0,2,1
"7066",2024-11-14,"62 - 1011",116,116,111,5,0,0.956896551724138
"7067",2024-11-14,"3 - 1008",227,231,227,0,4,1
"7068",2024-11-14,"16 - 1022",81,81,79,2,0,0.975308641975309
"7069",2024-11-14,"24 - 1150",260,287,260,0,27,1
"7070",2024-11-14,"24 - 1153",416,420,416,0,4,1
"7071",2024-11-15,"62 - 1011",116,116,113,3,0,0.974137931034483
"7072",2024-11-15,"3 - 1008",247,251,245,2,4,0.991902834008097
"7073",2024-11-15,"16 - 1022",81,81,76,5,0,0.938271604938272
"7074",2024-11-15,"24 - 1150",258,287,258,0,29,1
"7075",2024-11-15,"24 - 1153",414,420,414,0,6,1
"7076",2024-11-16,"62 - 1011",116,116,114,2,0,0.982758620689655
"7077",2024-11-16,"3 - 1008",246,251,244,2,5,0.991869918699187
"7078",2024-11-16,"16 - 1022",81,81,76,5,0,0.938271604938272
"7079",2024-11-16,"24 - 1150",250,287,250,0,37,1
"7080",2024-11-16,"24 - 1153",413,420,413,0,7,1
"7081",2024-11-17,"62 - 1011",116,116,114,2,0,0.982758620689655
"7082",2024-11-17,"3 - 1008",246,251,244,2,5,0.991869918699187
"7083",2024-11-17,"16 - 1022",81,81,77,4,0,0.950617283950617
"7084",2024-11-17,"24 - 1150",248,287,247,1,39,0.995967741935484
"7085",2024-11-17,"24 - 1153",412,420,412,0,8,1
"7086",2024-11-18,"62 - 1011",116,116,113,3,0,0.974137931034483
"7087",2024-11-18,"3 - 1008",270,271,263,7,1,0.974074074074074
"7088",2024-11-18,"16 - 1022",81,81,77,4,0,0.950617283950617
"7089",2024-11-18,"24 - 1150",249,287,248,1,38,0.995983935742972
"7090",2024-11-18,"24 - 1153",411,420,411,0,9,1
"7091",2024-11-19,"62 - 1011",116,116,113,3,0,0.974137931034483
"7092",2024-11-19,"3 - 1008",291,291,275,16,0,0.945017182130584
"7093",2024-11-19,"16 - 1022",81,81,80,1,0,0.987654320987654
"7094",2024-11-19,"24 - 1150",250,287,250,0,37,1
"7095",2024-11-19,"24 - 1153",411,420,411,0,9,1
"7096",2024-11-20,"62 - 1011",116,116,113,3,0,0.974137931034483
"7097",2024-11-20,"3 - 1008",311,311,289,22,0,0.929260450160772
"7098",2024-11-20,"16 - 1022",81,81,81,0,0,1
"7099",2024-11-20,"24 - 1150",259,287,255,4,28,0.984555984555985
"7100",2024-11-20,"24 - 1153",411,420,411,0,9,1
"7101",2024-11-21,"62 - 1011",116,116,112,4,0,0.96551724137931
"7102",2024-11-21,"3 - 1008",333,333,307,26,0,0.921921921921922
"7103",2024-11-21,"16 - 1022",81,81,78,3,0,0.962962962962963
"7104",2024-11-21,"24 - 1150",256,287,254,2,31,0.9921875
"7105",2024-11-21,"24 - 1153",411,420,411,0,9,1
"7106",2024-11-22,"62 - 1011",116,116,113,3,0,0.974137931034483
"7107",2024-11-22,"3 - 1008",333,333,316,17,0,0.948948948948949
"7108",2024-11-22,"16 - 1022",81,81,80,1,0,0.987654320987654
"7109",2024-11-22,"24 - 1150",255,287,255,0,32,1
"7110",2024-11-22,"24 - 1153",411,416,411,0,5,1
"7111",2024-11-23,"62 - 1011",116,116,114,2,0,0.982758620689655
"7112",2024-11-23,"3 - 1008",333,333,322,11,0,0.966966966966967
"7113",2024-11-23,"16 - 1022",81,81,80,1,0,0.987654320987654
"7114",2024-11-23,"24 - 1150",253,287,253,0,34,1
"7115",2024-11-23,"24 - 1153",415,420,413,2,5,0.995180722891566
"7116",2024-11-24,"62 - 1011",116,116,114,2,0,0.982758620689655
"7117",2024-11-24,"3 - 1008",333,333,323,10,0,0.96996996996997
"7118",2024-11-24,"16 - 1022",81,81,80,1,0,0.987654320987654
"7119",2024-11-24,"24 - 1150",250,287,250,0,37,1
"7120",2024-11-24,"24 - 1153",415,420,413,2,5,0.995180722891566
"7121",2024-11-25,"62 - 1011",116,116,114,2,0,0.982758620689655
"7122",2024-11-25,"3 - 1008",330,333,322,8,3,0.975757575757576
"7123",2024-11-25,"16 - 1022",81,81,78,3,0,0.962962962962963
"7124",2024-11-25,"24 - 1150",259,287,258,1,28,0.996138996138996
"7125",2024-11-25,"24 - 1153",415,420,412,3,5,0.992771084337349
"7126",2024-11-26,"62 - 1011",116,116,114,2,0,0.982758620689655
"7127",2024-11-26,"3 - 1008",330,333,320,10,3,0.96969696969697
"7128",2024-11-26,"16 - 1022",81,81,77,4,0,0.950617283950617
"7129",2024-11-26,"24 - 1150",262,287,261,1,25,0.99618320610687
"7130",2024-11-26,"24 - 1153",416,420,413,3,4,0.992788461538462
"7131",2024-11-27,"62 - 1011",116,116,114,2,0,0.982758620689655
"7132",2024-11-27,"3 - 1008",330,333,323,7,3,0.978787878787879
"7133",2024-11-27,"16 - 1022",81,81,78,3,0,0.962962962962963
"7134",2024-11-27,"24 - 1150",265,287,260,5,22,0.981132075471698
"7135",2024-11-27,"24 - 1153",416,420,416,0,4,1
"7136",2024-11-28,"62 - 1011",116,116,114,2,0,0.982758620689655
"7137",2024-11-28,"3 - 1008",330,333,324,6,3,0.981818181818182
"7138",2024-11-28,"16 - 1022",81,81,80,1,0,0.987654320987654
"7139",2024-11-28,"24 - 1150",262,287,262,0,25,1
"7140",2024-11-28,"24 - 1153",415,420,415,0,5,1
"7141",2024-11-29,"62 - 1011",116,116,114,2,0,0.982758620689655
"7142",2024-11-29,"3 - 1008",330,333,325,5,3,0.984848484848485
"7143",2024-11-29,"16 - 1022",81,81,79,2,0,0.975308641975309
"7144",2024-11-29,"24 - 1150",260,287,260,0,27,1
"7145",2024-11-29,"24 - 1153",414,420,414,0,6,1
"7146",2024-11-30,"62 - 1011",116,116,114,2,0,0.982758620689655
"7147",2024-11-30,"3 - 1008",331,333,326,5,2,0.984894259818731
"7148",2024-11-30,"16 - 1022",81,81,79,2,0,0.975308641975309
"7149",2024-11-30,"24 - 1150",259,287,259,0,28,1
"7150",2024-11-30,"24 - 1153",413,420,413,0,7,1
"7151",2024-12-01,"62 - 1011",116,116,114,2,0,0.982758620689655
"7152",2024-12-01,"3 - 1008",331,333,325,6,2,0.981873111782477
"7153",2024-12-01,"16 - 1022",81,81,78,3,0,0.962962962962963
"7154",2024-12-01,"24 - 1150",258,287,258,0,29,1
"7155",2024-12-01,"24 - 1153",411,420,410,1,9,0.997566909975669
"7156",2024-12-02,"62 - 1011",116,116,113,3,0,0.974137931034483
"7157",2024-12-02,"3 - 1008",330,333,325,5,3,0.984848484848485
"7158",2024-12-02,"16 - 1022",81,81,79,2,0,0.975308641975309
"7159",2024-12-02,"24 - 1150",261,287,258,3,26,0.988505747126437
"7160",2024-12-02,"24 - 1153",409,420,408,1,11,0.997555012224939
"7161",2024-12-03,"62 - 1011",116,116,113,3,0,0.974137931034483
"7162",2024-12-03,"3 - 1008",330,333,325,5,3,0.984848484848485
"7163",2024-12-03,"16 - 1022",81,81,80,1,0,0.987654320987654
"7164",2024-12-03,"24 - 1150",257,287,257,0,30,1
"7165",2024-12-03,"24 - 1153",412,420,411,1,8,0.997572815533981
"7166",2024-12-04,"62 - 1011",116,116,113,3,0,0.974137931034483
"7167",2024-12-04,"3 - 1008",330,333,324,6,3,0.981818181818182
"7168",2024-12-04,"16 - 1022",81,81,81,0,0,1
"7169",2024-12-04,"24 - 1150",260,287,260,0,27,1
"7170",2024-12-04,"24 - 1153",411,420,410,1,9,0.997566909975669
"7171",2024-12-05,"62 - 1011",116,116,113,3,0,0.974137931034483
"7172",2024-12-05,"3 - 1008",329,333,323,6,4,0.981762917933131
"7173",2024-12-05,"16 - 1022",81,81,81,0,0,1
"7174",2024-12-05,"24 - 1150",255,287,254,1,32,0.996078431372549
"7175",2024-12-05,"24 - 1153",411,420,411,0,9,1
"7176",2024-12-06,"62 - 1011",116,116,113,3,0,0.974137931034483
"7177",2024-12-06,"3 - 1008",331,333,323,8,2,0.97583081570997
"7178",2024-12-06,"16 - 1022",81,81,80,1,0,0.987654320987654
"7179",2024-12-06,"24 - 1150",257,287,257,0,30,1
"7180",2024-12-06,"24 - 1153",411,420,411,0,9,1
"7181",2024-12-07,"62 - 1011",116,116,113,3,0,0.974137931034483
"7182",2024-12-07,"3 - 1008",331,333,325,6,2,0.981873111782477
"7183",2024-12-07,"16 - 1022",81,81,79,2,0,0.975308641975309
"7184",2024-12-07,"24 - 1150",262,287,260,2,25,0.99236641221374
"7185",2024-12-07,"24 - 1153",410,420,409,1,10,0.997560975609756
"7186",2024-12-08,"62 - 1011",116,116,113,3,0,0.974137931034483
"7187",2024-12-08,"3 - 1008",330,333,323,7,3,0.978787878787879
"7188",2024-12-08,"16 - 1022",81,81,76,5,0,0.938271604938272
"7189",2024-12-08,"24 - 1150",262,287,262,0,25,1
"7190",2024-12-08,"24 - 1153",409,420,409,0,11,1
"7191",2024-12-09,"62 - 1011",116,116,113,3,0,0.974137931034483
"7192",2024-12-09,"3 - 1008",330,333,319,11,3,0.966666666666667
"7193",2024-12-09,"16 - 1022",81,81,80,1,0,0.987654320987654
"7194",2024-12-09,"24 - 1150",261,287,261,0,26,1
"7195",2024-12-09,"24 - 1153",408,420,407,1,12,0.997549019607843
"7196",2024-12-10,"62 - 1011",116,116,113,3,0,0.974137931034483
"7197",2024-12-10,"3 - 1008",330,333,319,11,3,0.966666666666667
"7198",2024-12-10,"16 - 1022",81,81,77,4,0,0.950617283950617
"7199",2024-12-10,"24 - 1150",263,287,263,0,24,1
"7200",2024-12-10,"24 - 1153",405,420,405,0,15,1
"7201",2024-12-11,"62 - 1011",116,116,113,3,0,0.974137931034483
"7202",2024-12-11,"3 - 1008",330,333,321,9,3,0.972727272727273
"7203",2024-12-11,"16 - 1022",81,81,78,3,0,0.962962962962963
"7204",2024-12-11,"24 - 1150",263,287,263,0,24,1
"7205",2024-12-11,"24 - 1153",401,414,401,0,13,1
"7206",2024-12-12,"62 - 1011",116,116,112,4,0,0.96551724137931
"7207",2024-12-12,"3 - 1008",330,333,321,9,3,0.972727272727273
"7208",2024-12-12,"16 - 1022",81,81,78,3,0,0.962962962962963
"7209",2024-12-12,"24 - 1150",259,287,258,1,28,0.996138996138996
"7210",2024-12-12,"24 - 1153",402,414,402,0,12,1
"7211",2024-12-13,"62 - 1011",116,116,112,4,0,0.96551724137931
"7212",2024-12-13,"3 - 1008",330,333,320,10,3,0.96969696969697
"7213",2024-12-13,"16 - 1022",81,81,78,3,0,0.962962962962963
"7214",2024-12-13,"24 - 1150",256,287,256,0,31,1
"7215",2024-12-13,"24 - 1153",408,414,407,1,6,0.997549019607843
"7216",2024-12-14,"62 - 1011",116,116,114,2,0,0.982758620689655
"7217",2024-12-14,"3 - 1008",330,333,321,9,3,0.972727272727273
"7218",2024-12-14,"16 - 1022",81,81,78,3,0,0.962962962962963
"7219",2024-12-14,"24 - 1150",255,287,255,0,32,1
"7220",2024-12-14,"24 - 1153",408,414,408,0,6,1
"7221",2024-12-15,"62 - 1011",116,116,115,1,0,0.991379310344828
"7222",2024-12-15,"3 - 1008",329,333,321,8,4,0.975683890577508
"7223",2024-12-15,"16 - 1022",81,81,78,3,0,0.962962962962963
"7224",2024-12-15,"24 - 1150",255,287,255,0,32,1
"7225",2024-12-15,"24 - 1153",408,414,408,0,6,1
"7226",2024-12-16,"62 - 1011",116,116,116,0,0,1
"7227",2024-12-16,"3 - 1008",329,333,321,8,4,0.975683890577508
"7228",2024-12-16,"16 - 1022",81,81,79,2,0,0.975308641975309
"7229",2024-12-16,"24 - 1150",254,287,254,0,33,1
"7230",2024-12-16,"24 - 1153",411,414,411,0,3,1
"7231",2024-12-17,"62 - 1011",116,116,115,1,0,0.991379310344828
"7232",2024-12-17,"3 - 1008",329,333,320,9,4,0.972644376899696
"7233",2024-12-17,"16 - 1022",81,81,79,2,0,0.975308641975309
"7234",2024-12-17,"24 - 1150",255,287,255,0,32,1
"7235",2024-12-17,"24 - 1153",415,420,415,0,5,1
"7236",2024-12-18,"62 - 1011",116,116,116,0,0,1
"7237",2024-12-18,"3 - 1008",329,333,322,7,4,0.978723404255319
"7238",2024-12-18,"16 - 1022",81,81,79,2,0,0.975308641975309
"7239",2024-12-18,"24 - 1150",252,287,251,1,35,0.996031746031746
"7240",2024-12-18,"24 - 1153",420,420,420,0,0,1
"7241",2024-12-19,"62 - 1011",116,116,116,0,0,1
"7242",2024-12-19,"3 - 1008",329,333,319,10,4,0.969604863221885
"7243",2024-12-19,"16 - 1022",81,81,80,1,0,0.987654320987654
"7244",2024-12-19,"24 - 1150",252,287,252,0,35,1
"7245",2024-12-19,"24 - 1153",420,420,420,0,0,1
"7246",2024-12-20,"62 - 1011",116,116,115,1,0,0.991379310344828
"7247",2024-12-20,"3 - 1008",328,333,317,11,5,0.966463414634146
"7248",2024-12-20,"16 - 1022",81,81,80,1,0,0.987654320987654
"7249",2024-12-20,"24 - 1150",252,287,252,0,35,1
"7250",2024-12-20,"24 - 1153",419,420,419,0,1,1
"7251",2024-12-21,"62 - 1011",116,116,115,1,0,0.991379310344828
"7252",2024-12-21,"3 - 1008",333,343,320,13,10,0.960960960960961
"7253",2024-12-21,"16 - 1022",81,81,80,1,0,0.987654320987654
"7254",2024-12-21,"24 - 1150",252,287,252,0,35,1
"7255",2024-12-21,"24 - 1153",420,420,419,1,0,0.997619047619048
"7256",2024-12-22,"62 - 1011",116,116,115,1,0,0.991379310344828
"7257",2024-12-22,"3 - 1008",333,343,318,15,10,0.954954954954955
"7258",2024-12-22,"16 - 1022",81,81,80,1,0,0.987654320987654
"7259",2024-12-22,"24 - 1150",251,287,251,0,36,1
"7260",2024-12-22,"24 - 1153",418,420,418,0,2,1
"7261",2024-12-23,"62 - 1011",116,116,115,1,0,0.991379310344828
"7262",2024-12-23,"3 - 1008",328,333,318,10,5,0.969512195121951
"7263",2024-12-23,"16 - 1022",81,81,81,0,0,1
"7264",2024-12-23,"24 - 1150",252,287,252,0,35,1
"7265",2024-12-23,"24 - 1153",418,420,418,0,2,1
"7266",2024-12-24,"62 - 1011",116,116,116,0,0,1
"7267",2024-12-24,"3 - 1008",328,333,315,13,5,0.960365853658537
"7268",2024-12-24,"16 - 1022",81,81,81,0,0,1
"7269",2024-12-24,"24 - 1150",252,287,252,0,35,1
"7270",2024-12-24,"24 - 1153",418,420,418,0,2,1
"7271",2024-12-25,"62 - 1011",116,116,116,0,0,1
"7272",2024-12-25,"3 - 1008",328,333,316,12,5,0.963414634146341
"7273",2024-12-25,"16 - 1022",81,81,81,0,0,1
"7274",2024-12-25,"24 - 1150",253,287,252,1,34,0.99604743083004
"7275",2024-12-25,"24 - 1153",418,420,418,0,2,1
"7276",2024-12-26,"62 - 1011",116,116,116,0,0,1
"7277",2024-12-26,"3 - 1008",328,333,316,12,5,0.963414634146341
"7278",2024-12-26,"16 - 1022",81,81,81,0,0,1
"7279",2024-12-26,"24 - 1150",253,287,252,1,34,0.99604743083004
"7280",2024-12-26,"24 - 1153",417,420,417,0,3,1
"7281",2024-12-27,"62 - 1011",116,116,116,0,0,1
"7282",2024-12-27,"3 - 1008",328,333,315,13,5,0.960365853658537
"7283",2024-12-27,"16 - 1022",81,81,79,2,0,0.975308641975309
"7284",2024-12-27,"24 - 1150",253,287,253,0,34,1
"7285",2024-12-27,"24 - 1153",417,420,417,0,3,1
"7286",2024-12-28,"62 - 1011",116,116,116,0,0,1
"7287",2024-12-28,"3 - 1008",328,333,315,13,5,0.960365853658537
"7288",2024-12-28,"16 - 1022",81,81,79,2,0,0.975308641975309
"7289",2024-12-28,"24 - 1150",253,287,253,0,34,1
"7290",2024-12-28,"24 - 1153",416,420,416,0,4,1
"7291",2024-12-29,"62 - 1011",116,116,116,0,0,1
"7292",2024-12-29,"3 - 1008",328,333,315,13,5,0.960365853658537
"7293",2024-12-29,"16 - 1022",81,81,79,2,0,0.975308641975309
"7294",2024-12-29,"24 - 1150",253,287,253,0,34,1
"7295",2024-12-29,"24 - 1153",416,420,416,0,4,1
"7296",2024-12-30,"62 - 1011",116,116,115,1,0,0.991379310344828
"7297",2024-12-30,"3 - 1008",328,333,315,13,5,0.960365853658537
"7298",2024-12-30,"16 - 1022",81,81,80,1,0,0.987654320987654
"7299",2024-12-30,"24 - 1150",254,287,254,0,33,1
"7300",2024-12-30,"24 - 1153",416,420,416,0,4,1
"7301",2024-12-31,"62 - 1011",116,116,115,1,0,0.991379310344828
"7302",2024-12-31,"3 - 1008",327,333,314,13,6,0.960244648318043
"7303",2024-12-31,"16 - 1022",81,81,79,2,0,0.975308641975309
"7304",2024-12-31,"24 - 1150",254,287,254,0,33,1
"7305",2024-12-31,"24 - 1153",415,420,415,0,5,1
